AAAAATTGAGC -> AAAATTGAGCC
AAAACATAATT -> AAACATAATTA
AAAAGAATCGT -> AAAGAATCGTT
AAAATCGTGGC -> AAATCGTGGCT
AAAATTGAGCC -> AAATTGAGCCG
AAACACCTACC -> AACACCTACCC
AAACATAATTA -> AACATAATTAA
AAACCAAGCTA -> AACCAAGCTAG
AAACCAATAAG -> AACCAATAAGG
AAACCTGCAAA -> AACCTGCAAAC
AAACGATACGT -> AACGATACGTT
AAACGGTGCGG -> AACGGTGCGGG
AAACTCCCTAT -> AACTCCCTATG
AAACTTGAAGG -> AACTTGAAGGA
AAAGAATCGTT -> AAGAATCGTTA
AAAGACGAGCA -> AAGACGAGCAC
AAAGAGCACAA -> AAGAGCACAAT
AAAGCTTGTAC -> AAGCTTGTACG
AAATATAGAGA -> AATATAGAGAT
AAATATGGATC -> AATATGGATCC
AAATCAACTTT -> AATCAACTTTG
AAATCAGGCCT -> AATCAGGCCTA
AAATCCATTAG -> AATCCATTAGA
AAATCGTGGCT -> AATCGTGGCTG
AAATGAGATAG -> AATGAGATAGG
AAATGCTACGC -> AATGCTACGCC
AAATGCTCTTT -> AATGCTCTTTG
AAATTAGTGGT -> AATTAGTGGTC
AAATTATAGCT -> AATTATAGCTA
AAATTCATTTA -> AATTCATTTAT
AAATTGAGCCG -> AATTGAGCCGC
AACAAAGACGA -> ACAAAGACGAG
AACACCACCTC -> ACACCACCTCG
AACACCAGGAC -> ACACCAGGACA
AACACCGTTGA -> ACACCGTTGAC
AACACCTACCC -> ACACCTACCCA
AACATAATTAA -> ACATAATTAAG
AACATCATGAC -> ACATCATGACC
AACCAAGCTAG -> ACCAAGCTAGT
AACCAATAAGG -> ACCAATAAGGG
AACCCTCGCTC -> ACCCTCGCTCC
AACCTACTTGG -> ACCTACTTGGC
AACCTAGACCC -> ACCTAGACCCA
AACCTGCAAAC -> ACCTGCAAACC
AACCTGCGGCG -> ACCTGCGGCGC
AACCTGTTTTC -> ACCTGTTTTCG
AACCTTCAGAC -> ACCTTCAGACG
AACGACAGTCT -> ACGACAGTCTA
AACGATACGTT -> ACGATACGTTG
AACGATCCGTG -> ACGATCCGTGA
AACGCACACCC -> ACGCACACCCG
AACGGGAAATC -> ACGGGAAATCA
AACGGTGCGGG -> ACGGTGCGGGA
AACTAATCCTG -> ACTAATCCTGG
AACTCAGCGAT -> ACTCAGCGATT
AACTCCCTATG -> ACTCCCTATGT
AACTGATATAC -> ACTGATATACC
AACTTACGGTC -> ACTTACGGTCC
AACTTATAACC -> ACTTATAACCT
AACTTGAAGGA -> ACTTGAAGGAA
AACTTTGCATG -> ACTTTGCATGT
AAGAATCGTTA -> AGAATCGTTAC
AAGACGAGCAC -> AGACGAGCACC
AAGACGTTGTA -> AGACGTTGTAG
AAGAGCACAAT -> AGAGCACAATT
AAGAGCTTTCC -> AGAGCTTTCCT
AAGATAACCTA -> AGATAACCTAC
AAGATGCATGA -> AGATGCATGAG
AAGATTAAACT -> AGATTAAACTT
AAGCATTGTAC -> AGCATTGTACA
AAGCCTAAATG -> AGCCTAAATGC
AAGCCTCTAGG -> AGCCTCTAGGT
AAGCGAAACTC -> AGCGAAACTCC
AAGCTAGTTTT -> AGCTAGTTTTC
AAGCTTGTACG -> AGCTTGTACGA
AAGGAACCCTC -> AGGAACCCTCG
AAGGAAGATAA -> AGGAAGATAAC
AAGGACACAAC -> AGGACACAACT
AAGGGCCATCA -> AGGGCCATCAC
AAGGGGGGAGG -> AGGGGGGAGGT
AAGTAATTACG -> AGTAATTACGG
AAGTACGCAAT -> AGTACGCAATT
AAGTAGCCACC -> AGTAGCCACCG
AAGTCGGAGCC -> AGTCGGAGCCA
AAGTTAGATAT -> AGTTAGATATT
AAGTTGGTTCT -> AGTTGGTTCTC
AAGTTGTCCAA -> AGTTGTCCAAA
AAGTTTTTGGT -> AGTTTTTGGTT
AATAAATGAGA -> ATAAATGAGAT
AATAAATTAGT -> ATAAATTAGTG
AATAAGGGCCA -> ATAAGGGCCAT
AATACCCAACA -> ATACCCAACAA
AATAGATCCGG -> ATAGATCCGGT
AATATAGAGAT -> ATATAGAGATT
AATATCTTCTG -> ATATCTTCTGA
AATATGGATCC -> ATATGGATCCA
AATATTTAATG -> ATATTTAATGA
AATCAACTTTG -> ATCAACTTTGC
AATCAAGATGC -> ATCAAGATGCA
AATCAGGCCTA -> ATCAGGCCTAT
AATCAGTACAT -> ATCAGTACATA
AATCAGTATTA -> ATCAGTATTAC
AATCCATTAGA -> ATCCATTAGAT
AATCCCGTCGG -> ATCCCGTCGGG
AATCCTGGTAG -> ATCCTGGTAGT
AATCGTGGCTG -> ATCGTGGCTGG
AATCGTTACAA -> ATCGTTACAAG
AATCTACCGGG -> ATCTACCGGGT
AATCTTTTCAG -> ATCTTTTCAGG
AATGAAAAGAA -> ATGAAAAGAAT
AATGAGATAGG -> ATGAGATAGGT
AATGATTTATG -> ATGATTTATGG
AATGCAACACC -> ATGCAACACCA
AATGCATCGGA -> ATGCATCGGAA
AATGCTACGCC -> ATGCTACGCCT
AATGCTCTTTG -> ATGCTCTTTGA
AATTAAGCCTA -> ATTAAGCCTAA
AATTACGGCGG -> ATTACGGCGGT
AATTACTTATT -> ATTACTTATTT
AATTAGCAATA -> ATTAGCAATAA
AATTAGTGGTC -> ATTAGTGGTCT
AATTATAGCTA -> ATTATAGCTAT
AATTCATTTAT -> ATTCATTTATT
AATTGAGCCGC -> ATTGAGCCGCT
AATTGGCCTAG -> ATTGGCCTAGG
ACAAAGACGAG -> CAAAGACGAGC
ACAACGATCCG -> CAACGATCCGT
ACAACTTACGG -> CAACTTACGGT
ACAACTTATAA -> CAACTTATAAC
ACAAGCGAAAC -> CAAGCGAAACT
ACAAGTCGGAG -> CAAGTCGGAGC
ACAAGTTGGTT -> CAAGTTGGTTC
ACAATCAGTAT -> CAATCAGTATT
ACAATTGGCCT -> CAATTGGCCTA
ACACAACTTAT -> CACAACTTATA
ACACCACCTCG -> CACCACCTCGC
ACACCAGGACA -> CACCAGGACAT
ACACCCGTGTT -> CACCCGTGTTT
ACACCGTTGAC -> CACCGTTGACT
ACACCTACCCA -> CACCTACCCAC
ACACCTTCGGA -> CACCTTCGGAA
ACACCTTCTTA -> CACCTTCTTAA
ACACTACAAGT -> CACTACAAGTT
ACAGAATACCC -> CAGAATACCCA
ACAGTACCGGA -> CAGTACCGGAC
ACAGTCTACGA -> CAGTCTACGAT
ACATAAGATTA -> CATAAGATTAA
ACATAATTAAG -> CATAATTAAGC
ACATACTTCAA -> CATACTTCAAG
ACATCATACGG -> CATCATACGGT
ACATCATGACC -> CATCATGACCT
ACATCGTGCCA -> CATCGTGCCAA
ACATGGCTCTC -> CATGGCTCTCC
ACATTAGGTTT -> CATTAGGTTTG
ACATTATCTAG -> CATTATCTAGT
ACATTTAGTCC -> CATTTAGTCCA
ACATTTTGAAA -> CATTTTGAAAC
ACCAAGCTAGT -> CCAAGCTAGTT
ACCAATAAGGG -> CCAATAAGGGC
ACCACATTATC -> CCACATTATCT
ACCACCTCGCG -> CCACCTCGCGC
ACCAGGACATC -> CCAGGACATCG
ACCCAACAAAG -> CCCAACAAAGA
ACCCACTGCGG -> CCCACTGCGGG
ACCCATACGCA -> CCCATACGCAC
ACCCCATACCA -> CCCCATACCAC
ACCCCATTTCT -> CCCCATTTCTT
ACCCGTGTTTT -> CCCGTGTTTTG
ACCCTATATGT -> CCCTATATGTC
ACCCTCGCTCC -> CCCTCGCTCCG
ACCCTTAAGGG -> CCCTTAAGGGG
ACCGAAACCTG -> CCGAAACCTGC
ACCGACAGAAT -> CCGACAGAATA
ACCGCAGAGGC -> CCGCAGAGGCA
ACCGGACGTCG -> CCGGACGTCGT
ACCGGCGATGA -> CCGGCGATGAA
ACCGGGCGCGG -> CCGGGCGCGGG
ACCGGGTCACC -> CCGGGTCACCT
ACCGTTGACTC -> CCGTTGACTCC
ACCTAACGACA -> CCTAACGACAG
ACCTACCCACT -> CCTACCCACTG
ACCTACTTGGC -> CCTACTTGGCC
ACCTAGACCCA -> CCTAGACCCAT
ACCTAGACTAT -> CCTAGACTATA
ACCTCATTAGA -> CCTCATTAGAC
ACCTCGCGCGA -> CCTCGCGCGAT
ACCTGAGAATC -> CCTGAGAATCA
ACCTGCAAACC -> CCTGCAAACCA
ACCTGCGGCGC -> CCTGCGGCGCG
ACCTGTTTGTG -> CCTGTTTGTGA
ACCTGTTTTCG -> CCTGTTTTCGG
ACCTTCAGACG -> CCTTCAGACGA
ACCTTCGGAAA -> CCTTCGGAAAG
ACCTTCTTAAT -> CCTTCTTAATT
ACGAAATCAGG -> CGAAATCAGGC
ACGAAGCTCCC -> CGAAGCTCCCT
ACGAATGCAAC -> CGAATGCAACA
ACGACAGTCTA -> CGACAGTCTAC
ACGAGCACCCT -> CGAGCACCCTT
ACGATAACATC -> CGATAACATCA
ACGATACGTTG -> CGATACGTTGA
ACGATCCGTGA -> CGATCCGTGAG
ACGATCGGCCC -> CGATCGGCCCC
ACGCAATTAGC -> CGCAATTAGCA
ACGCACACCCG -> CGCACACCCGT
ACGCACGTCCA -> CGCACGTCCAA
ACGCCTCTAAG -> CGCCTCTAAGT
ACGCGTATTTG -> CGCGTATTTGT
ACGCTCGCCGG -> CGCTCGCCGGT
ACGCTTCCTGC -> CGCTTCCTGCT
ACGGAGGCTCA -> CGGAGGCTCAT
ACGGATTACGG -> CGGATTACGGA
ACGGCGGTGGC -> CGGCGGTGGCG
ACGGCTTTCCC -> CGGCTTTCCCG
ACGGGAAATCA -> CGGGAAATCAA
ACGGTAGACAA -> CGGTAGACAAC
ACGGTCATAAA -> CGGTCATAAAC
ACGGTCCCTGA -> CGGTCCCTGAC
ACGGTGCGGGA -> CGGTGCGGGAA
ACGTCCAAATT -> CGTCCAAATTA
ACGTCGGTGGC -> CGTCGGTGGCG
ACGTCGTGCGT -> CGTCGTGCGTC
ACGTGCAAAAC -> CGTGCAAAACA
ACGTGGATAGT -> CGTGGATAGTC
ACGTTCGGCGG -> CGTTCGGCGGT
ACGTTGACGTT -> CGTTGACGTTC
ACGTTGTAGCA -> CGTTGTAGCAA
ACGTTGTCTAG -> CGTTGTCTAGG
ACTAAGTTGTC -> CTAAGTTGTCC
ACTAATCCTGG -> CTAATCCTGGT
ACTAATGCATC -> CTAATGCATCG
ACTACAAGTTG -> CTACAAGTTGG
ACTACGGCTTT -> CTACGGCTTTC
ACTACGTGCAA -> CTACGTGCAAA
ACTAGACTACG -> CTAGACTACGT
ACTATAAATAT -> CTATAAATATG
ACTATTAGGAC -> CTATTAGGACA
ACTCAGCGATT -> CTCAGCGATTG
ACTCCATATAC -> CTCCATATACT
ACTCCCAGTCG -> CTCCCAGTCGC
ACTCCCTATGT -> CTCCCTATGTG
ACTCGCCAACC -> CTCGCCAACCT
ACTCGCTCAGG -> CTCGCTCAGGT
ACTGACGAAGC -> CTGACGAAGCT
ACTGATATACC -> CTGATATACCG
ACTGCGGGACG -> CTGCGGGACGC
ACTGCTCGAGG -> CTGCTCGAGGT
ACTGGGAGGCG -> CTGGGAGGCGT
ACTTACGGTCC -> CTTACGGTCCC
ACTTATAACCT -> CTTATAACCTT
ACTTATTTTTA -> CTTATTTTTAG
ACTTCAAGGAC -> CTTCAAGGACA
ACTTCACATGG -> CTTCACATGGC
ACTTCGCCGCA -> CTTCGCCGCAC
ACTTGAAGGAA -> CTTGAAGGAAG
ACTTGACTCCC -> CTTGACTCCCA
ACTTGGCCTCT -> CTTGGCCTCTA
ACTTTGCATGT -> CTTTGCATGTC
AGAAATTCATT -> GAAATTCATTT
AGAACTAATCC -> GAACTAATCCT
AGAATACCCAA -> GAATACCCAAC
AGAATCAGTAC -> GAATCAGTACA
AGAATCGTTAC -> GAATCGTTACA
AGAATCTTTTC -> GAATCTTTTCA
AGACAACGATC -> GACAACGATCC
AGACCCATACG -> GACCCATACGC
AGACCGGGCGC -> GACCGGGCGCG
AGACGAATGCA -> GACGAATGCAA
AGACGAGCACC -> GACGAGCACCC
AGACGATAACA -> GACGATAACAT
AGACGCGTATT -> GACGCGTATTT
AGACGTTGTAG -> GACGTTGTAGC
AGACTACGTGC -> GACTACGTGCA
AGACTATAAAT -> GACTATAAATA
AGACTCGCCAA -> GACTCGCCAAC
AGACTGACGAA -> GACTGACGAAG
AGAGATTCGAT -> GAGATTCGATC
AGAGCACAATT -> GAGCACAATTG
AGAGCACGGAT -> GAGCACGGATT
AGAGCTTTCCT -> GAGCTTTCCTC
AGAGGCAAGGA -> GAGGCAAGGAA
AGAGGCTGTAA -> GAGGCTGTAAG
AGAGTAGCGAG -> GAGTAGCGAGA
AGATAACCTAC -> GATAACCTACT
AGATACAAGCG -> GATACAAGCGA
AGATAGGTTTT -> GATAGGTTTTT
AGATATTCAGG -> GATATTCAGGT
AGATCCGGTCC -> GATCCGGTCCC
AGATGCATGAG -> GATGCATGAGG
AGATTAAACTT -> GATTAAACTTG
AGATTCGATCC -> GATTCGATCCC
AGATTGTGACA -> GATTGTGACAC
AGATTTTCACG -> GATTTTCACGT
AGCAAGTTAGA -> GCAAGTTAGAT
AGCAATAAATG -> GCAATAAATGA
AGCACAATTGG -> GCACAATTGGC
AGCACCCTTAA -> GCACCCTTAAG
AGCACGGATTA -> GCACGGATTAC
AGCAGCGGCAG -> GCAGCGGCAGA
AGCATTGTACA -> GCATTGTACAA
AGCCAATATCT -> GCCAATATCTT
AGCCACCGAAA -> GCCACCGAAAC
AGCCCTTAAGT -> GCCCTTAAGTA
AGCCGCTTCGG -> GCCGCTTCGGG
AGCCTAAATGC -> GCCTAAATGCT
AGCCTACATTA -> GCCTACATTAG
AGCCTCTAGGT -> GCCTCTAGGTG
AGCGAAACTCC -> GCGAAACTCCC
AGCGAGATTGT -> GCGAGATTGTG
AGCGATTGCGG -> GCGATTGCGGA
AGCGCGGTTTA -> GCGCGGTTTAG
AGCGGCAGAGC -> GCGGCAGAGCA
AGCGTTCGATC -> GCGTTCGATCT
AGCTAGTGAGT -> GCTAGTGAGTC
AGCTAGTTTTC -> GCTAGTTTTCT
AGCTATCAGTG -> GCTATCAGTGA
AGCTCACTATT -> GCTCACTATTA
AGCTGCGTTCC -> GCTGCGTTCCG
AGCTTGTACGA -> GCTTGTACGAA
AGCTTTCCTCT -> GCTTTCCTCTG
AGGAACCCTCG -> GGAACCCTCGC
AGGAAGATAAC -> GGAAGATAACC
AGGACACAACT -> GGACACAACTT
AGGACACTACA -> GGACACTACAA
AGGACATCGTG -> GGACATCGTGC
AGGACTAATGC -> GGACTAATGCA
AGGAGCGTTCG -> GGAGCGTTCGA
AGGCAAGGAAC -> GGCAAGGAACC
AGGCACTCGCT -> GGCACTCGCTC
AGGCAGAGGCT -> GGCAGAGGCTG
AGGCCAGCTCA -> GGCCAGCTCAC
AGGCCTATCCA -> GGCCTATCCAT
AGGCGACCCTA -> GGCGACCCTAT
AGGCGTGAGAG -> GGCGTGAGAGT
AGGCTCATGAA -> GGCTCATGAAC
AGGCTGTAAGC -> GGCTGTAAGCA
AGGGCCATCAC -> GGGCCATCACT
AGGGGGGAGGT -> GGGGGGAGGTA
AGGGTAATAGA -> GGGTAATAGAT
AGGGTTACCTA -> GGGTTACCTAA
AGGTAATATTT -> GGTAATATTTA
AGGTACGCTCG -> GGTACGCTCGC
AGGTCTTGACA -> GGTCTTGACAT
AGGTGACTAGA -> GGTGACTAGAC
AGGTTCAACAC -> GGTTCAACACC
AGGTTCCTCGC -> GGTTCCTCGCC
AGGTTCTACTG -> GGTTCTACTGG
AGGTTTGACGT -> GGTTTGACGTG
AGGTTTTTGGA -> GGTTTTTGGAT
AGTAATTACGG -> GTAATTACGGC
AGTACATAAGA -> GTACATAAGAT
AGTACCGGACG -> GTACCGGACGT
AGTACGCAATT -> GTACGCAATTA
AGTAGCCACCG -> GTAGCCACCGA
AGTAGCGAGAT -> GTAGCGAGATT
AGTATTACGGT -> GTATTACGGTA
AGTCCAGCCTA -> GTCCAGCCTAC
AGTCCGGCGCT -> GTCCGGCGCTT
AGTCGCTGGTA -> GTCGCTGGTAT
AGTCGGAGCCA -> GTCGGAGCCAA
AGTCGGGATGG -> GTCGGGATGGC
AGTCGGTAAAA -> GTCGGTAAAAA
AGTCTACGATC -> GTCTACGATCG
AGTCTTAATGA -> GTCTTAATGAA
AGTGACCGGCG -> GTGACCGGCGA
AGTGAGTCTTA -> GTGAGTCTTAA
AGTGATCAATA -> GTGATCAATAA
AGTGCGCTCAC -> GTGCGCTCACT
AGTGGTCTTGT -> GTGGTCTTGTC
AGTTAGATATT -> GTTAGATATTC
AGTTCAGCAGC -> GTTCAGCAGCG
AGTTCGACTGC -> GTTCGACTGCT
AGTTCTGTATG -> GTTCTGTATGA
AGTTCTTCTTA -> GTTCTTCTTAA
AGTTGAAACGA -> GTTGAAACGAT
AGTTGGTTCTC -> GTTGGTTCTCC
AGTTGTCCAAA -> GTTGTCCAAAG
AGTTTTCTAGT -> GTTTTCTAGTG
AGTTTTTGGTT -> GTTTTTGGTTC
ATAAACGGTGC -> TAAACGGTGCG
ATAAATATGGA -> TAAATATGGAT
ATAAATGAGAT -> TAAATGAGATA
ATAAATTAGTG -> TAAATTAGTGG
ATAACATCATG -> TAACATCATGA
ATAACCTACTT -> TAACCTACTTG
ATAACCTTCAG -> TAACCTTCAGA
ATAAGATTAAA -> TAAGATTAAAC
ATAAGGGCCAT -> TAAGGGCCATC
ATAATTAAGCC -> TAATTAAGCCT
ATACAAGCGAA -> TACAAGCGAAA
ATACCACATTA -> TACCACATTAT
ATACCCAACAA -> TACCCAACAAA
ATACCGACAGA -> TACCGACAGAA
ATACGCACGTC -> TACGCACGTCC
ATACGGTCATA -> TACGGTCATAA
ATACGTCGGTG -> TACGTCGGTGG
ATACGTTGACG -> TACGTTGACGT
ATACTAAGTTG -> TACTAAGTTGT
ATACTTCAAGG -> TACTTCAAGGA
ATAGAGATTCG -> TAGAGATTCGA
ATAGATCCGGT -> TAGATCCGGTC
ATAGCCCTTAA -> TAGCCCTTAAG
ATAGCTATCAG -> TAGCTATCAGT
ATAGGTTTTTG -> TAGGTTTTTGG
ATAGTCGGTAA -> TAGTCGGTAAA
ATATACCGACA -> TATACCGACAG
ATATACTAAGT -> TATACTAAGTT
ATATAGAGATT -> TATAGAGATTC
ATATCTTCTGA -> TATCTTCTGAC
ATATGGATCCA -> TATGGATCCAG
ATATGTCCCAC -> TATGTCCCACC
ATATTCAGGTA -> TATTCAGGTAA
ATATTTAATGA -> TATTTAATGAT
ATCAACTTTGC -> TCAACTTTGCA
ATCAAGATGCA -> TCAAGATGCAT
ATCAATAAATT -> TCAATAAATTA
ATCACATCATA -> TCACATCATAC
ATCACTTCACA -> TCACTTCACAT
ATCAGATTTTC -> TCAGATTTTCA
ATCAGGCCTAT -> TCAGGCCTATC
ATCAGTACATA -> TCAGTACATAA
ATCAGTATTAC -> TCAGTATTACG
ATCAGTGATCA -> TCAGTGATCAA
ATCATACGGTC -> TCATACGGTCA
ATCATGACCTC -> TCATGACCTCA
ATCCAGTCGGG -> TCCAGTCGGGA
ATCCATGGCTC -> TCCATGGCTCT
ATCCATTAGAT -> TCCATTAGATA
ATCCCGTCGGG -> TCCCGTCGGGA
ATCCCTTCTCG -> TCCCTTCTCGC
ATCCGGTCCCT -> TCCGGTCCCTT
ATCCGTGAGTT -> TCCGTGAGTTC
ATCCGTGTGAA -> TCCGTGTGAAC
ATCCTGGTAGT -> TCCTGGTAGTT
ATCGAGACTGA -> TCGAGACTGAC
ATCGCCGGACA -> TCGCCGGACAC
ATCGGAATCAA -> TCGGAATCAAG
ATCGGCCCCAC -> TCGGCCCCACA
ATCGTGCCAAC -> TCGTGCCAACT
ATCGTGGCTGG -> TCGTGGCTGGA
ATCGTTACAAG -> TCGTTACAAGT
ATCTACCGGGT -> TCTACCGGGTC
ATCTAGTTCAG -> TCTAGTTCAGC
ATCTCCGAAGA -> TCTCCGAAGAC
ATCTGAAACCA -> TCTGAAACCAA
ATCTGATTGTT -> TCTGATTGTTG
ATCTTCTGACA -> TCTTCTGACAA
ATCTTTGCTTG -> TCTTTGCTTGG
ATCTTTTCAGG -> TCTTTTCAGGC
ATGAAAAGAAT -> TGAAAAGAATC
ATGAACCTGTT -> TGAACCTGTTT
ATGAACGGGAA -> TGAACGGGAAA
ATGACCCCATT -> TGACCCCATTT
ATGACCTCATT -> TGACCTCATTA
ATGAGATAGGT -> TGAGATAGGTT
ATGAGGGTAAT -> TGAGGGTAATA
ATGATTTATGG -> TGATTTATGGA
ATGCAACACCA -> TGCAACACCAG
ATGCATCGGAA -> TGCATCGGAAT
ATGCATGAGGG -> TGCATGAGGGT
ATGCTACGCCT -> TGCTACGCCTC
ATGCTCATGGC -> TGCTCATGGCT
ATGCTCTTTGA -> TGCTCTTTGAG
ATGGACTTCGC -> TGGACTTCGCC
ATGGATCCAGT -> TGGATCCAGTC
ATGGCACCTGA -> TGGCACCTGAG
ATGGCTCTAGC -> TGGCTCTAGCT
ATGGCTCTCCA -> TGGCTCTCCAG
ATGGCTGGTTA -> TGGCTGGTTAG
ATGTCCCACCG -> TGTCCCACCGC
ATGTCCTCGTT -> TGTCCTCGTTC
ATGTGCATTGA -> TGTGCATTGAT
ATGTTCTAGGC -> TGTTCTAGGCA
ATTAAACTTGA -> TTAAACTTGAA
ATTAAGCCTAA -> TTAAGCCTAAA
ATTACGGAGGC -> TTACGGAGGCT
ATTACGGCGGT -> TTACGGCGGTG
ATTACGGTAGA -> TTACGGTAGAC
ATTACTTATTT -> TTACTTATTTT
ATTAGACGAAT -> TTAGACGAATG
ATTAGATACAA -> TTAGATACAAG
ATTAGCAATAA -> TTAGCAATAAA
ATTAGGACACT -> TTAGGACACTA
ATTAGGTTTGA -> TTAGGTTTGAC
ATTAGTGGTCT -> TTAGTGGTCTT
ATTATAGCTAT -> TTATAGCTATC
ATTATCTAGTT -> TTATCTAGTTC
ATTCAGAAATT -> TTCAGAAATTC
ATTCAGGTAAT -> TTCAGGTAATA
ATTCATTTATT -> TTCATTTATTT
ATTCGAGTTGA -> TTCGAGTTGAA
ATTCGATCCCT -> TTCGATCCCTT
ATTCTATCGCC -> TTCTATCGCCG
ATTGAGCCGCT -> TTGAGCCGCTT
ATTGATCTGAA -> TTGATCTGAAA
ATTGCGGAGGA -> TTGCGGAGGAC
ATTGGCCTAGG -> TTGGCCTAGGA
ATTGTACAATC -> TTGTACAATCA
ATTGTGACACC -> TTGTGACACCT
ATTGTTGAGTC -> TTGTTGAGTCC
ATTTAATGATT -> TTTAATGATTT
ATTTAGTCCAG -> TTTAGTCCAGC
ATTTAGTGCGC -> TTTAGTGCGCT
ATTTATGGACT -> TTTATGGACTT
ATTTATTTAGT -> TTTATTTAGTG
ATTTCTTGTAT -> TTTCTTGTATC
ATTTGTATCTT -> TTTGTATCTTT
ATTTTATGCTC -> TTTTATGCTCA
ATTTTCACGTT -> TTTTCACGTTG
ATTTTGAAACA -> TTTTGAAACAC
ATTTTTAGACT -> TTTTTAGACTC
CAAAACATAAT -> AAAACATAATT
CAAACCAATAA -> AAACCAATAAG
CAAAGACGAGC -> AAAGACGAGCA
CAAAGCTTGTA -> AAAGCTTGTAC
CAAATATAGAG -> AAATATAGAGA
CAAATTATAGC -> AAATTATAGCT
CAACAAAGACG -> AACAAAGACGA
CAACACCAGGA -> AACACCAGGAC
CAACACCGTTG -> AACACCGTTGA
CAACCTGCGGC -> AACCTGCGGCG
CAACGATCCGT -> AACGATCCGTG
CAACTGATATA -> AACTGATATAC
CAACTTACGGT -> AACTTACGGTC
CAACTTATAAC -> AACTTATAACC
CAACTTTGCAT -> AACTTTGCATG
CAAGAGCTTTC -> AAGAGCTTTCC
CAAGATGCATG -> AAGATGCATGA
CAAGCGAAACT -> AAGCGAAACTC
CAAGCTAGTTT -> AAGCTAGTTTT
CAAGGAACCCT -> AAGGAACCCTC
CAAGGACACAA -> AAGGACACAAC
CAAGTCGGAGC -> AAGTCGGAGCC
CAAGTTAGATA -> AAGTTAGATAT
CAAGTTGGTTC -> AAGTTGGTTCT
CAATAAATGAG -> AATAAATGAGA
CAATAAATTAG -> AATAAATTAGT
CAATAAGGGCC -> AATAAGGGCCA
CAATATCTTCT -> AATATCTTCTG
CAATCAGTATT -> AATCAGTATTA
CAATCTACCGG -> AATCTACCGGG
CAATTAGCAAT -> AATTAGCAATA
CAATTGGCCTA -> AATTGGCCTAG
CACAACTTATA -> ACAACTTATAA
CACAATTGGCC -> ACAATTGGCCT
CACACCCGTGT -> ACACCCGTGTT
CACAGTACCGG -> ACAGTACCGGA
CACATCATACG -> ACATCATACGG
CACATGGCTCT -> ACATGGCTCTC
CACATTATCTA -> ACATTATCTAG
CACCACCTCGC -> ACCACCTCGCG
CACCAGGACAT -> ACCAGGACATC
CACCCGTGTTT -> ACCCGTGTTTT
CACCCTTAAGG -> ACCCTTAAGGG
CACCGAAACCT -> ACCGAAACCTG
CACCGCAGAGG -> ACCGCAGAGGC
CACCGTTGACT -> ACCGTTGACTC
CACCTACCCAC -> ACCTACCCACT
CACCTAGACTA -> ACCTAGACTAT
CACCTCGCGCG -> ACCTCGCGCGA
CACCTGAGAAT -> ACCTGAGAATC
CACCTTCGGAA -> ACCTTCGGAAA
CACCTTCTTAA -> ACCTTCTTAAT
CACGGATTACG -> ACGGATTACGG
CACGTCCAAAT -> ACGTCCAAATT
CACGTTGTCTA -> ACGTTGTCTAG
CACTACAAGTT -> ACTACAAGTTG
CACTACGGCTT -> ACTACGGCTTT
CACTATTAGGA -> ACTATTAGGAC
CACTCGCTCAG -> ACTCGCTCAGG
CACTGCGGGAC -> ACTGCGGGACG
CACTTCACATG -> ACTTCACATGG
CACTTGACTCC -> ACTTGACTCCC
CAGAAATTCAT -> AGAAATTCATT
CAGAATACCCA -> AGAATACCCAA
CAGACGATAAC -> AGACGATAACA
CAGAGCACGGA -> AGAGCACGGAT
CAGAGGCAAGG -> AGAGGCAAGGA
CAGAGGCTGTA -> AGAGGCTGTAA
CAGATTTTCAC -> AGATTTTCACG
CAGCAGCGGCA -> AGCAGCGGCAG
CAGCCTACATT -> AGCCTACATTA
CAGCGATTGCG -> AGCGATTGCGG
CAGCGGCAGAG -> AGCGGCAGAGC
CAGCTCACTAT -> AGCTCACTATT
CAGGACATCGT -> AGGACATCGTG
CAGGCCTATCC -> AGGCCTATCCA
CAGGCGACCCT -> AGGCGACCCTA
CAGGGTTACCT -> AGGGTTACCTA
CAGGTAATATT -> AGGTAATATTT
CAGGTTCCTCG -> AGGTTCCTCGC
CAGTACATAAG -> AGTACATAAGA
CAGTACCGGAC -> AGTACCGGACG
CAGTATTACGG -> AGTATTACGGT
CAGTCGCTGGT -> AGTCGCTGGTA
CAGTCGGGATG -> AGTCGGGATGG
CAGTCTACGAT -> AGTCTACGATC
CAGTGATCAAT -> AGTGATCAATA
CAGTTCGACTG -> AGTTCGACTGC
CATAAACGGTG -> ATAAACGGTGC
CATAAGATTAA -> ATAAGATTAAA
CATAATTAAGC -> ATAATTAAGCC
CATACCACATT -> ATACCACATTA
CATACGCACGT -> ATACGCACGTC
CATACGGTCAT -> ATACGGTCATA
CATACTTCAAG -> ATACTTCAAGG
CATATACTAAG -> ATATACTAAGT
CATCACTTCAC -> ATCACTTCACA
CATCATACGGT -> ATCATACGGTC
CATCATGACCT -> ATCATGACCTC
CATCCGTGTGA -> ATCCGTGTGAA
CATCGGAATCA -> ATCGGAATCAA
CATCGTGCCAA -> ATCGTGCCAAC
CATGAACGGGA -> ATGAACGGGAA
CATGACCTCAT -> ATGACCTCATT
CATGAGGGTAA -> ATGAGGGTAAT
CATGGCTCTAG -> ATGGCTCTAGC
CATGGCTCTCC -> ATGGCTCTCCA
CATGGCTGGTT -> ATGGCTGGTTA
CATGTCCTCGT -> ATGTCCTCGTT
CATTAGACGAA -> ATTAGACGAAT
CATTAGATACA -> ATTAGATACAA
CATTAGGTTTG -> ATTAGGTTTGA
CATTATCTAGT -> ATTATCTAGTT
CATTCAGAAAT -> ATTCAGAAATT
CATTCTATCGC -> ATTCTATCGCC
CATTGATCTGA -> ATTGATCTGAA
CATTGTACAAT -> ATTGTACAATC
CATTTAGTCCA -> ATTTAGTCCAG
CATTTATTTAG -> ATTTATTTAGT
CATTTCTTGTA -> ATTTCTTGTAT
CATTTTGAAAC -> ATTTTGAAACA
CCAAAGCTTGT -> CAAAGCTTGTA
CCAAATATAGA -> CAAATATAGAG
CCAAATTATAG -> CAAATTATAGC
CCAACAAAGAC -> CAACAAAGACG
CCAACCTGCGG -> CAACCTGCGGC
CCAACTGATAT -> CAACTGATATA
CCAAGCTAGTT -> CAAGCTAGTTT
CCAATAAGGGC -> CAATAAGGGCC
CCAATATCTTC -> CAATATCTTCT
CCACAGTACCG -> CACAGTACCGG
CCACATTATCT -> CACATTATCTA
CCACCGAAACC -> CACCGAAACCT
CCACCGCAGAG -> CACCGCAGAGG
CCACCTCGCGC -> CACCTCGCGCG
CCACTGCGGGA -> CACTGCGGGAC
CCAGCCTACAT -> CAGCCTACATT
CCAGCTCACTA -> CAGCTCACTAT
CCAGGACATCG -> CAGGACATCGT
CCAGGGTTACC -> CAGGGTTACCT
CCAGTCGCTGG -> CAGTCGCTGGT
CCAGTCGGGAT -> CAGTCGGGATG
CCATACCACAT -> CATACCACATT
CCATACGCACG -> CATACGCACGT
CCATATACTAA -> CATATACTAAG
CCATCACTTCA -> CATCACTTCAC
CCATGGCTCTA -> CATGGCTCTAG
CCATTAGATAC -> CATTAGATACA
CCATTTCTTGT -> CATTTCTTGTA
CCCAACAAAGA -> CCAACAAAGAC
CCCACAGTACC -> CCACAGTACCG
CCCACCGCAGA -> CCACCGCAGAG
CCCACTGCGGG -> CCACTGCGGGA
CCCAGTCGCTG -> CCAGTCGCTGG
CCCATACCACA -> CCATACCACAT
CCCATACGCAC -> CCATACGCACG
CCCATTTCTTG -> CCATTTCTTGT
CCCCACAGTAC -> CCCACAGTACC
CCCCATACCAC -> CCCATACCACA
CCCCATTTCTT -> CCCATTTCTTG
CCCGAGGTCTT -> CCGAGGTCTTG
CCCGTCGGGAC -> CCGTCGGGACC
CCCGTGTTTTG -> CCGTGTTTTGT
CCCTATATGTC -> CCTATATGTCC
CCCTATGTGCA -> CCTATGTGCAT
CCCTCGCTCCG -> CCTCGCTCCGA
CCCTGACATTT -> CCTGACATTTT
CCCTTAAGGGG -> CCTTAAGGGGG
CCCTTAAGTAG -> CCTTAAGTAGC
CCCTTCTCGCC -> CCTTCTCGCCG
CCCTTGCCAAA -> CCTTGCCAAAT
CCGAAACCTGC -> CGAAACCTGCA
CCGAAATCCAT -> CGAAATCCATT
CCGAAGACGTT -> CGAAGACGTTG
CCGACAGAATA -> CGACAGAATAC
CCGAGGTCTTG -> CGAGGTCTTGA
CCGATTCGAGT -> CGATTCGAGTT
CCGCACTACGG -> CGCACTACGGC
CCGCAGAGGCA -> CGCAGAGGCAA
CCGCCTAGAAT -> CGCCTAGAATC
CCGCTTCGGGT -> CGCTTCGGGTT
CCGGACACCTT -> CGGACACCTTC
CCGGACGTCGT -> CGGACGTCGTG
CCGGATAGCCC -> CGGATAGCCCT
CCGGCGATGAA -> CGGCGATGAAC
CCGGCGCTTTC -> CGGCGCTTTCT
CCGGGCGCGGG -> CGGGCGCGGGG
CCGGGTCACCT -> CGGGTCACCTA
CCGGTAAAATC -> CGGTAAAATCG
CCGGTAACGCA -> CGGTAACGCAC
CCGGTCCCTTG -> CGGTCCCTTGC
CCGTCGGGACC -> CGTCGGGACCT
CCGTGAGTTCT -> CGTGAGTTCTT
CCGTGTGAACC -> CGTGTGAACCT
CCGTGTTTTGT -> CGTGTTTTGTA
CCGTTGACTCC -> CGTTGACTCCA
CCTAAATGCTC -> CTAAATGCTCT
CCTAACGACAG -> CTAACGACAGT
CCTACATTAGG -> CTACATTAGGT
CCTACCCACTG -> CTACCCACTGC
CCTACTTGGCC -> CTACTTGGCCT
CCTAGAATCTT -> CTAGAATCTTT
CCTAGACCCAT -> CTAGACCCATA
CCTAGACTATA -> CTAGACTATAA
CCTAGGAGCGT -> CTAGGAGCGTT
CCTATATGTCC -> CTATATGTCCC
CCTATCCATGG -> CTATCCATGGC
CCTATGTGCAT -> CTATGTGCATT
CCTCATTAGAC -> CTCATTAGACG
CCTCGCCTCTT -> CTCGCCTCTTA
CCTCGCGCGAT -> CTCGCGCGATC
CCTCGCTCCGA -> CTCGCTCCGAT
CCTCGTTCTCG -> CTCGTTCTCGA
CCTCTAAATGC -> CTCTAAATGCT
CCTCTAAGTTT -> CTCTAAGTTTT
CCTCTAGGTGA -> CTCTAGGTGAC
CCTCTGCAGTT -> CTCTGCAGTTC
CCTCTTAGACC -> CTCTTAGACCG
CCTGACATTTT -> CTGACATTTTG
CCTGAGAATCA -> CTGAGAATCAG
CCTGCAAACCA -> CTGCAAACCAA
CCTGCGGCGCG -> CTGCGGCGCGG
CCTGCTTTGCA -> CTGCTTTGCAA
CCTGGTAGTTC -> CTGGTAGTTCT
CCTGTTTGTGA -> CTGTTTGTGAA
CCTGTTTTCGG -> CTGTTTTCGGT
CCTTAAGGGGG -> CTTAAGGGGGG
CCTTAAGTAGC -> CTTAAGTAGCC
CCTTCAGACGA -> CTTCAGACGAT
CCTTCGGAAAG -> CTTCGGAAAGA
CCTTCTCGCCG -> CTTCTCGCCGG
CCTTCTTAATT -> CTTCTTAATTA
CCTTGCCAAAT -> CTTGCCAAATA
CGAAACCTGCA -> GAAACCTGCAA
CGAAACTCCCT -> GAAACTCCCTA
CGAAATCAGGC -> GAAATCAGGCC
CGAAATCCATT -> GAAATCCATTA
CGAAGACGTTG -> GAAGACGTTGT
CGAATGCAACA -> GAATGCAACAC
CGACAGAATAC -> GACAGAATACC
CGACAGTCTAC -> GACAGTCTACG
CGACCCTATAT -> GACCCTATATG
CGACTGCTCGA -> GACTGCTCGAG
CGAGACTGACG -> GAGACTGACGA
CGAGATTGTGA -> GAGATTGTGAC
CGAGCACCCTT -> GAGCACCCTTA
CGAGGTCTTGA -> GAGGTCTTGAC
CGAGGTTCAAC -> GAGGTTCAACA
CGAGTTGAAAC -> GAGTTGAAACG
CGATAACATCA -> GATAACATCAT
CGATACGTCGG -> GATACGTCGGT
CGATACGTTGA -> GATACGTTGAC
CGATCAGATTT -> GATCAGATTTT
CGATCCCTTCT -> GATCCCTTCTC
CGATCCGTGAG -> GATCCGTGAGT
CGATCGAGACT -> GATCGAGACTG
CGATCGGCCCC -> GATCGGCCCCA
CGATCTGATTG -> GATCTGATTGT
CGATGAACCTG -> GATGAACCTGT
CGATTCGAGTT -> GATTCGAGTTG
CGATTGCGGAG -> GATTGCGGAGG
CGCAATTAGCA -> GCAATTAGCAA
CGCACACCCGT -> GCACACCCGTG
CGCACGTCCAA -> GCACGTCCAAA
CGCACTACGGC -> GCACTACGGCT
CGCAGAGGCAA -> GCAGAGGCAAG
CGCCAACCTGC -> GCCAACCTGCG
CGCCGCACTAC -> GCCGCACTACG
CGCCGGACACC -> GCCGGACACCT
CGCCGGTAAAA -> GCCGGTAAAAT
CGCCGGTAACG -> GCCGGTAACGC
CGCCTAGAATC -> GCCTAGAATCT
CGCCTCTAAGT -> GCCTCTAAGTT
CGCCTCTTAGA -> GCCTCTTAGAC
CGCGATCAGAT -> GCGATCAGATT
CGCGCGATCAG -> GCGCGATCAGA
CGCGGGGCTCG -> GCGGGGCTCGG
CGCGGTAGCTA -> GCGGTAGCTAG
CGCGGTTTAGA -> GCGGTTTAGAA
CGCGTATTTGT -> GCGTATTTGTA
CGCTCACTTGA -> GCTCACTTGAC
CGCTCAGGTTC -> GCTCAGGTTCC
CGCTCCGATTC -> GCTCCGATTCG
CGCTCGCCGGT -> GCTCGCCGGTA
CGCTGGTATTT -> GCTGGTATTTT
CGCTTCCTGCT -> GCTTCCTGCTT
CGCTTCGGGTT -> GCTTCGGGTTC
CGCTTTCTAAC -> GCTTTCTAACA
CGGAAAGAGCA -> GGAAAGAGCAC
CGGAATCAAGA -> GGAATCAAGAT
CGGACACCTTC -> GGACACCTTCT
CGGACGTCGTG -> GGACGTCGTGC
CGGAGCCAATA -> GGAGCCAATAT
CGGAGGACTAA -> GGAGGACTAAT
CGGAGGCTCAT -> GGAGGCTCATG
CGGATAGCCCT -> GGATAGCCCTT
CGGATTACGGA -> GGATTACGGAG
CGGCAGAGCAC -> GGCAGAGCACG
CGGCCCCACAG -> GGCCCCACAGT
CGGCGATGAAC -> GGCGATGAACC
CGGCGCGGTAG -> GGCGCGGTAGC
CGGCGCTTTCT -> GGCGCTTTCTA
CGGCGGTACAT -> GGCGGTACATT
CGGCGGTGGCG -> GGCGGTGGCGT
CGGCTTTCCCG -> GGCTTTCCCGA
CGGGAAATCAA -> GGGAAATCAAC
CGGGAATCCCG -> GGGAATCCCGT
CGGGACCTGTT -> GGGACCTGTTT
CGGGACGCTTC -> GGGACGCTTCC
CGGGATGGCAC -> GGGATGGCACC
CGGGCGCGGGG -> GGGCGCGGGGC
CGGGGCTCGGT -> GGGGCTCGGTC
CGGGTCACCTA -> GGGTCACCTAG
CGGGTTCTAAG -> GGGTTCTAAGC
CGGTAAAAATT -> GGTAAAAATTG
CGGTAAAATCG -> GGTAAAATCGT
CGGTAACGCAC -> GGTAACGCACA
CGGTACATTTA -> GGTACATTTAG
CGGTAGACAAC -> GGTAGACAACG
CGGTAGCTAGT -> GGTAGCTAGTG
CGGTAGGCCAG -> GGTAGGCCAGC
CGGTCAAGAGC -> GGTCAAGAGCT
CGGTCATAAAC -> GGTCATAAACG
CGGTCATCCGT -> GGTCATCCGTG
CGGTCCCTGAC -> GGTCCCTGACA
CGGTCCCTTGC -> GGTCCCTTGCC
CGGTGCGGGAA -> GGTGCGGGAAT
CGGTGGCGGTC -> GGTGGCGGTCA
CGGTGGCGTCG -> GGTGGCGTCGA
CGGTTTAGAAC -> GGTTTAGAACT
CGTATTTGTAT -> GTATTTGTATC
CGTCCAAATTA -> GTCCAAATTAT
CGTCCGAAATC -> GTCCGAAATCC
CGTCGATCGAG -> GTCGATCGAGA
CGTCGGGACCT -> GTCGGGACCTG
CGTCGGTGGCG -> GTCGGTGGCGG
CGTCGTGCGTC -> GTCGTGCGTCC
CGTGAGAGTAG -> GTGAGAGTAGC
CGTGAGTTCTT -> GTGAGTTCTTC
CGTGCAAAACA -> GTGCAAAACAT
CGTGCCAACTG -> GTGCCAACTGA
CGTGCGTCCGA -> GTGCGTCCGAA
CGTGGATAGTC -> GTGGATAGTCG
CGTGGCTGGAC -> GTGGCTGGACC
CGTGTGAACCT -> GTGTGAACCTA
CGTGTTTTGTA -> GTGTTTTGTAG
CGTTACAAGTC -> GTTACAAGTCG
CGTTCCGGATA -> GTTCCGGATAG
CGTTCGATCTG -> GTTCGATCTGA
CGTTCGGCGGT -> GTTCGGCGGTA
CGTTCTCGATA -> GTTCTCGATAC
CGTTGACGTTC -> GTTGACGTTCG
CGTTGACTCCA -> GTTGACTCCAT
CGTTGTAGCAA -> GTTGTAGCAAG
CGTTGTCTAGG -> GTTGTCTAGGC
CTAAATGCTAC -> TAAATGCTACG
CTAAATGCTCT -> TAAATGCTCTT
CTAACACCACC -> TAACACCACCT
CTAACGACAGT -> TAACGACAGTC
CTAAGCCTCTA -> TAAGCCTCTAG
CTAAGTAATTA -> TAAGTAATTAC
CTAAGTTGTCC -> TAAGTTGTCCA
CTAAGTTTTTG -> TAAGTTTTTGG
CTAATCCTGGT -> TAATCCTGGTA
CTAATGCATCG -> TAATGCATCGG
CTACAAGTTGG -> TACAAGTTGGT
CTACATTAGGT -> TACATTAGGTT
CTACCCACTGC -> TACCCACTGCG
CTACCGGGTCA -> TACCGGGTCAC
CTACGATCGGC -> TACGATCGGCC
CTACGCCTCTA -> TACGCCTCTAA
CTACGGCTTTC -> TACGGCTTTCC
CTACGTGCAAA -> TACGTGCAAAA
CTACTGGGAGG -> TACTGGGAGGC
CTACTTGGCCT -> TACTTGGCCTC
CTAGAATCTTT -> TAGAATCTTTT
CTAGACCCATA -> TAGACCCATAC
CTAGACTACGT -> TAGACTACGTG
CTAGACTATAA -> TAGACTATAAA
CTAGCTGCGTT -> TAGCTGCGTTC
CTAGGAGCGTT -> TAGGAGCGTTC
CTAGGCACTCG -> TAGGCACTCGC
CTAGGCAGAGG -> TAGGCAGAGGC
CTAGGTGACTA -> TAGGTGACTAG
CTAGTGACCGG -> TAGTGACCGGC
CTAGTGAGTCT -> TAGTGAGTCTT
CTAGTTCAGCA -> TAGTTCAGCAG
CTAGTTTTCTA -> TAGTTTTCTAG
CTATAAATATG -> TATAAATATGG
CTATATGTCCC -> TATATGTCCCA
CTATCAGTGAT -> TATCAGTGATC
CTATCCATGGC -> TATCCATGGCT
CTATCGCCGGA -> TATCGCCGGAC
CTATGTGCATT -> TATGTGCATTG
CTATTAGGACA -> TATTAGGACAC
CTCACTATTAG -> TCACTATTAGG
CTCACTTGACT -> TCACTTGACTC
CTCAGCGATTG -> TCAGCGATTGC
CTCAGGTTCCT -> TCAGGTTCCTC
CTCATGAACGG -> TCATGAACGGG
CTCATGGCTGG -> TCATGGCTGGT
CTCATTAGACG -> TCATTAGACGA
CTCCAGGGTTA -> TCCAGGGTTAC
CTCCATATACT -> TCCATATACTA
CTCCCAGTCGC -> TCCCAGTCGCT
CTCCCTATGTG -> TCCCTATGTGC
CTCCGAAGACG -> TCCGAAGACGT
CTCCGATTCGA -> TCCGATTCGAG
CTCCGCCTAGA -> TCCGCCTAGAA
CTCGAGGTTCA -> TCGAGGTTCAA
CTCGATACGTC -> TCGATACGTCG
CTCGCCAACCT -> TCGCCAACCTG
CTCGCCGGTAA -> TCGCCGGTAAC,TCGCCGGTAAA
CTCGCCTCTTA -> TCGCCTCTTAG
CTCGCGCGATC -> TCGCGCGATCA
CTCGCTCAGGT -> TCGCTCAGGTT
CTCGCTCCGAT -> TCGCTCCGATT
CTCGGTCAAGA -> TCGGTCAAGAG
CTCGTTCTCGA -> TCGTTCTCGAT
CTCTAAATGCT -> TCTAAATGCTA
CTCTAAGTTTT -> TCTAAGTTTTT
CTCTAGCTGCG -> TCTAGCTGCGT
CTCTAGGTGAC -> TCTAGGTGACT
CTCTCCAGGGT -> TCTCCAGGGTT
CTCTGCAGTTC -> TCTGCAGTTCG
CTCTTAGACCG -> TCTTAGACCGG
CTCTTTGAGCG -> TCTTTGAGCGC
CTGAAACCAAG -> TGAAACCAAGC
CTGACAACTTA -> TGACAACTTAC
CTGACATTTTG -> TGACATTTTGA
CTGACGAAGCT -> TGACGAAGCTC
CTGAGAATCAG -> TGAGAATCAGT
CTGATATACCG -> TGATATACCGA
CTGATTGTTGA -> TGATTGTTGAG
CTGCAAACCAA -> TGCAAACCAAT
CTGCAGTTCGA -> TGCAGTTCGAC
CTGCGGCGCGG -> TGCGGCGCGGT
CTGCGGGACGC -> TGCGGGACGCT
CTGCGTTCCGG -> TGCGTTCCGGA
CTGCTCGAGGT -> TGCTCGAGGTT
CTGCTTTGCAA -> TGCTTTGCAAT
CTGGACCCCAT -> TGGACCCCATA
CTGGCATTCTA -> TGGCATTCTAT
CTGGGAGGCGT -> TGGGAGGCGTG
CTGGTAGTTCT -> TGGTAGTTCTG
CTGGTATTTTA -> TGGTATTTTAT
CTGGTTAGGTT -> TGGTTAGGTTC
CTGTAAGCATT -> TGTAAGCATTG
CTGTATGACCC -> TGTATGACCCC
CTGTTTGTGAA -> TGTTTGTGAAG
CTGTTTTCGGT -> TGTTTTCGGTA
CTTAACTCAGC -> TTAACTCAGCG
CTTAAGGGGGG -> TTAAGGGGGGA
CTTAAGTAGCC -> TTAAGTAGCCA
CTTAATGAAAA -> TTAATGAAAAG
CTTAATTACTT -> TTAATTACTTA
CTTACGGTCCC -> TTACGGTCCCT
CTTAGACCGGG -> TTAGACCGGGC
CTTATAACCTT -> TTATAACCTTC
CTTATTTTTAG -> TTATTTTTAGA
CTTCAAGGACA -> TTCAAGGACAC
CTTCACATGGC -> TTCACATGGCT
CTTCAGACGAT -> TTCAGACGATA
CTTCCTGCTTT -> TTCCTGCTTTG
CTTCGCCGCAC -> TTCGCCGCACT
CTTCGGAAAGA -> TTCGGAAAGAG
CTTCGGGTTCT -> TTCGGGTTCTA
CTTCTCGCCGG -> TTCTCGCCGGT
CTTCTGACAAC -> TTCTGACAACT
CTTCTTAACTC -> TTCTTAACTCA
CTTCTTAATTA -> TTCTTAATTAC
CTTGAAGGAAG -> TTGAAGGAAGA
CTTGACATACT -> TTGACATACTT
CTTGACTCCCA -> TTGACTCCCAG
CTTGCCAAATA -> TTGCCAAATAT
CTTGGCCTCTA -> TTGGCCTCTAA
CTTGGGATCAC -> TTGGGATCACA
CTTGTACGAAA -> TTGTACGAAAT
CTTGTATCTCC -> TTGTATCTCCG
CTTGTCTAAGT -> TTGTCTAAGTA
CTTTCCCGAGG -> TTTCCCGAGGT
CTTTCCTCTGC -> TTTCCTCTGCA
CTTTCTAACAC -> TTTCTAACACC
CTTTGAGCGCG -> TTTGAGCGCGG
CTTTGCAATCT -> TTTGCAATCTA
CTTTGCATGTC -> TTTGCATGTCC
CTTTGCTTGGG -> TTTGCTTGGGA
CTTTTCAGGCG -> TTTTCAGGCGA
GAAAAGAATCG -> AAAAGAATCGT
GAAACACCTAC -> AAACACCTACC
GAAACCAAGCT -> AAACCAAGCTA
GAAACCTGCAA -> AAACCTGCAAA
GAAACGATACG -> AAACGATACGT
GAAACTCCCTA -> AAACTCCCTAT
GAAAGAGCACA -> AAAGAGCACAA
GAAATCAACTT -> AAATCAACTTT
GAAATCAGGCC -> AAATCAGGCCT
GAAATCCATTA -> AAATCCATTAG
GAAATTCATTT -> AAATTCATTTA
GAACCCTCGCT -> AACCCTCGCTC
GAACCTAGACC -> AACCTAGACCC
GAACCTGTTTT -> AACCTGTTTTC
GAACGGGAAAT -> AACGGGAAATC
GAACTAATCCT -> AACTAATCCTG
GAAGACGTTGT -> AAGACGTTGTA
GAAGATAACCT -> AAGATAACCTA
GAAGGAAGATA -> AAGGAAGATAA
GAAGTACGCAA -> AAGTACGCAAT
GAATACCCAAC -> AATACCCAACA
GAATCAAGATG -> AATCAAGATGC
GAATCAGTACA -> AATCAGTACAT
GAATCCCGTCG -> AATCCCGTCGG
GAATCGTTACA -> AATCGTTACAA
GAATCTTTTCA -> AATCTTTTCAG
GAATGCAACAC -> AATGCAACACC
GACAACGATCC -> ACAACGATCCG
GACAACTTACG -> ACAACTTACGG
GACACAACTTA -> ACACAACTTAT
GACACCTTCGG -> ACACCTTCGGA
GACACCTTCTT -> ACACCTTCTTA
GACACTACAAG -> ACACTACAAGT
GACAGAATACC -> ACAGAATACCC
GACAGTCTACG -> ACAGTCTACGA
GACATACTTCA -> ACATACTTCAA
GACATCGTGCC -> ACATCGTGCCA
GACATTTTGAA -> ACATTTTGAAA
GACCCATACGC -> ACCCATACGCA
GACCCCATACC -> ACCCCATACCA
GACCCCATTTC -> ACCCCATTTCT
GACCCTATATG -> ACCCTATATGT
GACCGGCGATG -> ACCGGCGATGA
GACCGGGCGCG -> ACCGGGCGCGG
GACCTCATTAG -> ACCTCATTAGA
GACCTGTTTGT -> ACCTGTTTGTG
GACGAAGCTCC -> ACGAAGCTCCC
GACGAATGCAA -> ACGAATGCAAC
GACGAGCACCC -> ACGAGCACCCT
GACGATAACAT -> ACGATAACATC
GACGCGTATTT -> ACGCGTATTTG
GACGCTTCCTG -> ACGCTTCCTGC
GACGTCGTGCG -> ACGTCGTGCGT
GACGTGGATAG -> ACGTGGATAGT
GACGTTCGGCG -> ACGTTCGGCGG
GACGTTGTAGC -> ACGTTGTAGCA
GACTAATGCAT -> ACTAATGCATC
GACTACGTGCA -> ACTACGTGCAA
GACTAGACTAC -> ACTAGACTACG
GACTATAAATA -> ACTATAAATAT
GACTCCATATA -> ACTCCATATAC
GACTCCCAGTC -> ACTCCCAGTCG
GACTCGCCAAC -> ACTCGCCAACC
GACTGACGAAG -> ACTGACGAAGC
GACTGCTCGAG -> ACTGCTCGAGG
GACTTCGCCGC -> ACTTCGCCGCA
GAGAATCAGTA -> AGAATCAGTAC
GAGACTGACGA -> AGACTGACGAA
GAGAGTAGCGA -> AGAGTAGCGAG
GAGATAGGTTT -> AGATAGGTTTT
GAGATTCGATC -> AGATTCGATCC
GAGATTGTGAC -> AGATTGTGACA
GAGCACAATTG -> AGCACAATTGG
GAGCACCCTTA -> AGCACCCTTAA
GAGCACGGATT -> AGCACGGATTA
GAGCCAATATC -> AGCCAATATCT
GAGCCGCTTCG -> AGCCGCTTCGG
GAGCGCGGTTT -> AGCGCGGTTTA
GAGCGTTCGAT -> AGCGTTCGATC
GAGCTTTCCTC -> AGCTTTCCTCT
GAGGACTAATG -> AGGACTAATGC
GAGGCAAGGAA -> AGGCAAGGAAC
GAGGCGTGAGA -> AGGCGTGAGAG
GAGGCTCATGA -> AGGCTCATGAA
GAGGCTGTAAG -> AGGCTGTAAGC
GAGGGTAATAG -> AGGGTAATAGA
GAGGTACGCTC -> AGGTACGCTCG
GAGGTCTTGAC -> AGGTCTTGACA
GAGGTTCAACA -> AGGTTCAACAC
GAGTAGCGAGA -> AGTAGCGAGAT
GAGTCCGGCGC -> AGTCCGGCGCT
GAGTCTTAATG -> AGTCTTAATGA
GAGTTCTTCTT -> AGTTCTTCTTA
GAGTTGAAACG -> AGTTGAAACGA
GATAACATCAT -> ATAACATCATG
GATAACCTACT -> ATAACCTACTT
GATACAAGCGA -> ATACAAGCGAA
GATACGTCGGT -> ATACGTCGGTG
GATACGTTGAC -> ATACGTTGACG
GATAGCCCTTA -> ATAGCCCTTAA
GATAGGTTTTT -> ATAGGTTTTTG
GATAGTCGGTA -> ATAGTCGGTAA
GATATACCGAC -> ATATACCGACA
GATATTCAGGT -> ATATTCAGGTA
GATCAATAAAT -> ATCAATAAATT
GATCACATCAT -> ATCACATCATA
GATCAGATTTT -> ATCAGATTTTC
GATCCAGTCGG -> ATCCAGTCGGG
GATCCCTTCTC -> ATCCCTTCTCG
GATCCGGTCCC -> ATCCGGTCCCT
GATCCGTGAGT -> ATCCGTGAGTT
GATCGAGACTG -> ATCGAGACTGA
GATCGGCCCCA -> ATCGGCCCCAC
GATCTGAAACC -> ATCTGAAACCA
GATCTGATTGT -> ATCTGATTGTT
GATGAACCTGT -> ATGAACCTGTT
GATGCATGAGG -> ATGCATGAGGG
GATGGCACCTG -> ATGGCACCTGA
GATGTTCTAGG -> ATGTTCTAGGC
GATTAAACTTG -> ATTAAACTTGA
GATTACGGAGG -> ATTACGGAGGC
GATTCGAGTTG -> ATTCGAGTTGA
GATTCGATCCC -> ATTCGATCCCT
GATTGCGGAGG -> ATTGCGGAGGA
GATTGTGACAC -> ATTGTGACACC
GATTGTTGAGT -> ATTGTTGAGTC
GATTTATGGAC -> ATTTATGGACT
GATTTTCACGT -> ATTTTCACGTT
GCAAAACATAA -> CAAAACATAAT
GCAAACCAATA -> CAAACCAATAA
GCAACACCAGG -> CAACACCAGGA
GCAAGGAACCC -> CAAGGAACCCT
GCAAGTTAGAT -> CAAGTTAGATA
GCAATAAATGA -> CAATAAATGAG
GCAATCTACCG -> CAATCTACCGG
GCAATTAGCAA -> CAATTAGCAAT
GCACAATTGGC -> CACAATTGGCC
GCACACCCGTG -> CACACCCGTGT
GCACCCTTAAG -> CACCCTTAAGG
GCACCTGAGAA -> CACCTGAGAAT
GCACGGATTAC -> CACGGATTACG
GCACGTCCAAA -> CACGTCCAAAT
GCACTACGGCT -> CACTACGGCTT
GCACTCGCTCA -> CACTCGCTCAG
GCAGAGCACGG -> CAGAGCACGGA
GCAGAGGCAAG -> CAGAGGCAAGG
GCAGAGGCTGT -> CAGAGGCTGTA
GCAGCGGCAGA -> CAGCGGCAGAG
GCAGTTCGACT -> CAGTTCGACTG
GCATCGGAATC -> CATCGGAATCA
GCATGAGGGTA -> CATGAGGGTAA
GCATGTCCTCG -> CATGTCCTCGT
GCATTCTATCG -> CATTCTATCGC
GCATTGATCTG -> CATTGATCTGA
GCATTGTACAA -> CATTGTACAAT
GCCAAATATAG -> CCAAATATAGA
GCCAACCTGCG -> CCAACCTGCGG
GCCAACTGATA -> CCAACTGATAT
GCCAATATCTT -> CCAATATCTTC
GCCACCGAAAC -> CCACCGAAACC
GCCAGCTCACT -> CCAGCTCACTA
GCCATCACTTC -> CCATCACTTCA
GCCCCACAGTA -> CCCCACAGTAC
GCCCTTAAGTA -> CCCTTAAGTAG
GCCGCACTACG -> CCGCACTACGG
GCCGCTTCGGG -> CCGCTTCGGGT
GCCGGACACCT -> CCGGACACCTT
GCCGGTAAAAT -> CCGGTAAAATC
GCCGGTAACGC -> CCGGTAACGCA
GCCTAAATGCT -> CCTAAATGCTC
GCCTACATTAG -> CCTACATTAGG
GCCTAGAATCT -> CCTAGAATCTT
GCCTAGGAGCG -> CCTAGGAGCGT
GCCTATCCATG -> CCTATCCATGG
GCCTCTAAATG -> CCTCTAAATGC
GCCTCTAAGTT -> CCTCTAAGTTT
GCCTCTAGGTG -> CCTCTAGGTGA
GCCTCTTAGAC -> CCTCTTAGACC
GCGAAACTCCC -> CGAAACTCCCT
GCGACCCTATA -> CGACCCTATAT
GCGAGATTGTG -> CGAGATTGTGA
GCGATCAGATT -> CGATCAGATTT
GCGATGAACCT -> CGATGAACCTG
GCGATTGCGGA -> CGATTGCGGAG
GCGCGATCAGA -> CGCGATCAGAT
GCGCGGGGCTC -> CGCGGGGCTCG
GCGCGGTAGCT -> CGCGGTAGCTA
GCGCGGTTTAG -> CGCGGTTTAGA
GCGCTCACTTG -> CGCTCACTTGA
GCGCTTTCTAA -> CGCTTTCTAAC
GCGGAGGACTA -> CGGAGGACTAA
GCGGCAGAGCA -> CGGCAGAGCAC
GCGGCGCGGTA -> CGGCGCGGTAG
GCGGGAATCCC -> CGGGAATCCCG
GCGGGACGCTT -> CGGGACGCTTC
GCGGGGCTCGG -> CGGGGCTCGGT
GCGGTACATTT -> CGGTACATTTA
GCGGTAGCTAG -> CGGTAGCTAGT
GCGGTCATCCG -> CGGTCATCCGT
GCGGTGGCGTC -> CGGTGGCGTCG
GCGGTTTAGAA -> CGGTTTAGAAC
GCGTATTTGTA -> CGTATTTGTAT
GCGTCCGAAAT -> CGTCCGAAATC
GCGTCGATCGA -> CGTCGATCGAG
GCGTGAGAGTA -> CGTGAGAGTAG
GCGTTCCGGAT -> CGTTCCGGATA
GCGTTCGATCT -> CGTTCGATCTG
GCTACGCCTCT -> CTACGCCTCTA
GCTAGTGAGTC -> CTAGTGAGTCT
GCTAGTTTTCT -> CTAGTTTTCTA
GCTATCAGTGA -> CTATCAGTGAT
GCTCACTATTA -> CTCACTATTAG
GCTCACTTGAC -> CTCACTTGACT
GCTCAGGTTCC -> CTCAGGTTCCT
GCTCATGAACG -> CTCATGAACGG
GCTCATGGCTG -> CTCATGGCTGG
GCTCCGATTCG -> CTCCGATTCGA
GCTCGAGGTTC -> CTCGAGGTTCA
GCTCGCCGGTA -> CTCGCCGGTAA
GCTCGGTCAAG -> CTCGGTCAAGA
GCTCTAGCTGC -> CTCTAGCTGCG
GCTCTCCAGGG -> CTCTCCAGGGT
GCTCTTTGAGC -> CTCTTTGAGCG
GCTGCGTTCCG -> CTGCGTTCCGG
GCTGGACCCCA -> CTGGACCCCAT
GCTGGTATTTT -> CTGGTATTTTA
GCTGGTTAGGT -> CTGGTTAGGTT
GCTGTAAGCAT -> CTGTAAGCATT
GCTTCCTGCTT -> CTTCCTGCTTT
GCTTCGGGTTC -> CTTCGGGTTCT
GCTTGGGATCA -> CTTGGGATCAC
GCTTGTACGAA -> CTTGTACGAAA
GCTTTCCCGAG -> CTTTCCCGAGG
GCTTTCCTCTG -> CTTTCCTCTGC
GCTTTCTAACA -> CTTTCTAACAC
GCTTTGCAATC -> CTTTGCAATCT
GGAAAGAGCAC -> GAAAGAGCACA
GGAAATCAACT -> GAAATCAACTT
GGAACCCTCGC -> GAACCCTCGCT
GGAAGATAACC -> GAAGATAACCT
GGAATCAAGAT -> GAATCAAGATG
GGAATCCCGTC -> GAATCCCGTCG
GGACACAACTT -> GACACAACTTA
GGACACCTTCT -> GACACCTTCTT
GGACACTACAA -> GACACTACAAG
GGACATCGTGC -> GACATCGTGCC
GGACCCCATAC -> GACCCCATACC
GGACCTGTTTG -> GACCTGTTTGT
GGACGCTTCCT -> GACGCTTCCTG
GGACGTCGTGC -> GACGTCGTGCG
GGACTAATGCA -> GACTAATGCAT
GGACTTCGCCG -> GACTTCGCCGC
GGAGCCAATAT -> GAGCCAATATC
GGAGCGTTCGA -> GAGCGTTCGAT
GGAGGACTAAT -> GAGGACTAATG
GGAGGCGTGAG -> GAGGCGTGAGA
GGAGGCTCATG -> GAGGCTCATGA
GGAGGTACGCT -> GAGGTACGCTC
GGATAGCCCTT -> GATAGCCCTTA
GGATAGTCGGT -> GATAGTCGGTA
GGATCACATCA -> GATCACATCAT
GGATCCAGTCG -> GATCCAGTCGG
GGATGGCACCT -> GATGGCACCTG
GGATGTTCTAG -> GATGTTCTAGG
GGATTACGGAG -> GATTACGGAGG
GGCAAGGAACC -> GCAAGGAACCC
GGCACCTGAGA -> GCACCTGAGAA
GGCACTCGCTC -> GCACTCGCTCA
GGCAGAGCACG -> GCAGAGCACGG
GGCAGAGGCTG -> GCAGAGGCTGT
GGCATTCTATC -> GCATTCTATCG
GGCCAGCTCAC -> GCCAGCTCACT
GGCCATCACTT -> GCCATCACTTC
GGCCCCACAGT -> GCCCCACAGTA
GGCCTAGGAGC -> GCCTAGGAGCG
GGCCTATCCAT -> GCCTATCCATG
GGCCTCTAAAT -> GCCTCTAAATG
GGCGACCCTAT -> GCGACCCTATA
GGCGATGAACC -> GCGATGAACCT
GGCGCGGGGCT -> GCGCGGGGCTC
GGCGCGGTAGC -> GCGCGGTAGCT
GGCGCTTTCTA -> GCGCTTTCTAA
GGCGGTACATT -> GCGGTACATTT
GGCGGTCATCC -> GCGGTCATCCG
GGCGGTGGCGT -> GCGGTGGCGTC
GGCGTCGATCG -> GCGTCGATCGA
GGCGTGAGAGT -> GCGTGAGAGTA
GGCTCATGAAC -> GCTCATGAACG
GGCTCGGTCAA -> GCTCGGTCAAG
GGCTCTAGCTG -> GCTCTAGCTGC
GGCTCTCCAGG -> GCTCTCCAGGG
GGCTGGACCCC -> GCTGGACCCCA
GGCTGGTTAGG -> GCTGGTTAGGT
GGCTGTAAGCA -> GCTGTAAGCAT
GGCTTTCCCGA -> GCTTTCCCGAG
GGGAAATCAAC -> GGAAATCAACT
GGGAATCCCGT -> GGAATCCCGTC
GGGACCTGTTT -> GGACCTGTTTG
GGGACGCTTCC -> GGACGCTTCCT
GGGAGGCGTGA -> GGAGGCGTGAG
GGGAGGTACGC -> GGAGGTACGCT
GGGATCACATC -> GGATCACATCA
GGGATGGCACC -> GGATGGCACCT
GGGCCATCACT -> GGCCATCACTT
GGGCGCGGGGC -> GGCGCGGGGCT
GGGCTCGGTCA -> GGCTCGGTCAA
GGGGAGGTACG -> GGGAGGTACGC
GGGGCTCGGTC -> GGGCTCGGTCA
GGGGGAGGTAC -> GGGGAGGTACG
GGGGGGAGGTA -> GGGGGAGGTAC
GGGTAATAGAT -> GGTAATAGATC
GGGTCACCTAG -> GGTCACCTAGA
GGGTTACCTAA -> GGTTACCTAAC
GGGTTCTAAGC -> GGTTCTAAGCC
GGTAAAAATTG -> GTAAAAATTGA
GGTAAAATCGT -> GTAAAATCGTG
GGTAACGCACA -> GTAACGCACAC
GGTAATAGATC -> GTAATAGATCC
GGTAATATTTA -> GTAATATTTAA
GGTACATTTAG -> GTACATTTAGT
GGTACGCTCGC -> GTACGCTCGCC
GGTAGACAACG -> GTAGACAACGA
GGTAGCTAGTG -> GTAGCTAGTGA
GGTAGGCCAGC -> GTAGGCCAGCT
GGTAGTTCTGT -> GTAGTTCTGTA
GGTATTTTATG -> GTATTTTATGC
GGTCAAGAGCT -> GTCAAGAGCTT
GGTCACCTAGA -> GTCACCTAGAC
GGTCATAAACG -> GTCATAAACGG
GGTCATCCGTG -> GTCATCCGTGT
GGTCCCTGACA -> GTCCCTGACAT
GGTCCCTTGCC -> GTCCCTTGCCA
GGTCTTGACAT -> GTCTTGACATA
GGTCTTGTCTA -> GTCTTGTCTAA
GGTGACTAGAC -> GTGACTAGACT
GGTGCGGGAAT -> GTGCGGGAATC
GGTGGCGGTCA -> GTGGCGGTCAT
GGTGGCGTCGA -> GTGGCGTCGAT
GGTTACCTAAC -> GTTACCTAACG
GGTTAGGTTCT -> GTTAGGTTCTA
GGTTCAACACC -> GTTCAACACCG
GGTTCATTCAG -> GTTCATTCAGA
GGTTCCTCGCC -> GTTCCTCGCCT
GGTTCTAAGCC -> GTTCTAAGCCT
GGTTCTACTGG -> GTTCTACTGGG
GGTTCTCCGCC -> GTTCTCCGCCT
GGTTTAGAACT -> GTTTAGAACTA
GGTTTGACGTG -> GTTTGACGTGG
GGTTTTTGGAT -> GTTTTTGGATG
GTAAAAATTGA -> TAAAAATTGAG
GTAAAATCGTG -> TAAAATCGTGG
GTAACGCACAC -> TAACGCACACC
GTAAGCATTGT -> TAAGCATTGTA
GTAATAGATCC -> TAATAGATCCG
GTAATATTTAA -> TAATATTTAAT
GTAATTACGGC -> TAATTACGGCG
GTACAATCAGT -> TACAATCAGTA
GTACATAAGAT -> TACATAAGATT
GTACATTTAGT -> TACATTTAGTC
GTACCGGACGT -> TACCGGACGTC
GTACGAAATCA -> TACGAAATCAG
GTACGCAATTA -> TACGCAATTAG
GTACGCTCGCC -> TACGCTCGCCG
GTAGACAACGA -> TAGACAACGAT
GTAGACGCGTA -> TAGACGCGTAT
GTAGCAAGTTA -> TAGCAAGTTAG
GTAGCCACCGA -> TAGCCACCGAA
GTAGCGAGATT -> TAGCGAGATTG
GTAGCTAGTGA -> TAGCTAGTGAG
GTAGGCCAGCT -> TAGGCCAGCTC
GTAGTTCTGTA -> TAGTTCTGTAT
GTATCTCCGAA -> TATCTCCGAAG
GTATCTTTGCT -> TATCTTTGCTT
GTATGACCCCA -> TATGACCCCAT
GTATTACGGTA -> TATTACGGTAG
GTATTTGTATC -> TATTTGTATCT
GTATTTTATGC -> TATTTTATGCT
GTCAAGAGCTT -> TCAAGAGCTTT
GTCACCTAGAC -> TCACCTAGACT
GTCATAAACGG -> TCATAAACGGT
GTCATCCGTGT -> TCATCCGTGTG
GTCCAAAGCTT -> TCCAAAGCTTG
GTCCAAATTAT -> TCCAAATTATA
GTCCAGCCTAC -> TCCAGCCTACA
GTCCCACCGCA -> TCCCACCGCAG
GTCCCTGACAT -> TCCCTGACATT
GTCCCTTGCCA -> TCCCTTGCCAA
GTCCGAAATCC -> TCCGAAATCCA
GTCCGGCGCTT -> TCCGGCGCTTT
GTCCTCGTTCT -> TCCTCGTTCTC
GTCGATCGAGA -> TCGATCGAGAC
GTCGCTGGTAT -> TCGCTGGTATT
GTCGGAGCCAA -> TCGGAGCCAAT
GTCGGGACCTG -> TCGGGACCTGT
GTCGGGATGGC -> TCGGGATGGCA
GTCGGTAAAAA -> TCGGTAAAAAT
GTCGGTGGCGG -> TCGGTGGCGGT
GTCGTGCGTCC -> TCGTGCGTCCG
GTCTAAGTAAT -> TCTAAGTAATT
GTCTACGATCG -> TCTACGATCGG
GTCTAGGCACT -> TCTAGGCACTC
GTCTTAATGAA -> TCTTAATGAAA
GTCTTGACATA -> TCTTGACATAC
GTCTTGTCTAA -> TCTTGTCTAAG
GTGAACCTAGA -> TGAACCTAGAC
GTGAAGTACGC -> TGAAGTACGCA
GTGACACCTTC -> TGACACCTTCG
GTGACCGGCGA -> TGACCGGCGAT
GTGACTAGACT -> TGACTAGACTA
GTGAGAGTAGC -> TGAGAGTAGCG
GTGAGTCTTAA -> TGAGTCTTAAT
GTGAGTTCTTC -> TGAGTTCTTCT
GTGATCAATAA -> TGATCAATAAA
GTGCAAAACAT -> TGCAAAACATA
GTGCATTGATC -> TGCATTGATCT
GTGCCAACTGA -> TGCCAACTGAT
GTGCGCTCACT -> TGCGCTCACTT
GTGCGGGAATC -> TGCGGGAATCC
GTGCGTCCGAA -> TGCGTCCGAAA
GTGGATAGTCG -> TGGATAGTCGG
GTGGCGGTCAT -> TGGCGGTCATC
GTGGCGTCGAT -> TGGCGTCGATC
GTGGCTGGACC -> TGGCTGGACCC
GTGGTCTTGTC -> TGGTCTTGTCT
GTGTGAACCTA -> TGTGAACCTAG
GTGTTTTGTAG -> TGTTTTGTAGA
GTTACAAGTCG -> TTACAAGTCGG
GTTACCTAACG -> TTACCTAACGA
GTTAGATATTC -> TTAGATATTCA
GTTAGGTTCTA -> TTAGGTTCTAC
GTTCAACACCG -> TTCAACACCGT
GTTCAGCAGCG -> TTCAGCAGCGG
GTTCATTCAGA -> TTCATTCAGAA
GTTCCGGATAG -> TTCCGGATAGC
GTTCCTCGCCT -> TTCCTCGCCTC
GTTCGACTGCT -> TTCGACTGCTC
GTTCGATCTGA -> TTCGATCTGAT
GTTCGGCGGTA -> TTCGGCGGTAC
GTTCTAAGCCT -> TTCTAAGCCTC
GTTCTACTGGG -> TTCTACTGGGA
GTTCTAGGCAG -> TTCTAGGCAGA
GTTCTCCGCCT -> TTCTCCGCCTA
GTTCTCGATAC -> TTCTCGATACG
GTTCTGTATGA -> TTCTGTATGAC
GTTCTTCTTAA -> TTCTTCTTAAC
GTTGAAACGAT -> TTGAAACGATA
GTTGACGTTCG -> TTGACGTTCGG
GTTGACTCCAT -> TTGACTCCATA
GTTGAGTCCGG -> TTGAGTCCGGC
GTTGGTTCTCC -> TTGGTTCTCCG
GTTGTAGCAAG -> TTGTAGCAAGT
GTTGTCCAAAG -> TTGTCCAAAGC
GTTGTCTAGGC -> TTGTCTAGGCA
GTTTAGAACTA -> TTTAGAACTAA
GTTTGACGTGG -> TTTGACGTGGA
GTTTGTGAAGT -> TTTGTGAAGTA
GTTTTCGGTAG -> TTTTCGGTAGG
GTTTTCTAGTG -> TTTTCTAGTGA
GTTTTGTAGAC -> TTTTGTAGACG
GTTTTTGGATG -> TTTTTGGATGT
GTTTTTGGTTC -> TTTTTGGTTCA
TAAAAATTGAG -> AAAAATTGAGC
TAAAATCGTGG -> AAAATCGTGGC
TAAACGGTGCG -> AAACGGTGCGG
TAAACTTGAAG -> AAACTTGAAGG
TAAATATGGAT -> AAATATGGATC
TAAATGAGATA -> AAATGAGATAG
TAAATGCTACG -> AAATGCTACGC
TAAATGCTCTT -> AAATGCTCTTT
TAAATTAGTGG -> AAATTAGTGGT
TAACACCACCT -> AACACCACCTC
TAACATCATGA -> AACATCATGAC
TAACCTACTTG -> AACCTACTTGG
TAACCTTCAGA -> AACCTTCAGAC
TAACGACAGTC -> AACGACAGTCT
TAACGCACACC -> AACGCACACCC
TAACTCAGCGA -> AACTCAGCGAT
TAAGATTAAAC -> AAGATTAAACT
TAAGCATTGTA -> AAGCATTGTAC
TAAGCCTAAAT -> AAGCCTAAATG
TAAGCCTCTAG -> AAGCCTCTAGG
TAAGGGCCATC -> AAGGGCCATCA
TAAGGGGGGAG -> AAGGGGGGAGG
TAAGTAATTAC -> AAGTAATTACG
TAAGTAGCCAC -> AAGTAGCCACC
TAAGTTGTCCA -> AAGTTGTCCAA
TAAGTTTTTGG -> AAGTTTTTGGT
TAATAGATCCG -> AATAGATCCGG
TAATATTTAAT -> AATATTTAATG
TAATCCTGGTA -> AATCCTGGTAG
TAATGAAAAGA -> AATGAAAAGAA
TAATGATTTAT -> AATGATTTATG
TAATGCATCGG -> AATGCATCGGA
TAATTAAGCCT -> AATTAAGCCTA
TAATTACGGCG -> AATTACGGCGG
TAATTACTTAT -> AATTACTTATT
TACAAGCGAAA -> ACAAGCGAAAC
TACAAGTCGGA -> ACAAGTCGGAG
TACAAGTTGGT -> ACAAGTTGGTT
TACAATCAGTA -> ACAATCAGTAT
TACATAAGATT -> ACATAAGATTA
TACATTAGGTT -> ACATTAGGTTT
TACATTTAGTC -> ACATTTAGTCC
TACCACATTAT -> ACCACATTATC
TACCCAACAAA -> ACCCAACAAAG
TACCCACTGCG -> ACCCACTGCGG
TACCGACAGAA -> ACCGACAGAAT
TACCGGACGTC -> ACCGGACGTCG
TACCGGGTCAC -> ACCGGGTCACC
TACCTAACGAC -> ACCTAACGACA
TACGAAATCAG -> ACGAAATCAGG
TACGATCGGCC -> ACGATCGGCCC
TACGCAATTAG -> ACGCAATTAGC
TACGCACGTCC -> ACGCACGTCCA
TACGCCTCTAA -> ACGCCTCTAAG
TACGCTCGCCG -> ACGCTCGCCGG
TACGGAGGCTC -> ACGGAGGCTCA
TACGGCGGTGG -> ACGGCGGTGGC
TACGGCTTTCC -> ACGGCTTTCCC
TACGGTAGACA -> ACGGTAGACAA
TACGGTCATAA -> ACGGTCATAAA
TACGGTCCCTG -> ACGGTCCCTGA
TACGTCGGTGG -> ACGTCGGTGGC
TACGTGCAAAA -> ACGTGCAAAAC
TACGTTGACGT -> ACGTTGACGTT
TACTAAGTTGT -> ACTAAGTTGTC
TACTGGGAGGC -> ACTGGGAGGCG
TACTTATTTTT -> ACTTATTTTTA
TACTTCAAGGA -> ACTTCAAGGAC
TACTTGGCCTC -> ACTTGGCCTCT
TAGAACTAATC -> AGAACTAATCC
TAGAATCTTTT -> AGAATCTTTTC
TAGACAACGAT -> AGACAACGATC
TAGACCCATAC -> AGACCCATACG
TAGACCGGGCG -> AGACCGGGCGC
TAGACGAATGC -> AGACGAATGCA
TAGACGCGTAT -> AGACGCGTATT
TAGACTACGTG -> AGACTACGTGC
TAGACTATAAA -> AGACTATAAAT
TAGACTCGCCA -> AGACTCGCCAA
TAGAGATTCGA -> AGAGATTCGAT
TAGATACAAGC -> AGATACAAGCG
TAGATATTCAG -> AGATATTCAGG
TAGATCCGGTC -> AGATCCGGTCC
TAGCAAGTTAG -> AGCAAGTTAGA
TAGCAATAAAT -> AGCAATAAATG
TAGCCACCGAA -> AGCCACCGAAA
TAGCCCTTAAG -> AGCCCTTAAGT
TAGCGAGATTG -> AGCGAGATTGT
TAGCTAGTGAG -> AGCTAGTGAGT
TAGCTATCAGT -> AGCTATCAGTG
TAGCTGCGTTC -> AGCTGCGTTCC
TAGGACACTAC -> AGGACACTACA
TAGGAGCGTTC -> AGGAGCGTTCG
TAGGCACTCGC -> AGGCACTCGCT
TAGGCAGAGGC -> AGGCAGAGGCT
TAGGCCAGCTC -> AGGCCAGCTCA
TAGGTGACTAG -> AGGTGACTAGA
TAGGTTCTACT -> AGGTTCTACTG
TAGGTTTGACG -> AGGTTTGACGT
TAGGTTTTTGG -> AGGTTTTTGGA
TAGTCCAGCCT -> AGTCCAGCCTA
TAGTCGGTAAA -> AGTCGGTAAAA
TAGTGACCGGC -> AGTGACCGGCG
TAGTGAGTCTT -> AGTGAGTCTTA
TAGTGCGCTCA -> AGTGCGCTCAC
TAGTGGTCTTG -> AGTGGTCTTGT
TAGTTCAGCAG -> AGTTCAGCAGC
TAGTTCTGTAT -> AGTTCTGTATG
TAGTTTTCTAG -> AGTTTTCTAGT
TATAAATATGG -> ATAAATATGGA
TATAACCTTCA -> ATAACCTTCAG
TATACCGACAG -> ATACCGACAGA
TATACTAAGTT -> ATACTAAGTTG
TATAGAGATTC -> ATAGAGATTCG
TATAGCTATCA -> ATAGCTATCAG
TATATGTCCCA -> ATATGTCCCAC
TATCAGTGATC -> ATCAGTGATCA
TATCCATGGCT -> ATCCATGGCTC
TATCGCCGGAC -> ATCGCCGGACA
TATCTAGTTCA -> ATCTAGTTCAG
TATCTCCGAAG -> ATCTCCGAAGA
TATCTTCTGAC -> ATCTTCTGACA
TATCTTTGCTT -> ATCTTTGCTTG
TATGACCCCAT -> ATGACCCCATT
TATGCTCATGG -> ATGCTCATGGC
TATGGACTTCG -> ATGGACTTCGC
TATGGATCCAG -> ATGGATCCAGT
TATGTCCCACC -> ATGTCCCACCG
TATGTGCATTG -> ATGTGCATTGA
TATTACGGTAG -> ATTACGGTAGA
TATTAGGACAC -> ATTAGGACACT
TATTCAGGTAA -> ATTCAGGTAAT
TATTTAATGAT -> ATTTAATGATT
TATTTAGTGCG -> ATTTAGTGCGC
TATTTGTATCT -> ATTTGTATCTT
TATTTTATGCT -> ATTTTATGCTC
TATTTTTAGAC -> ATTTTTAGACT
TCAACACCGTT -> CAACACCGTTG
TCAACTTTGCA -> CAACTTTGCAT
TCAAGAGCTTT -> CAAGAGCTTTC
TCAAGATGCAT -> CAAGATGCATG
TCAAGGACACA -> CAAGGACACAA
TCAATAAATTA -> CAATAAATTAG
TCACATCATAC -> CACATCATACG
TCACATGGCTC -> CACATGGCTCT
TCACCTAGACT -> CACCTAGACTA
TCACGTTGTCT -> CACGTTGTCTA
TCACTATTAGG -> CACTATTAGGA
TCACTTCACAT -> CACTTCACATG
TCACTTGACTC -> CACTTGACTCC
TCAGAAATTCA -> CAGAAATTCAT
TCAGACGATAA -> CAGACGATAAC
TCAGATTTTCA -> CAGATTTTCAC
TCAGCAGCGGC -> CAGCAGCGGCA
TCAGCGATTGC -> CAGCGATTGCG
TCAGGCCTATC -> CAGGCCTATCC
TCAGGCGACCC -> CAGGCGACCCT
TCAGGTAATAT -> CAGGTAATATT
TCAGGTTCCTC -> CAGGTTCCTCG
TCAGTACATAA -> CAGTACATAAG
TCAGTATTACG -> CAGTATTACGG
TCAGTGATCAA -> CAGTGATCAAT
TCATAAACGGT -> CATAAACGGTG
TCATACGGTCA -> CATACGGTCAT
TCATCCGTGTG -> CATCCGTGTGA
TCATGAACGGG -> CATGAACGGGA
TCATGACCTCA -> CATGACCTCAT
TCATGGCTGGT -> CATGGCTGGTT
TCATTAGACGA -> CATTAGACGAA
TCATTCAGAAA -> CATTCAGAAAT
TCATTTATTTA -> CATTTATTTAG
TCCAAAGCTTG -> CCAAAGCTTGT
TCCAAATTATA -> CCAAATTATAG
TCCAGCCTACA -> CCAGCCTACAT
TCCAGGGTTAC -> CCAGGGTTACC
TCCAGTCGGGA -> CCAGTCGGGAT
TCCATATACTA -> CCATATACTAA
TCCATGGCTCT -> CCATGGCTCTA
TCCATTAGATA -> CCATTAGATAC
TCCCACCGCAG -> CCCACCGCAGA
TCCCAGTCGCT -> CCCAGTCGCTG
TCCCGAGGTCT -> CCCGAGGTCTT
TCCCGTCGGGA -> CCCGTCGGGAC
TCCCTATGTGC -> CCCTATGTGCA
TCCCTGACATT -> CCCTGACATTT
TCCCTTCTCGC -> CCCTTCTCGCC
TCCCTTGCCAA -> CCCTTGCCAAA
TCCGAAATCCA -> CCGAAATCCAT
TCCGAAGACGT -> CCGAAGACGTT
TCCGATTCGAG -> CCGATTCGAGT
TCCGCCTAGAA -> CCGCCTAGAAT
TCCGGATAGCC -> CCGGATAGCCC
TCCGGCGCTTT -> CCGGCGCTTTC
TCCGGTCCCTT -> CCGGTCCCTTG
TCCGTGAGTTC -> CCGTGAGTTCT
TCCGTGTGAAC -> CCGTGTGAACC
TCCTCGCCTCT -> CCTCGCCTCTT
TCCTCGTTCTC -> CCTCGTTCTCG
TCCTCTGCAGT -> CCTCTGCAGTT
TCCTGCTTTGC -> CCTGCTTTGCA
TCCTGGTAGTT -> CCTGGTAGTTC
TCGACTGCTCG -> CGACTGCTCGA
TCGAGACTGAC -> CGAGACTGACG
TCGAGGTTCAA -> CGAGGTTCAAC
TCGAGTTGAAA -> CGAGTTGAAAC
TCGATACGTCG -> CGATACGTCGG
TCGATCCCTTC -> CGATCCCTTCT
TCGATCGAGAC -> CGATCGAGACT
TCGATCTGATT -> CGATCTGATTG
TCGCCAACCTG -> CGCCAACCTGC
TCGCCGCACTA -> CGCCGCACTAC
TCGCCGGACAC -> CGCCGGACACC
TCGCCGGTAAA -> CGCCGGTAAAA
TCGCCGGTAAC -> CGCCGGTAACG
TCGCCTCTTAG -> CGCCTCTTAGA
TCGCGCGATCA -> CGCGCGATCAG
TCGCTCAGGTT -> CGCTCAGGTTC
TCGCTCCGATT -> CGCTCCGATTC
TCGCTGGTATT -> CGCTGGTATTT
TCGGAAAGAGC -> CGGAAAGAGCA
TCGGAATCAAG -> CGGAATCAAGA
TCGGAGCCAAT -> CGGAGCCAATA
TCGGCCCCACA -> CGGCCCCACAG
TCGGCGGTACA -> CGGCGGTACAT
TCGGGACCTGT -> CGGGACCTGTT
TCGGGATGGCA -> CGGGATGGCAC
TCGGGTTCTAA -> CGGGTTCTAAG
TCGGTAAAAAT -> CGGTAAAAATT
TCGGTAGGCCA -> CGGTAGGCCAG
TCGGTCAAGAG -> CGGTCAAGAGC
TCGGTGGCGGT -> CGGTGGCGGTC
TCGTGCCAACT -> CGTGCCAACTG
TCGTGCGTCCG -> CGTGCGTCCGA
TCGTGGCTGGA -> CGTGGCTGGAC
TCGTTACAAGT -> CGTTACAAGTC
TCGTTCTCGAT -> CGTTCTCGATA
TCTAAATGCTA -> CTAAATGCTAC
TCTAACACCAC -> CTAACACCACC
TCTAAGCCTCT -> CTAAGCCTCTA
TCTAAGTAATT -> CTAAGTAATTA
TCTAAGTTTTT -> CTAAGTTTTTG
TCTACCGGGTC -> CTACCGGGTCA
TCTACGATCGG -> CTACGATCGGC
TCTACTGGGAG -> CTACTGGGAGG
TCTAGCTGCGT -> CTAGCTGCGTT
TCTAGGCACTC -> CTAGGCACTCG
TCTAGGCAGAG -> CTAGGCAGAGG
TCTAGGTGACT -> CTAGGTGACTA
TCTAGTGACCG -> CTAGTGACCGG
TCTAGTTCAGC -> CTAGTTCAGCA
TCTATCGCCGG -> CTATCGCCGGA
TCTCCAGGGTT -> CTCCAGGGTTA
TCTCCGAAGAC -> CTCCGAAGACG
TCTCCGCCTAG -> CTCCGCCTAGA
TCTCGATACGT -> CTCGATACGTC
TCTCGCCGGTA -> CTCGCCGGTAA
TCTGAAACCAA -> CTGAAACCAAG
TCTGACAACTT -> CTGACAACTTA
TCTGATTGTTG -> CTGATTGTTGA
TCTGCAGTTCG -> CTGCAGTTCGA
TCTGTATGACC -> CTGTATGACCC
TCTTAACTCAG -> CTTAACTCAGC
TCTTAATGAAA -> CTTAATGAAAA
TCTTAATTACT -> CTTAATTACTT
TCTTAGACCGG -> CTTAGACCGGG
TCTTCTGACAA -> CTTCTGACAAC
TCTTCTTAACT -> CTTCTTAACTC
TCTTGACATAC -> CTTGACATACT
TCTTGTATCTC -> CTTGTATCTCC
TCTTGTCTAAG -> CTTGTCTAAGT
TCTTTGAGCGC -> CTTTGAGCGCG
TCTTTGCTTGG -> CTTTGCTTGGG
TCTTTTCAGGC -> CTTTTCAGGCG
TGAAAAGAATC -> GAAAAGAATCG
TGAAACACCTA -> GAAACACCTAC
TGAAACCAAGC -> GAAACCAAGCT
TGAAACGATAC -> GAAACGATACG
TGAACCTAGAC -> GAACCTAGACC
TGAACCTGTTT -> GAACCTGTTTT
TGAACGGGAAA -> GAACGGGAAAT
TGAAGGAAGAT -> GAAGGAAGATA
TGAAGTACGCA -> GAAGTACGCAA
TGACAACTTAC -> GACAACTTACG
TGACACCTTCG -> GACACCTTCGG
TGACATACTTC -> GACATACTTCA
TGACATTTTGA -> GACATTTTGAA
TGACCCCATTT -> GACCCCATTTC
TGACCGGCGAT -> GACCGGCGATG
TGACCTCATTA -> GACCTCATTAG
TGACGAAGCTC -> GACGAAGCTCC
TGACGTGGATA -> GACGTGGATAG
TGACGTTCGGC -> GACGTTCGGCG
TGACTAGACTA -> GACTAGACTAC
TGACTCCATAT -> GACTCCATATA
TGACTCCCAGT -> GACTCCCAGTC
TGAGAATCAGT -> GAGAATCAGTA
TGAGAGTAGCG -> GAGAGTAGCGA
TGAGATAGGTT -> GAGATAGGTTT
TGAGCCGCTTC -> GAGCCGCTTCG
TGAGCGCGGTT -> GAGCGCGGTTT
TGAGGGTAATA -> GAGGGTAATAG
TGAGTCCGGCG -> GAGTCCGGCGC
TGAGTCTTAAT -> GAGTCTTAATG
TGAGTTCTTCT -> GAGTTCTTCTT
TGATATACCGA -> GATATACCGAC
TGATCAATAAA -> GATCAATAAAT
TGATCTGAAAC -> GATCTGAAACC
TGATTGTTGAG -> GATTGTTGAGT
TGATTTATGGA -> GATTTATGGAC
TGCAAAACATA -> GCAAAACATAA
TGCAAACCAAT -> GCAAACCAATA
TGCAACACCAG -> GCAACACCAGG
TGCAATCTACC -> GCAATCTACCG
TGCAGTTCGAC -> GCAGTTCGACT
TGCATCGGAAT -> GCATCGGAATC
TGCATGAGGGT -> GCATGAGGGTA
TGCATGTCCTC -> GCATGTCCTCG
TGCATTGATCT -> GCATTGATCTG
TGCCAAATATA -> GCCAAATATAG
TGCCAACTGAT -> GCCAACTGATA
TGCGCTCACTT -> GCGCTCACTTG
TGCGGAGGACT -> GCGGAGGACTA
TGCGGCGCGGT -> GCGGCGCGGTA
TGCGGGAATCC -> GCGGGAATCCC
TGCGGGACGCT -> GCGGGACGCTT
TGCGTCCGAAA -> GCGTCCGAAAT
TGCGTTCCGGA -> GCGTTCCGGAT
TGCTACGCCTC -> GCTACGCCTCT
TGCTCATGGCT -> GCTCATGGCTG
TGCTCGAGGTT -> GCTCGAGGTTC
TGCTCTTTGAG -> GCTCTTTGAGC
TGCTTGGGATC -> GCTTGGGATCA
TGCTTTGCAAT -> GCTTTGCAATC
TGGACCCCATA -> GGACCCCATAC
TGGACTTCGCC -> GGACTTCGCCG
TGGATAGTCGG -> GGATAGTCGGT
TGGATCCAGTC -> GGATCCAGTCG
TGGATGTTCTA -> GGATGTTCTAG
TGGCACCTGAG -> GGCACCTGAGA
TGGCATTCTAT -> GGCATTCTATC
TGGCCTAGGAG -> GGCCTAGGAGC
TGGCCTCTAAA -> GGCCTCTAAAT
TGGCGGTCATC -> GGCGGTCATCC
TGGCGTCGATC -> GGCGTCGATCG
TGGCTCTAGCT -> GGCTCTAGCTG
TGGCTCTCCAG -> GGCTCTCCAGG
TGGCTGGACCC -> GGCTGGACCCC
TGGCTGGTTAG -> GGCTGGTTAGG
TGGGAGGCGTG -> GGGAGGCGTGA
TGGGATCACAT -> GGGATCACATC
TGGTAGTTCTG -> GGTAGTTCTGT
TGGTATTTTAT -> GGTATTTTATG
TGGTCTTGTCT -> GGTCTTGTCTA
TGGTTAGGTTC -> GGTTAGGTTCT
TGGTTCATTCA -> GGTTCATTCAG
TGGTTCTCCGC -> GGTTCTCCGCC
TGTAAGCATTG -> GTAAGCATTGT
TGTACAATCAG -> GTACAATCAGT
TGTACGAAATC -> GTACGAAATCA
TGTAGACGCGT -> GTAGACGCGTA
TGTAGCAAGTT -> GTAGCAAGTTA
TGTATCTCCGA -> GTATCTCCGAA
TGTATCTTTGC -> GTATCTTTGCT
TGTATGACCCC -> GTATGACCCCA
TGTCCAAAGCT -> GTCCAAAGCTT
TGTCCCACCGC -> GTCCCACCGCA
TGTCCTCGTTC -> GTCCTCGTTCT
TGTCTAAGTAA -> GTCTAAGTAAT
TGTCTAGGCAC -> GTCTAGGCACT
TGTGAACCTAG -> GTGAACCTAGA
TGTGAAGTACG -> GTGAAGTACGC
TGTGACACCTT -> GTGACACCTTC
TGTGCATTGAT -> GTGCATTGATC
TGTTCTAGGCA -> GTTCTAGGCAG
TGTTGAGTCCG -> GTTGAGTCCGG
TGTTTGTGAAG -> GTTTGTGAAGT
TGTTTTCGGTA -> GTTTTCGGTAG
TGTTTTGTAGA -> GTTTTGTAGAC
TTAAACTTGAA -> TAAACTTGAAG
TTAACTCAGCG -> TAACTCAGCGA
TTAAGCCTAAA -> TAAGCCTAAAT
TTAAGGGGGGA -> TAAGGGGGGAG
TTAAGTAGCCA -> TAAGTAGCCAC
TTAATGAAAAG -> TAATGAAAAGA
TTAATGATTTA -> TAATGATTTAT
TTAATTACTTA -> TAATTACTTAT
TTACAAGTCGG -> TACAAGTCGGA
TTACCTAACGA -> TACCTAACGAC
TTACGGAGGCT -> TACGGAGGCTC
TTACGGCGGTG -> TACGGCGGTGG
TTACGGTAGAC -> TACGGTAGACA
TTACGGTCCCT -> TACGGTCCCTG
TTACTTATTTT -> TACTTATTTTT
TTAGAACTAAT -> TAGAACTAATC
TTAGACCGGGC -> TAGACCGGGCG
TTAGACGAATG -> TAGACGAATGC
TTAGACTCGCC -> TAGACTCGCCA
TTAGATACAAG -> TAGATACAAGC
TTAGATATTCA -> TAGATATTCAG
TTAGCAATAAA -> TAGCAATAAAT
TTAGGACACTA -> TAGGACACTAC
TTAGGTTCTAC -> TAGGTTCTACT
TTAGGTTTGAC -> TAGGTTTGACG
TTAGTCCAGCC -> TAGTCCAGCCT
TTAGTGCGCTC -> TAGTGCGCTCA
TTAGTGGTCTT -> TAGTGGTCTTG
TTATAACCTTC -> TATAACCTTCA
TTATAGCTATC -> TATAGCTATCA
TTATCTAGTTC -> TATCTAGTTCA
TTATGCTCATG -> TATGCTCATGG
TTATGGACTTC -> TATGGACTTCG
TTATTTAGTGC -> TATTTAGTGCG
TTATTTTTAGA -> TATTTTTAGAC
TTCAACACCGT -> TCAACACCGTT
TTCAAGGACAC -> TCAAGGACACA
TTCACATGGCT -> TCACATGGCTC
TTCACGTTGTC -> TCACGTTGTCT
TTCAGAAATTC -> TCAGAAATTCA
TTCAGACGATA -> TCAGACGATAA
TTCAGCAGCGG -> TCAGCAGCGGC
TTCAGGCGACC -> TCAGGCGACCC
TTCAGGTAATA -> TCAGGTAATAT
TTCATTCAGAA -> TCATTCAGAAA
TTCATTTATTT -> TCATTTATTTA
TTCCCGAGGTC -> TCCCGAGGTCT
TTCCGGATAGC -> TCCGGATAGCC
TTCCTCGCCTC -> TCCTCGCCTCT
TTCCTCTGCAG -> TCCTCTGCAGT
TTCCTGCTTTG -> TCCTGCTTTGC
TTCGACTGCTC -> TCGACTGCTCG
TTCGAGTTGAA -> TCGAGTTGAAA
TTCGATCCCTT -> TCGATCCCTTC
TTCGATCTGAT -> TCGATCTGATT
TTCGCCGCACT -> TCGCCGCACTA
TTCGGAAAGAG -> TCGGAAAGAGC
TTCGGCGGTAC -> TCGGCGGTACA
TTCGGGTTCTA -> TCGGGTTCTAA
TTCGGTAGGCC -> TCGGTAGGCCA
TTCTAACACCA -> TCTAACACCAC
TTCTAAGCCTC -> TCTAAGCCTCT
TTCTACTGGGA -> TCTACTGGGAG
TTCTAGGCAGA -> TCTAGGCAGAG
TTCTAGTGACC -> TCTAGTGACCG
TTCTATCGCCG -> TCTATCGCCGG
TTCTCCGCCTA -> TCTCCGCCTAG
TTCTCGATACG -> TCTCGATACGT
TTCTCGCCGGT -> TCTCGCCGGTA
TTCTGACAACT -> TCTGACAACTT
TTCTGTATGAC -> TCTGTATGACC
TTCTTAACTCA -> TCTTAACTCAG
TTCTTAATTAC -> TCTTAATTACT
TTCTTCTTAAC -> TCTTCTTAACT
TTCTTGTATCT -> TCTTGTATCTC
TTGAAACACCT -> TGAAACACCTA
TTGAAACGATA -> TGAAACGATAC
TTGAAGGAAGA -> TGAAGGAAGAT
TTGACATACTT -> TGACATACTTC
TTGACGTGGAT -> TGACGTGGATA
TTGACGTTCGG -> TGACGTTCGGC
TTGACTCCATA -> TGACTCCATAT
TTGACTCCCAG -> TGACTCCCAGT
TTGAGCCGCTT -> TGAGCCGCTTC
TTGAGCGCGGT -> TGAGCGCGGTT
TTGAGTCCGGC -> TGAGTCCGGCG
TTGATCTGAAA -> TGATCTGAAAC
TTGCAATCTAC -> TGCAATCTACC
TTGCATGTCCT -> TGCATGTCCTC
TTGCCAAATAT -> TGCCAAATATA
TTGCGGAGGAC -> TGCGGAGGACT
TTGCTTGGGAT -> TGCTTGGGATC
TTGGATGTTCT -> TGGATGTTCTA
TTGGCCTAGGA -> TGGCCTAGGAG
TTGGCCTCTAA -> TGGCCTCTAAA
TTGGGATCACA -> TGGGATCACAT
TTGGTTCATTC -> TGGTTCATTCA
TTGGTTCTCCG -> TGGTTCTCCGC
TTGTACAATCA -> TGTACAATCAG
TTGTACGAAAT -> TGTACGAAATC
TTGTAGACGCG -> TGTAGACGCGT
TTGTAGCAAGT -> TGTAGCAAGTT
TTGTATCTCCG -> TGTATCTCCGA
TTGTATCTTTG -> TGTATCTTTGC
TTGTCCAAAGC -> TGTCCAAAGCT
TTGTCTAAGTA -> TGTCTAAGTAA
TTGTCTAGGCA -> TGTCTAGGCAC
TTGTGAAGTAC -> TGTGAAGTACG
TTGTGACACCT -> TGTGACACCTT
TTGTTGAGTCC -> TGTTGAGTCCG
TTTAATGATTT -> TTAATGATTTA
TTTAGAACTAA -> TTAGAACTAAT
TTTAGACTCGC -> TTAGACTCGCC
TTTAGTCCAGC -> TTAGTCCAGCC
TTTAGTGCGCT -> TTAGTGCGCTC
TTTATGCTCAT -> TTATGCTCATG
TTTATGGACTT -> TTATGGACTTC
TTTATTTAGTG -> TTATTTAGTGC
TTTCACGTTGT -> TTCACGTTGTC
TTTCAGGCGAC -> TTCAGGCGACC
TTTCCCGAGGT -> TTCCCGAGGTC
TTTCCTCTGCA -> TTCCTCTGCAG
TTTCGGTAGGC -> TTCGGTAGGCC
TTTCTAACACC -> TTCTAACACCA
TTTCTAGTGAC -> TTCTAGTGACC
TTTCTTGTATC -> TTCTTGTATCT
TTTGAAACACC -> TTGAAACACCT
TTTGACGTGGA -> TTGACGTGGAT
TTTGAGCGCGG -> TTGAGCGCGGT
TTTGCAATCTA -> TTGCAATCTAC
TTTGCATGTCC -> TTGCATGTCCT
TTTGCTTGGGA -> TTGCTTGGGAT
TTTGGATGTTC -> TTGGATGTTCT
TTTGGTTCATT -> TTGGTTCATTC
TTTGTAGACGC -> TTGTAGACGCG
TTTGTATCTTT -> TTGTATCTTTG
TTTGTGAAGTA -> TTGTGAAGTAC
TTTTAGACTCG -> TTTAGACTCGC
TTTTATGCTCA -> TTTATGCTCAT
TTTTCACGTTG -> TTTCACGTTGT
TTTTCAGGCGA -> TTTCAGGCGAC
TTTTCGGTAGG -> TTTCGGTAGGC
TTTTCTAGTGA -> TTTCTAGTGAC
TTTTGAAACAC -> TTTGAAACACC
TTTTGGATGTT -> TTTGGATGTTC
TTTTGGTTCAT -> TTTGGTTCATT
TTTTGTAGACG -> TTTGTAGACGC
TTTTTAGACTC -> TTTTAGACTCG
TTTTTGGATGT -> TTTTGGATGTT
TTTTTGGTTCA -> TTTTGGTTCAT
