AAAAATAGCGGACACGCAT -> AAAATAGCGGACACGCATA
AAAAATTAGACTTTTAGAT -> AAAATTAGACTTTTAGATA
AAAACACTACCAATTGCAG -> AAACACTACCAATTGCAGA
AAAACCAAAAGTCATGATG -> AAACCAAAAGTCATGATGA
AAAACCGTTTGAAGGATTT -> AAACCGTTTGAAGGATTTG
AAAACTACAGAGTTACCGA -> AAACTACAGAGTTACCGAC
AAAAGTCATGATGAGCCTC -> AAAGTCATGATGAGCCTCC
AAAAGTCCGCATAATATTT -> AAAGTCCGCATAATATTTG
AAAAGTGAGTCAGCCACGT -> AAAGTGAGTCAGCCACGTT
AAAATAGCGGACACGCATA -> AAATAGCGGACACGCATAC
AAAATTAGACTTTTAGATA -> AAATTAGACTTTTAGATAC
AAACAACAGACAGTACAGT -> AACAACAGACAGTACAGTT
AAACACTACCAATTGCAGA -> AACACTACCAATTGCAGAA
AAACAGCCTCGTGTAGACC -> AACAGCCTCGTGTAGACCA
AAACCAAAAGTCATGATGA -> AACCAAAAGTCATGATGAG
AAACCAAACTGCAGTCATT -> AACCAAACTGCAGTCATTC
AAACCGATCGCTCGAATCC -> AACCGATCGCTCGAATCCT
AAACCGTTTGAAGGATTTG -> AACCGTTTGAAGGATTTGA
AAACCTGCGTCGTCTAGAA -> AACCTGCGTCGTCTAGAAG
AAACGCAAAGCAGAATTAA -> AACGCAAAGCAGAATTAAA
AAACGCCCATACTCAACCA -> AACGCCCATACTCAACCAG
AAACGCGTACTTCACGTGG -> AACGCGTACTTCACGTGGT
AAACTACAGAGTTACCGAC -> AACTACAGAGTTACCGACG
AAACTCTGTACACCTTACG -> AACTCTGTACACCTTACGT
AAACTGCAGTCATTCTATG -> AACTGCAGTCATTCTATGT
AAAGAATGGCTCCTACCCG -> AAGAATGGCTCCTACCCGC
AAAGATAATCACCCTGGGA -> AAGATAATCACCCTGGGAT
AAAGCAGAATTAAACAACA -> AAGCAGAATTAAACAACAG
AAAGTAGGGAAAAGTCCGC -> AAGTAGGGAAAAGTCCGCA
AAAGTCATGATGAGCCTCC -> AAGTCATGATGAGCCTCCC
AAAGTCCGCATAATATTTG -> AAGTCCGCATAATATTTGG
AAAGTGAGTCAGCCACGTT -> AAGTGAGTCAGCCACGTTA
AAATAGCGGACACGCATAC -> AATAGCGGACACGCATACC
AAATGAGGTTAGGTACGAA -> AATGAGGTTAGGTACGAAT
AAATGTTGGAGCCAACCAA -> AATGTTGGAGCCAACCAAA
AAATGTTGGAGCCACTTCC -> AATGTTGGAGCCACTTCCC
AAATGTTGGAGCCATGGGG -> AATGTTGGAGCCATGGGGG
AAATGTTGGAGCCATTGGT -> AATGTTGGAGCCATTGGTA
AAATTAGACTTTTAGATAC -> AATTAGACTTTTAGATACA
AAATTCGAACGTGCCCGGC -> AATTCGAACGTGCCCGGCA
AAATTCGGCTTGAACCAAA -> AATTCGGCTTGAACCAAAT
AACAAAACACTACCAATTG -> ACAAAACACTACCAATTGC
AACAACAGACAGTACAGTT -> ACAACAGACAGTACAGTTT
AACAAGCCCCCTCACCTCA -> ACAAGCCCCCTCACCTCAA
AACAATTCCAGGATGGTGT -> ACAATTCCAGGATGGTGTA
AACACATACACCAGCTGGC -> ACACATACACCAGCTGGCC
AACACTACCAATTGCAGAA -> ACACTACCAATTGCAGAAC
AACACTACGGTCCGGGGAG -> ACACTACGGTCCGGGGAGT
AACAGACAGTACAGTTTGT -> ACAGACAGTACAGTTTGTC
AACAGCCTCGTGTAGACCA -> ACAGCCTCGTGTAGACCAG
AACAGGGATGTCCCAGCAT -> ACAGGGATGTCCCAGCATT
AACAGTTCCCCACAACTAC -> ACAGTTCCCCACAACTACA
AACATCAAACCTGCGTCGT -> ACATCAAACCTGCGTCGTC
AACATCATCACTAAACGCG -> ACATCATCACTAAACGCGT
AACATTTATATCCAGTCAG -> ACATTTATATCCAGTCAGC
AACCAAAAGTCATGATGAG -> ACCAAAAGTCATGATGAGC
AACCAAACTGCAGTCATTC -> ACCAAACTGCAGTCATTCT
AACCAAATGTTGGAGCCAA -> ACCAAATGTTGGAGCCAAC
AACCAAATGTTGGAGCCAC -> ACCAAATGTTGGAGCCACT
AACCAAATGTTGGAGCCAT -> ACCAAATGTTGGAGCCATG,ACCAAATGTTGGAGCCATT
AACCACCTCCATTCATGGT -> ACCACCTCCATTCATGGTT
AACCAGACATGGATGGTGT -> ACCAGACATGGATGGTGTG
AACCCTTCTACTAAAGTAG -> ACCCTTCTACTAAAGTAGG
AACCGATCGCTCGAATCCT -> ACCGATCGCTCGAATCCTC
AACCGGTTAGCAGACAAAC -> ACCGGTTAGCAGACAAACC
AACCGTTTGAAGGATTTGA -> ACCGTTTGAAGGATTTGAC
AACCTGCGTCGTCTAGAAG -> ACCTGCGTCGTCTAGAAGG
AACGAAAAATTAGACTTTT -> ACGAAAAATTAGACTTTTA
AACGAACAATTCCAGGATG -> ACGAACAATTCCAGGATGG
AACGCAAAGCAGAATTAAA -> ACGCAAAGCAGAATTAAAC
AACGCCCATACTCAACCAG -> ACGCCCATACTCAACCAGA
AACGCGTACTTCACGTGGT -> ACGCGTACTTCACGTGGTG
AACGGAATCGTGACATGGA -> ACGGAATCGTGACATGGAT
AACGGACCGAACGGGGACT -> ACGGACCGAACGGGGACTG
AACGGGGACTGTTTGGAAA -> ACGGGGACTGTTTGGAAAG
AACGGGGTACCATGGGTAG -> ACGGGGTACCATGGGTAGC
AACGGTCCGCGTACCCTTC -> ACGGTCCGCGTACCCTTCA
AACGTCCTTAATCAATACG -> ACGTCCTTAATCAATACGT
AACGTGACGCAGATGTTTA -> ACGTGACGCAGATGTTTAA
AACGTGCCCGGCATACTTC -> ACGTGCCCGGCATACTTCG
AACTACAGAATGACCGCCT -> ACTACAGAATGACCGCCTC
AACTACAGAGTTACCGACG -> ACTACAGAGTTACCGACGC
AACTCCCACTGAACGTCCT -> ACTCCCACTGAACGTCCTT
AACTCGTTGTCTGGGGTAC -> ACTCGTTGTCTGGGGTACC
AACTCTATGTTACGCACGG -> ACTCTATGTTACGCACGGC
AACTCTGTACACCTTACGT -> ACTCTGTACACCTTACGTG
AACTCTTTTACGAGCCTGT -> ACTCTTTTACGAGCCTGTC
AACTGCAGTCATTCTATGT -> ACTGCAGTCATTCTATGTG
AACTGGATGAGGGAGACGT -> ACTGGATGAGGGAGACGTA
AACTGGATGTGATGTACAG -> ACTGGATGTGATGTACAGC
AACTTTTGAGGGCGTCTCT -> ACTTTTGAGGGCGTCTCTT
AAGAATGGCTCCTACCCGC -> AGAATGGCTCCTACCCGCC
AAGACAATTGTGGCCATGT -> AGACAATTGTGGCCATGTC
AAGACATGCGAATTCGAGT -> AGACATGCGAATTCGAGTC
AAGATAATCACCCTGGGAT -> AGATAATCACCCTGGGATA
AAGCAGAAGGAACAAGCCC -> AGCAGAAGGAACAAGCCCC
AAGCAGAATTAAACAACAG -> AGCAGAATTAAACAACAGA
AAGCAGCGAGGAAGCTTGG -> AGCAGCGAGGAAGCTTGGG
AAGCCCCCTCACCTCAATA -> AGCCCCCTCACCTCAATAT
AAGCCTCTCCGAGCTTAGC -> AGCCTCTCCGAGCTTAGCT
AAGCTGTACACATGATCCT -> AGCTGTACACATGATCCTG
AAGCTTATAAGCTGTACAC -> AGCTTATAAGCTGTACACA
AAGCTTGGGTTGCCCTGAC -> AGCTTGGGTTGCCCTGACG
AAGGAACAAGCCCCCTCAC -> AGGAACAAGCCCCCTCACC
AAGGATTTGACCGCGCCCA -> AGGATTTGACCGCGCCCAG
AAGGGGAATCCGGAACGGG -> AGGGGAATCCGGAACGGGG
AAGGGGAATCGTATGACCG -> AGGGGAATCGTATGACCGT
AAGGGTCTAAGCAGAAGGA -> AGGGTCTAAGCAGAAGGAA
AAGTAGGGAAAAGTCCGCA -> AGTAGGGAAAAGTCCGCAT
AAGTCATGATGAGCCTCCC -> AGTCATGATGAGCCTCCCC
AAGTCCGCATAATATTTGG -> AGTCCGCATAATATTTGGT
AAGTGAGTCAGCCACGTTA -> AGTGAGTCAGCCACGTTAC
AAGTGGGTTCAATGGCAAC -> AGTGGGTTCAATGGCAACG
AAGTTTGCGAGTCAGCACC -> AGTTTGCGAGTCAGCACCG
AATAATCAACCGGTTAGCA -> ATAATCAACCGGTTAGCAG
AATACGTAGGCCAGGTTGG -> ATACGTAGGCCAGGTTGGG
AATAGATCCGGCACGGCGC -> ATAGATCCGGCACGGCGCG
AATAGCGGACACGCATACC -> ATAGCGGACACGCATACCC
AATATATGAATCTTAGTAC -> ATATATGAATCTTAGTACG
AATATTATGAACCAAATGT -> ATATTATGAACCAAATGTT
AATATTTGGTATCCTGACG -> ATATTTGGTATCCTGACGG
AATCAACCGGTTAGCAGAC -> ATCAACCGGTTAGCAGACA
AATCAATACGTAGGCCAGG -> ATCAATACGTAGGCCAGGT
AATCACCCTGGGATATGAT -> ATCACCCTGGGATATGATG
AATCATGACTAGCCAACTC -> ATCATGACTAGCCAACTCC
AATCCAATCCCTTAGCCCT -> ATCCAATCCCTTAGCCCTA
AATCCCTTAGCCCTATTTC -> ATCCCTTAGCCCTATTTCC
AATCCGGAACGGGGTACCA -> ATCCGGAACGGGGTACCAT
AATCCTCTTGGAAATTCGA -> ATCCTCTTGGAAATTCGAA
AATCGCTCCCGTGTTGGAT -> ATCGCTCCCGTGTTGGATG
AATCGTATGACCGTAAGAC -> ATCGTATGACCGTAAGACA
AATCGTGACATGGATAACA -> ATCGTGACATGGATAACAT
AATCTGAAGTGGGTTCAAT -> ATCTGAAGTGGGTTCAATG
AATCTTAGTACGACTCAAC -> ATCTTAGTACGACTCAACG
AATGACCGCCTCCACGAGA -> ATGACCGCCTCCACGAGAC
AATGAGGTTAGGTACGAAT -> ATGAGGTTAGGTACGAATA
AATGCGAACTGGATGTGAT -> ATGCGAACTGGATGTGATG
AATGGCAACGAACAATTCC -> ATGGCAACGAACAATTCCA
AATGGCAGCTTGTCCAACC -> ATGGCAGCTTGTCCAACCC
AATGGCTCCTACCCGCCCG -> ATGGCTCCTACCCGCCCGG
AATGGCTTTGAACCAAATG -> ATGGCTTTGAACCAAATGT
AATGGTAGCCAGCATACCA -> ATGGTAGCCAGCATACCAA
AATGTTGGAGCCAACCAAA -> ATGTTGGAGCCAACCAAAT
AATGTTGGAGCCACTTCCC -> ATGTTGGAGCCACTTCCCA
AATGTTGGAGCCATGGGGG -> ATGTTGGAGCCATGGGGGT
AATGTTGGAGCCATTGGTA -> ATGTTGGAGCCATTGGTAC
AATTAAACAACAGACAGTA -> ATTAAACAACAGACAGTAC
AATTAGACTTTTAGATACA -> ATTAGACTTTTAGATACAA
AATTCCAGGATGGTGTACC -> ATTCCAGGATGGTGTACCA
AATTCGAACGTGCCCGGCA -> ATTCGAACGTGCCCGGCAT
AATTCGAGTCGGGGGCAGA -> ATTCGAGTCGGGGGCAGAA
AATTCGGCTTGAACCAAAT -> ATTCGGCTTGAACCAAATG
AATTGCACCGCATGTGGTA -> ATTGCACCGCATGTGGTAT
AATTGCAGAACTTTTGAGG -> ATTGCAGAACTTTTGAGGG
AATTGTGGCCATGTCTGCT -> ATTGTGGCCATGTCTGCTT
ACAAAACACTACCAATTGC -> CAAAACACTACCAATTGCA
ACAAACCGATCGCTCGAAT -> CAAACCGATCGCTCGAATC
ACAAACTCTGTACACCTTA -> CAAACTCTGTACACCTTAC
ACAACACTACGGTCCGGGG -> CAACACTACGGTCCGGGGA
ACAACAGACAGTACAGTTT -> CAACAGACAGTACAGTTTG
ACAACTACAGAATGACCGC -> CAACTACAGAATGACCGCC
ACAAGCCCCCTCACCTCAA -> CAAGCCCCCTCACCTCAAT
ACAAGCCTCTCCGAGCTTA -> CAAGCCTCTCCGAGCTTAG
ACAATTCCAGGATGGTGTA -> CAATTCCAGGATGGTGTAC
ACAATTGTGGCCATGTCTG -> CAATTGTGGCCATGTCTGC
ACACAGTACAGCTCCCGTC -> CACAGTACAGCTCCCGTCA
ACACATACACCAGCTGGCC -> CACATACACCAGCTGGCCT
ACACATGATCCTGTCAGCG -> CACATGATCCTGTCAGCGG
ACACCAGCTGGCCTGTGGG -> CACCAGCTGGCCTGTGGGG
ACACCTTACGTGTCAAAAA -> CACCTTACGTGTCAAAAAT
ACACGCATACCCGAGTCTG -> CACGCATACCCGAGTCTGT
ACACTACCAATTGCAGAAC -> CACTACCAATTGCAGAACT
ACACTACGGTCCGGGGAGT -> CACTACGGTCCGGGGAGTT
ACACTATATGCTATGCGTA -> CACTATATGCTATGCGTAC
ACAGAATGACCGCCTCCAC -> CAGAATGACCGCCTCCACG
ACAGACAGTACAGTTTGTC -> CAGACAGTACAGTTTGTCG
ACAGAGTTACCGACGCCGT -> CAGAGTTACCGACGCCGTA
ACAGCCGTCTAACATTTAT -> CAGCCGTCTAACATTTATA
ACAGCCTCGTGTAGACCAG -> CAGCCTCGTGTAGACCAGA
ACAGCTCCCGTCATCCAGG -> CAGCTCCCGTCATCCAGGC
ACAGCTCCCGTCATCCCGC -> CAGCTCCCGTCATCCCGCA
ACAGCTCCCGTCATCCGAA -> CAGCTCCCGTCATCCGAAA
ACAGCTCCCGTCATCCTTA -> CAGCTCCCGTCATCCTTAG
ACAGGGATGTCCCAGCATT -> CAGGGATGTCCCAGCATTA
ACAGTACAGCTCCCGTCAT -> CAGTACAGCTCCCGTCATC
ACAGTACAGTTTGTCGTCG -> CAGTACAGTTTGTCGTCGT
ACAGTGGACAAACTCTGTA -> CAGTGGACAAACTCTGTAC
ACAGTTCCCCACAACTACA -> CAGTTCCCCACAACTACAG
ACAGTTTGTCGTCGTGCTC -> CAGTTTGTCGTCGTGCTCG
ACATACACCAGCTGGCCTG -> CATACACCAGCTGGCCTGT
ACATCAAACCTGCGTCGTC -> CATCAAACCTGCGTCGTCT
ACATCATCACTAAACGCGT -> CATCATCACTAAACGCGTA
ACATCCCAAGCTTATAAGC -> CATCCCAAGCTTATAAGCT
ACATCGACGCGAACGAAAA -> CATCGACGCGAACGAAAAA
ACATGATCCTGTCAGCGGA -> CATGATCCTGTCAGCGGAT
ACATGCGAATTCGAGTCGG -> CATGCGAATTCGAGTCGGG
ACATGGATAACATCAAACC -> CATGGATAACATCAAACCT
ACATGGATGGTGTGAGGTC -> CATGGATGGTGTGAGGTCG
ACATTCCCAACCACCTCCA -> CATTCCCAACCACCTCCAT
ACATTTATATCCAGTCAGC -> CATTTATATCCAGTCAGCT
ACATTTTATAATCATGACT -> CATTTTATAATCATGACTA
ACCAAAACCAAAAGTCATG -> CCAAAACCAAAAGTCATGA
ACCAAAAGTCATGATGAGC -> CCAAAAGTCATGATGAGCC
ACCAAACGCCCATACTCAA -> CCAAACGCCCATACTCAAC
ACCAAACTGCAGTCATTCT -> CCAAACTGCAGTCATTCTA
ACCAAATGTTGGAGCCAAC -> CCAAATGTTGGAGCCAACC
ACCAAATGTTGGAGCCACT -> CCAAATGTTGGAGCCACTT
ACCAAATGTTGGAGCCATG -> CCAAATGTTGGAGCCATGG
ACCAAATGTTGGAGCCATT -> CCAAATGTTGGAGCCATTG
ACCAACGGTCCGCGTACCC -> CCAACGGTCCGCGTACCCT
ACCAATTGCAGAACTTTTG -> CCAATTGCAGAACTTTTGA
ACCACCTCCATTCATGGTT -> CCACCTCCATTCATGGTTC
ACCACTAAACAGCCTCGTG -> CCACTAAACAGCCTCGTGT
ACCAGACATGGATGGTGTG -> CCAGACATGGATGGTGTGA
ACCAGACGTGCAGCGCCGA -> CCAGACGTGCAGCGCCGAC
ACCAGAGGCTTGTAGGCGC -> CCAGAGGCTTGTAGGCGCT
ACCAGCACTCTCACCAACG -> CCAGCACTCTCACCAACGG
ACCAGCTGGCCTGTGGGGT -> CCAGCTGGCCTGTGGGGTG
ACCATGATCCCAAGGGGAA -> CCATGATCCCAAGGGGAAT
ACCATGGGTAGCGGAACGG -> CCATGGGTAGCGGAACGGA
ACCCGAGTCTGTTTACCAA -> CCCGAGTCTGTTTACCAAA
ACCCGCCCGGCCCATACCG -> CCCGCCCGGCCCATACCGT
ACCCTGGGATATGATGTCA -> CCCTGGGATATGATGTCAG
ACCCTTCACCATGATCCCA -> CCCTTCACCATGATCCCAA
ACCCTTCTACTAAAGTAGG -> CCCTTCTACTAAAGTAGGG
ACCGAACGGGGACTGTTTG -> CCGAACGGGGACTGTTTGG
ACCGACGCCGTATAGCTCC -> CCGACGCCGTATAGCTCCC
ACCGATCGCTCGAATCCTC -> CCGATCGCTCGAATCCTCT
ACCGCATGTGGTATTAGCG -> CCGCATGTGGTATTAGCGC
ACCGCCTCCACGAGACTGT -> CCGCCTCCACGAGACTGTG
ACCGCGCCCAGGGGACTTT -> CCGCGCCCAGGGGACTTTT
ACCGCTATCAGGCTTCTCA -> CCGCTATCAGGCTTCTCAC
ACCGGTTAGCAGACAAACC -> CCGGTTAGCAGACAAACCG
ACCGTAAGACATGCGAATT -> CCGTAAGACATGCGAATTC
ACCGTCAATAGATCCGGCA -> CCGTCAATAGATCCGGCAC
ACCGTCCTGGACGGTAGCT -> CCGTCCTGGACGGTAGCTC
ACCGTTTGAAGGATTTGAC -> CCGTTTGAAGGATTTGACC
ACCGTTTGGGAAAAGTGAG -> CCGTTTGGGAAAAGTGAGT
ACCTCAATATATGAATCTT -> CCTCAATATATGAATCTTA
ACCTCCATTCATGGTTCGT -> CCTCCATTCATGGTTCGTC
ACCTGCGTCGTCTAGAAGG -> CCTGCGTCGTCTAGAAGGG
ACCTTACGTGTCAAAAATA -> CCTTACGTGTCAAAAATAG
ACCTTTAACTCTTTTACGA -> CCTTTAACTCTTTTACGAG
ACCTTTCGTCAATCGCTCC -> CCTTTCGTCAATCGCTCCC
ACGAAAAATTAGACTTTTA -> CGAAAAATTAGACTTTTAG
ACGAACAATTCCAGGATGG -> CGAACAATTCCAGGATGGT
ACGAATAATCAACCGGTTA -> CGAATAATCAACCGGTTAG
ACGACTCAACGGACCGAAC -> CGACTCAACGGACCGAACG
ACGAGACTGTGAACAGGGA -> CGAGACTGTGAACAGGGAT
ACGAGCCTGTCGTGGGGCT -> CGAGCCTGTCGTGGGGCTT
ACGAGCTCCAGGCGCAGTT -> CGAGCTCCAGGCGCAGTTC
ACGCAAAGCAGAATTAAAC -> CGCAAAGCAGAATTAAACA
ACGCACGGCTAGGCATTCC -> CGCACGGCTAGGCATTCCC
ACGCAGATGTTTAACACAT -> CGCAGATGTTTAACACATA
ACGCATACCCGAGTCTGTT -> CGCATACCCGAGTCTGTTT
ACGCCCATACTCAACCAGA -> CGCCCATACTCAACCAGAC
ACGCCGTATAGCTCCCCGA -> CGCCGTATAGCTCCCCGAT
ACGCGAACGAAAAATTAGA -> CGCGAACGAAAAATTAGAC
ACGCGTACTTCACGTGGTG -> CGCGTACTTCACGTGGTGC
ACGGAATCGTGACATGGAT -> CGGAATCGTGACATGGATA
ACGGACCGAACGGGGACTG -> CGGACCGAACGGGGACTGT
ACGGCCTTGAGTGACCTTT -> CGGCCTTGAGTGACCTTTC
ACGGCGCGAGCTGATTACC -> CGGCGCGAGCTGATTACCT
ACGGCTAGGCATTCCCTCG -> CGGCTAGGCATTCCCTCGC
ACGGGGACTGTTTGGAAAG -> CGGGGACTGTTTGGAAAGA
ACGGGGTACCATGGGTAGC -> CGGGGTACCATGGGTAGCG
ACGGTAGCTCCAGCTGGGT -> CGGTAGCTCCAGCTGGGTG
ACGGTCCGCGTACCCTTCA -> CGGTCCGCGTACCCTTCAC
ACGGTCCGGGGAGTTACCA -> CGGTCCGGGGAGTTACCAG
ACGGTTAAGGGGAATCGTA -> CGGTTAAGGGGAATCGTAT
ACGTAAGTTTGCGAGTCAG -> CGTAAGTTTGCGAGTCAGC
ACGTAGGCCAGGTTGGGTT -> CGTAGGCCAGGTTGGGTTC
ACGTATTAAAACCGTTTGA -> CGTATTAAAACCGTTTGAA
ACGTATTAAATGAGGTTAG -> CGTATTAAATGAGGTTAGG
ACGTCCTTAATCAATACGT -> CGTCCTTAATCAATACGTA
ACGTGACGCAGATGTTTAA -> CGTGACGCAGATGTTTAAC
ACGTGCAGCGCCGACAGCC -> CGTGCAGCGCCGACAGCCG
ACGTGCCCGGCATACTTCG -> CGTGCCCGGCATACTTCGC
ACGTGGTGCTCTGCCTAAA -> CGTGGTGCTCTGCCTAAAC
ACGTGTCAAAAATAGCGGA -> CGTGTCAAAAATAGCGGAC
ACGTTACATTCCCAACCAC -> CGTTACATTCCCAACCACC
ACTAAACAGCCTCGTGTAG -> CTAAACAGCCTCGTGTAGA
ACTAAACGCGTACTTCACG -> CTAAACGCGTACTTCACGT
ACTAAAGTAGGGAAAAGTC -> CTAAAGTAGGGAAAAGTCC
ACTAATTGCACCGCATGTG -> CTAATTGCACCGCATGTGG
ACTACAGAATGACCGCCTC -> CTACAGAATGACCGCCTCC
ACTACAGAGTTACCGACGC -> CTACAGAGTTACCGACGCC
ACTACCAATTGCAGAACTT -> CTACCAATTGCAGAACTTT
ACTACGGTCCGGGGAGTTA -> CTACGGTCCGGGGAGTTAC
ACTAGCCAACTCCCACTGA -> CTAGCCAACTCCCACTGAA
ACTATATGCTATGCGTACA -> CTATATGCTATGCGTACAG
ACTCAACCAGACATGGATG -> CTCAACCAGACATGGATGG
ACTCAACGGACCGAACGGG -> CTCAACGGACCGAACGGGG
ACTCCCACTGAACGTCCTT -> CTCCCACTGAACGTCCTTA
ACTCGTTGTCTGGGGTACC -> CTCGTTGTCTGGGGTACCG
ACTCTATGTTACGCACGGC -> CTCTATGTTACGCACGGCT
ACTCTCACCAACGGTCCGC -> CTCTCACCAACGGTCCGCG
ACTCTGTACACCTTACGTG -> CTCTGTACACCTTACGTGT
ACTCTTTTACGAGCCTGTC -> CTCTTTTACGAGCCTGTCG
ACTGAACGTCCTTAATCAA -> CTGAACGTCCTTAATCAAT
ACTGCAGTCATTCTATGTG -> CTGCAGTCATTCTATGTGG
ACTGGATGAGGGAGACGTA -> CTGGATGAGGGAGACGTAT
ACTGGATGTGATGTACAGC -> CTGGATGTGATGTACAGCT
ACTGTGAACAGGGATGTCC -> CTGTGAACAGGGATGTCCC
ACTGTTTGGAAAGAATGGC -> CTGTTTGGAAAGAATGGCT
ACTTCACGTGGTGCTCTGC -> CTTCACGTGGTGCTCTGCC
ACTTCCCAAGCAGCGAGGA -> CTTCCCAAGCAGCGAGGAA
ACTTCGCGTAAACGCAAAG -> CTTCGCGTAAACGCAAAGC
ACTTGTGCAAGACAATTGT -> CTTGTGCAAGACAATTGTG
ACTTTTACATCCCAAGCTT -> CTTTTACATCCCAAGCTTA
ACTTTTAGATACAACACTA -> CTTTTAGATACAACACTAC
ACTTTTGAGGGCGTCTCTT -> CTTTTGAGGGCGTCTCTTA
AGAACTTTTGAGGGCGTCT -> GAACTTTTGAGGGCGTCTC
AGAAGGAACAAGCCCCCTC -> GAAGGAACAAGCCCCCTCA
AGAAGGGTCTAAGCAGAAG -> GAAGGGTCTAAGCAGAAGG
AGAATATTATGAACCAAAT -> GAATATTATGAACCAAATG
AGAATCTGAAGTGGGTTCA -> GAATCTGAAGTGGGTTCAA
AGAATGACCGCCTCCACGA -> GAATGACCGCCTCCACGAG
AGAATGCGAACTGGATGTG -> GAATGCGAACTGGATGTGA
AGAATGGCTCCTACCCGCC -> GAATGGCTCCTACCCGCCC
AGAATTAAACAACAGACAG -> GAATTAAACAACAGACAGT
AGACAAACCGATCGCTCGA -> GACAAACCGATCGCTCGAA
AGACAATTGTGGCCATGTC -> GACAATTGTGGCCATGTCT
AGACAGTACAGTTTGTCGT -> GACAGTACAGTTTGTCGTC
AGACATGCGAATTCGAGTC -> GACATGCGAATTCGAGTCG
AGACATGGATGGTGTGAGG -> GACATGGATGGTGTGAGGT
AGACCAGAGGCTTGTAGGC -> GACCAGAGGCTTGTAGGCG
AGACGTATTAAATGAGGTT -> GACGTATTAAATGAGGTTA
AGACGTGCAGCGCCGACAG -> GACGTGCAGCGCCGACAGC
AGACTGTGAACAGGGATGT -> GACTGTGAACAGGGATGTC
AGACTTTTAGATACAACAC -> GACTTTTAGATACAACACT
AGAGCTCCGTCAACGTGAC -> GAGCTCCGTCAACGTGACG
AGAGGCTTGTAGGCGCTTA -> GAGGCTTGTAGGCGCTTAA
AGAGTTACCGACGCCGTAT -> GAGTTACCGACGCCGTATA
AGATAATCACCCTGGGATA -> GATAATCACCCTGGGATAT
AGATACAACACTACGGTCC -> GATACAACACTACGGTCCG
AGATAGAATCTGAAGTGGG -> GATAGAATCTGAAGTGGGT
AGATCCGGCACGGCGCGAG -> GATCCGGCACGGCGCGAGC
AGATGTTTAACACATACAC -> GATGTTTAACACATACACC
AGCACCGCTATCAGGCTTC -> GCACCGCTATCAGGCTTCT
AGCACTCTCACCAACGGTC -> GCACTCTCACCAACGGTCC
AGCAGAAGGAACAAGCCCC -> GCAGAAGGAACAAGCCCCC
AGCAGAATTAAACAACAGA -> GCAGAATTAAACAACAGAC
AGCAGACAAACCGATCGCT -> GCAGACAAACCGATCGCTC
AGCAGATAGAATCTGAAGT -> GCAGATAGAATCTGAAGTG
AGCAGCGAGGAAGCTTGGG -> GCAGCGAGGAAGCTTGGGT
AGCATACCAAAACCAAAAG -> GCATACCAAAACCAAAAGT
AGCATTACTTGTGCAAGAC -> GCATTACTTGTGCAAGACA
AGCCAACCAAATGTTGGAG -> GCCAACCAAATGTTGGAGC
AGCCAACTCCCACTGAACG -> GCCAACTCCCACTGAACGT
AGCCACGTTACATTCCCAA -> GCCACGTTACATTCCCAAC
AGCCACTTCCCAAGCAGCG -> GCCACTTCCCAAGCAGCGA
AGCCAGCATACCAAAACCA -> GCCAGCATACCAAAACCAA
AGCCATGGGGGTAACTCGT -> GCCATGGGGGTAACTCGTT
AGCCATTGGTACGTATTAA -> GCCATTGGTACGTATTAAA
AGCCCCCTCACCTCAATAT -> GCCCCCTCACCTCAATATA
AGCCCTATTTCCACTAATT -> GCCCTATTTCCACTAATTG
AGCCGTCTAACATTTATAT -> GCCGTCTAACATTTATATC
AGCCTATTGTGACATCGAC -> GCCTATTGTGACATCGACG
AGCCTCCCCGTCATATACC -> GCCTCCCCGTCATATACCA
AGCCTCGTGTAGACCAGAG -> GCCTCGTGTAGACCAGAGG
AGCCTCTCCGAGCTTAGCT -> GCCTCTCCGAGCTTAGCTG
AGCCTGTCGTGGGGCTTCT -> GCCTGTCGTGGGGCTTCTG
AGCGAGGAAGCTTGGGTTG -> GCGAGGAAGCTTGGGTTGC
AGCGCCGACAGCCGTCTAA -> GCGCCGACAGCCGTCTAAC
AGCGCGATTTAGTAGCAGA -> GCGCGATTTAGTAGCAGAT
AGCGGAACGGAATCGTGAC -> GCGGAACGGAATCGTGACA
AGCGGACACGCATACCCGA -> GCGGACACGCATACCCGAG
AGCGGATAGCTGATCCACA -> GCGGATAGCTGATCCACAG
AGCTAGCCTATTGTGACAT -> GCTAGCCTATTGTGACATC
AGCTCCAGCTGGGTGCTGC -> GCTCCAGCTGGGTGCTGCC
AGCTCCAGGCGCAGTTCTC -> GCTCCAGGCGCAGTTCTCT
AGCTCCCCGATATGTTGGG -> GCTCCCCGATATGTTGGGG
AGCTCCCGTCATCCAGGCC -> GCTCCCGTCATCCAGGCCA
AGCTCCCGTCATCCCGCAA -> GCTCCCGTCATCCCGCAAT
AGCTCCCGTCATCCGAAAT -> GCTCCCGTCATCCGAAATT
AGCTCCCGTCATCCTTAGA -> GCTCCCGTCATCCTTAGAA
AGCTCCGTCAACGTGACGC -> GCTCCGTCAACGTGACGCA
AGCTGATCCACAGTGGACA -> GCTGATCCACAGTGGACAA
AGCTGATTACCTTTAACTC -> GCTGATTACCTTTAACTCT
AGCTGGCCTGTGGGGTGCA -> GCTGGCCTGTGGGGTGCAA
AGCTGGGTGCTGCCATAGT -> GCTGGGTGCTGCCATAGTG
AGCTGTAATGGCAGCTTGT -> GCTGTAATGGCAGCTTGTC
AGCTGTACACATGATCCTG -> GCTGTACACATGATCCTGT
AGCTTAGCTGTAATGGCAG -> GCTTAGCTGTAATGGCAGC
AGCTTATAAGCTGTACACA -> GCTTATAAGCTGTACACAT
AGCTTGGGTTGCCCTGACG -> GCTTGGGTTGCCCTGACGA
AGCTTGTCCAACCCTTCTA -> GCTTGTCCAACCCTTCTAC
AGGAACAAGCCCCCTCACC -> GGAACAAGCCCCCTCACCT
AGGAAGCTTGGGTTGCCCT -> GGAAGCTTGGGTTGCCCTG
AGGATGGTGTACCACTAAA -> GGATGGTGTACCACTAAAC
AGGATTTGACCGCGCCCAG -> GGATTTGACCGCGCCCAGG
AGGCATTCCCTCGCTCTTG -> GGCATTCCCTCGCTCTTGT
AGGCCAGGTTGGGTTCGTT -> GGCCAGGTTGGGTTCGTTA
AGGCCATGCTGTGGGTACA -> GGCCATGCTGTGGGTACAG
AGGCGCAGTTCTCTGAGTC -> GGCGCAGTTCTCTGAGTCC
AGGCGCTTAAAGATAATCA -> GGCGCTTAAAGATAATCAC
AGGCTTCTCACCGTCCTGG -> GGCTTCTCACCGTCCTGGA
AGGCTTGTAGGCGCTTAAA -> GGCTTGTAGGCGCTTAAAG
AGGGAAAAGTCCGCATAAT -> GGGAAAAGTCCGCATAATA
AGGGAGACGTATTAAATGA -> GGGAGACGTATTAAATGAG
AGGGATGTCCCAGCATTAC -> GGGATGTCCCAGCATTACT
AGGGCGTCTCTTAGACGTC -> GGGCGTCTCTTAGACGTCT
AGGGGAATCCGGAACGGGG -> GGGGAATCCGGAACGGGGT
AGGGGAATCGTATGACCGT -> GGGGAATCGTATGACCGTA
AGGGGACTTTTACATCCCA -> GGGGACTTTTACATCCCAA
AGGGTCTAAGCAGAAGGAA -> GGGTCTAAGCAGAAGGAAC
AGGTACGAATAATCAACCG -> GGTACGAATAATCAACCGG
AGGTCGTCTCATTGAACAG -> GGTCGTCTCATTGAACAGT
AGGTTAGGTACGAATAATC -> GGTTAGGTACGAATAATCA
AGGTTGGGTTCGTTAACAA -> GGTTGGGTTCGTTAACAAA
AGTACAGCTCCCGTCATCC -> GTACAGCTCCCGTCATCCA
AGTACAGTTTGTCGTCGTG -> GTACAGTTTGTCGTCGTGC
AGTACGACTCAACGGACCG -> GTACGACTCAACGGACCGA
AGTACGGTTAAGGGGAATC -> GTACGGTTAAGGGGAATCG
AGTAGCAGATAGAATCTGA -> GTAGCAGATAGAATCTGAA
AGTAGGGAAAAGTCCGCAT -> GTAGGGAAAAGTCCGCATA
AGTCAGCACCGCTATCAGG -> GTCAGCACCGCTATCAGGC
AGTCAGCCACGTTACATTC -> GTCAGCCACGTTACATTCC
AGTCAGCTAGCCTATTGTG -> GTCAGCTAGCCTATTGTGA
AGTCATGATGAGCCTCCCC -> GTCATGATGAGCCTCCCCG
AGTCATTCTATGTGGGATT -> GTCATTCTATGTGGGATTC
AGTCCGCATAATATTTGGT -> GTCCGCATAATATTTGGTA
AGTCCGTTTCTTTGGCTCG -> GTCCGTTTCTTTGGCTCGG
AGTCGGGGGCAGAATGCGA -> GTCGGGGGCAGAATGCGAA
AGTCTGTTTACCAAACGCC -> GTCTGTTTACCAAACGCCC
AGTGACCTTTCGTCAATCG -> GTGACCTTTCGTCAATCGC
AGTGAGTCAGCCACGTTAC -> GTGAGTCAGCCACGTTACA
AGTGGACAAACTCTGTACA -> GTGGACAAACTCTGTACAC
AGTGGAGAGCTCCGTCAAC -> GTGGAGAGCTCCGTCAACG
AGTGGGTTCAATGGCAACG -> GTGGGTTCAATGGCAACGA
AGTTACCAGCACTCTCACC -> GTTACCAGCACTCTCACCA
AGTTACCGACGCCGTATAG -> GTTACCGACGCCGTATAGC
AGTTCCCCACAACTACAGA -> GTTCCCCACAACTACAGAA
AGTTCTCTGAGTCCGTTTC -> GTTCTCTGAGTCCGTTTCT
AGTTTGCGAGTCAGCACCG -> GTTTGCGAGTCAGCACCGC
AGTTTGTCGTCGTGCTCGA -> GTTTGTCGTCGTGCTCGAT
ATAACATCAAACCTGCGTC -> TAACATCAAACCTGCGTCG
ATAAGCTGTACACATGATC -> TAAGCTGTACACATGATCC
ATAATATTTGGTATCCTGA -> TAATATTTGGTATCCTGAC
ATAATCAACCGGTTAGCAG -> TAATCAACCGGTTAGCAGA
ATAATCACCCTGGGATATG -> TAATCACCCTGGGATATGA
ATAATCATGACTAGCCAAC -> TAATCATGACTAGCCAACT
ATACAACACTACGGTCCGG -> TACAACACTACGGTCCGGG
ATACACCAGCTGGCCTGTG -> TACACCAGCTGGCCTGTGG
ATACCAAAACCAAAAGTCA -> TACCAAAACCAAAAGTCAT
ATACCAGACGTGCAGCGCC -> TACCAGACGTGCAGCGCCG
ATACCCGAGTCTGTTTACC -> TACCCGAGTCTGTTTACCA
ATACCGTTTGGGAAAAGTG -> TACCGTTTGGGAAAAGTGA
ATACGTAGGCCAGGTTGGG -> TACGTAGGCCAGGTTGGGT
ATACTCAACCAGACATGGA -> TACTCAACCAGACATGGAT
ATACTTCGCGTAAACGCAA -> TACTTCGCGTAAACGCAAA
ATAGAATCTGAAGTGGGTT -> TAGAATCTGAAGTGGGTTC
ATAGATCCGGCACGGCGCG -> TAGATCCGGCACGGCGCGA
ATAGCGGACACGCATACCC -> TAGCGGACACGCATACCCG
ATAGCTCCCCGATATGTTG -> TAGCTCCCCGATATGTTGG
ATAGCTGATCCACAGTGGA -> TAGCTGATCCACAGTGGAC
ATAGTGGAGAGCTCCGTCA -> TAGTGGAGAGCTCCGTCAA
ATATACCAGACGTGCAGCG -> TATACCAGACGTGCAGCGC
ATATATGAATCTTAGTACG -> TATATGAATCTTAGTACGA
ATATCCAGTCAGCTAGCCT -> TATCCAGTCAGCTAGCCTA
ATATGAATCTTAGTACGAC -> TATGAATCTTAGTACGACT
ATATGATGTCAGTACGGTT -> TATGATGTCAGTACGGTTA
ATATGCTATGCGTACAGCT -> TATGCTATGCGTACAGCTC
ATATGTTGGGGTTGTCATT -> TATGTTGGGGTTGTCATTA
ATATTATGAACCAAATGTT -> TATTATGAACCAAATGTTG
ATATTTGGTATCCTGACGG -> TATTTGGTATCCTGACGGC
ATCAAACCTGCGTCGTCTA -> TCAAACCTGCGTCGTCTAG
ATCAACCGGTTAGCAGACA -> TCAACCGGTTAGCAGACAA
ATCAATACGTAGGCCAGGT -> TCAATACGTAGGCCAGGTT
ATCACCCTGGGATATGATG -> TCACCCTGGGATATGATGT
ATCACTAAACGCGTACTTC -> TCACTAAACGCGTACTTCA
ATCAGGCTTCTCACCGTCC -> TCAGGCTTCTCACCGTCCT
ATCATCACTAAACGCGTAC -> TCATCACTAAACGCGTACT
ATCATGACTAGCCAACTCC -> TCATGACTAGCCAACTCCC
ATCCAATCCCTTAGCCCTA -> TCCAATCCCTTAGCCCTAT
ATCCACAGTGGACAAACTC -> TCCACAGTGGACAAACTCT
ATCCAGGCCATGCTGTGGG -> TCCAGGCCATGCTGTGGGT
ATCCAGTCAGCTAGCCTAT -> TCCAGTCAGCTAGCCTATT
ATCCCAAGCTTATAAGCTG -> TCCCAAGCTTATAAGCTGT
ATCCCAAGGGGAATCCGGA -> TCCCAAGGGGAATCCGGAA
ATCCCGCAATGGCTTTGAA -> TCCCGCAATGGCTTTGAAC
ATCCCTTAGCCCTATTTCC -> TCCCTTAGCCCTATTTCCA
ATCCGAAATTCGGCTTGAA -> TCCGAAATTCGGCTTGAAC
ATCCGGAACGGGGTACCAT -> TCCGGAACGGGGTACCATG
ATCCGGCACGGCGCGAGCT -> TCCGGCACGGCGCGAGCTG
ATCCTCTTGGAAATTCGAA -> TCCTCTTGGAAATTCGAAC
ATCCTGACGGCCTTGAGTG -> TCCTGACGGCCTTGAGTGA
ATCCTGTCAGCGGATAGCT -> TCCTGTCAGCGGATAGCTG
ATCCTTAGAATATTATGAA -> TCCTTAGAATATTATGAAC
ATCGACGCGAACGAAAAAT -> TCGACGCGAACGAAAAATT
ATCGCTCCCGTGTTGGATG -> TCGCTCCCGTGTTGGATGT
ATCGCTCGAATCCTCTTGG -> TCGCTCGAATCCTCTTGGA
ATCGTATGACCGTAAGACA -> TCGTATGACCGTAAGACAT
ATCGTGACATGGATAACAT -> TCGTGACATGGATAACATC
ATCTGAAGTGGGTTCAATG -> TCTGAAGTGGGTTCAATGG
ATCTTAGTACGACTCAACG -> TCTTAGTACGACTCAACGG
ATGAACCAAATGTTGGAGC -> TGAACCAAATGTTGGAGCC
ATGAATCTTAGTACGACTC -> TGAATCTTAGTACGACTCA
ATGACCGCCTCCACGAGAC -> TGACCGCCTCCACGAGACT
ATGACCGTAAGACATGCGA -> TGACCGTAAGACATGCGAA
ATGACTAGCCAACTCCCAC -> TGACTAGCCAACTCCCACT
ATGAGCCTCCCCGTCATAT -> TGAGCCTCCCCGTCATATA
ATGAGGGAGACGTATTAAA -> TGAGGGAGACGTATTAAAT
ATGAGGTTAGGTACGAATA -> TGAGGTTAGGTACGAATAA
ATGATCCCAAGGGGAATCC -> TGATCCCAAGGGGAATCCG
ATGATCCTGTCAGCGGATA -> TGATCCTGTCAGCGGATAG
ATGATGAGCCTCCCCGTCA -> TGATGAGCCTCCCCGTCAT
ATGATGTCAGTACGGTTAA -> TGATGTCAGTACGGTTAAG
ATGCGAACTGGATGTGATG -> TGCGAACTGGATGTGATGT
ATGCGAATTCGAGTCGGGG -> TGCGAATTCGAGTCGGGGG
ATGCGTACAGCTCCCGTCA -> TGCGTACAGCTCCCGTCAT
ATGCTATGCGTACAGCTCC -> TGCTATGCGTACAGCTCCC
ATGCTGTGGGTACAGCTCC -> TGCTGTGGGTACAGCTCCC
ATGGATAACATCAAACCTG -> TGGATAACATCAAACCTGC
ATGGATGGTGTGAGGTCGT -> TGGATGGTGTGAGGTCGTC
ATGGCAACGAACAATTCCA -> TGGCAACGAACAATTCCAG
ATGGCAGCTTGTCCAACCC -> TGGCAGCTTGTCCAACCCT
ATGGCCACATTTTATAATC -> TGGCCACATTTTATAATCA
ATGGCTCCTACCCGCCCGG -> TGGCTCCTACCCGCCCGGC
ATGGCTTTGAACCAAATGT -> TGGCTTTGAACCAAATGTT
ATGGGGGTAACTCGTTGTC -> TGGGGGTAACTCGTTGTCT
ATGGGTAGCGGAACGGAAT -> TGGGTAGCGGAACGGAATC
ATGGTAGCCAGCATACCAA -> TGGTAGCCAGCATACCAAA
ATGGTGTACCACTAAACAG -> TGGTGTACCACTAAACAGC
ATGGTGTGAGGTCGTCTCA -> TGGTGTGAGGTCGTCTCAT
ATGGTTCGTCACACAGTAC -> TGGTTCGTCACACAGTACA
ATGTACACTATATGCTATG -> TGTACACTATATGCTATGC
ATGTACAGCTCCCGTCATC -> TGTACAGCTCCCGTCATCC
ATGTCAGTACGGTTAAGGG -> TGTCAGTACGGTTAAGGGG
ATGTCCCAGCATTACTTGT -> TGTCCCAGCATTACTTGTG
ATGTCTGCTTAACTCTATG -> TGTCTGCTTAACTCTATGT
ATGTGATGTACAGCTCCCG -> TGTGATGTACAGCTCCCGT
ATGTGGGATTCTGCACAAG -> TGTGGGATTCTGCACAAGC
ATGTGGTATTAGCGCGATT -> TGTGGTATTAGCGCGATTT
ATGTTACGCACGGCTAGGC -> TGTTACGCACGGCTAGGCA
ATGTTGGAGCCAACCAAAT -> TGTTGGAGCCAACCAAATG
ATGTTGGAGCCACTTCCCA -> TGTTGGAGCCACTTCCCAA
ATGTTGGAGCCATGGGGGT -> TGTTGGAGCCATGGGGGTA
ATGTTGGAGCCATTGGTAC -> TGTTGGAGCCATTGGTACG
ATGTTGGGGTTGTCATTAA -> TGTTGGGGTTGTCATTAAT
ATGTTTAACACATACACCA -> TGTTTAACACATACACCAG
ATTAAAACCGTTTGAAGGA -> TTAAAACCGTTTGAAGGAT
ATTAAACAACAGACAGTAC -> TTAAACAACAGACAGTACA
ATTAAATGAGGTTAGGTAC -> TTAAATGAGGTTAGGTACG
ATTAATCCAATCCCTTAGC -> TTAATCCAATCCCTTAGCC
ATTACCTTTAACTCTTTTA -> TTACCTTTAACTCTTTTAC
ATTACTTGTGCAAGACAAT -> TTACTTGTGCAAGACAATT
ATTAGACTTTTAGATACAA -> TTAGACTTTTAGATACAAC
ATTAGCGCGATTTAGTAGC -> TTAGCGCGATTTAGTAGCA
ATTATGAACCAAATGTTGG -> TTATGAACCAAATGTTGGA
ATTATGGCCACATTTTATA -> TTATGGCCACATTTTATAA
ATTCATGGTTCGTCACACA -> TTCATGGTTCGTCACACAG
ATTCCAGGATGGTGTACCA -> TTCCAGGATGGTGTACCAC
ATTCCCAACCACCTCCATT -> TTCCCAACCACCTCCATTC
ATTCCCTCGCTCTTGTTTT -> TTCCCTCGCTCTTGTTTTG
ATTCGAACGTGCCCGGCAT -> TTCGAACGTGCCCGGCATA
ATTCGAGTCGGGGGCAGAA -> TTCGAGTCGGGGGCAGAAT
ATTCGGCTTGAACCAAATG -> TTCGGCTTGAACCAAATGT
ATTCTATGTGGGATTCTGC -> TTCTATGTGGGATTCTGCA
ATTCTGCACAAGCCTCTCC -> TTCTGCACAAGCCTCTCCG
ATTGAACAGTTCCCCACAA -> TTGAACAGTTCCCCACAAC
ATTGCACCGCATGTGGTAT -> TTGCACCGCATGTGGTATT
ATTGCAGAACTTTTGAGGG -> TTGCAGAACTTTTGAGGGC
ATTGGTACGTATTAAAACC -> TTGGTACGTATTAAAACCG
ATTGTGACATCGACGCGAA -> TTGTGACATCGACGCGAAC
ATTGTGGCCATGTCTGCTT -> TTGTGGCCATGTCTGCTTA
ATTTAGTAGCAGATAGAAT -> TTTAGTAGCAGATAGAATC
ATTTATATCCAGTCAGCTA -> TTTATATCCAGTCAGCTAG
ATTTCCACTAATTGCACCG -> TTTCCACTAATTGCACCGC
ATTTGACCGCGCCCAGGGG -> TTTGACCGCGCCCAGGGGA
ATTTGGTATCCTGACGGCC -> TTTGGTATCCTGACGGCCT
ATTTTATAATCATGACTAG -> TTTTATAATCATGACTAGC
CAAAAATAGCGGACACGCA -> AAAAATAGCGGACACGCAT
CAAAACACTACCAATTGCA -> AAAACACTACCAATTGCAG
CAAAACCAAAAGTCATGAT -> AAAACCAAAAGTCATGATG
CAAAACTACAGAGTTACCG -> AAAACTACAGAGTTACCGA
CAAAAGTCATGATGAGCCT -> AAAAGTCATGATGAGCCTC
CAAACCGATCGCTCGAATC -> AAACCGATCGCTCGAATCC
CAAACCTGCGTCGTCTAGA -> AAACCTGCGTCGTCTAGAA
CAAACGCCCATACTCAACC -> AAACGCCCATACTCAACCA
CAAACTCTGTACACCTTAC -> AAACTCTGTACACCTTACG
CAAACTGCAGTCATTCTAT -> AAACTGCAGTCATTCTATG
CAAAGCAGAATTAAACAAC -> AAAGCAGAATTAAACAACA
CAAATGTTGGAGCCAACCA -> AAATGTTGGAGCCAACCAA
CAAATGTTGGAGCCACTTC -> AAATGTTGGAGCCACTTCC
CAAATGTTGGAGCCATGGG -> AAATGTTGGAGCCATGGGG
CAAATGTTGGAGCCATTGG -> AAATGTTGGAGCCATTGGT
CAACACTACGGTCCGGGGA -> AACACTACGGTCCGGGGAG
CAACAGACAGTACAGTTTG -> AACAGACAGTACAGTTTGT
CAACATCATCACTAAACGC -> AACATCATCACTAAACGCG
CAACCAAATGTTGGAGCCA -> AACCAAATGTTGGAGCCAT
CAACCACCTCCATTCATGG -> AACCACCTCCATTCATGGT
CAACCAGACATGGATGGTG -> AACCAGACATGGATGGTGT
CAACCCTTCTACTAAAGTA -> AACCCTTCTACTAAAGTAG
CAACCGGTTAGCAGACAAA -> AACCGGTTAGCAGACAAAC
CAACGAACAATTCCAGGAT -> AACGAACAATTCCAGGATG
CAACGGACCGAACGGGGAC -> AACGGACCGAACGGGGACT
CAACGGTCCGCGTACCCTT -> AACGGTCCGCGTACCCTTC
CAACGTGACGCAGATGTTT -> AACGTGACGCAGATGTTTA
CAACTACAGAATGACCGCC -> AACTACAGAATGACCGCCT
CAACTCCCACTGAACGTCC -> AACTCCCACTGAACGTCCT
CAAGACAATTGTGGCCATG -> AAGACAATTGTGGCCATGT
CAAGCAGCGAGGAAGCTTG -> AAGCAGCGAGGAAGCTTGG
CAAGCCCCCTCACCTCAAT -> AAGCCCCCTCACCTCAATA
CAAGCCTCTCCGAGCTTAG -> AAGCCTCTCCGAGCTTAGC
CAAGCTTATAAGCTGTACA -> AAGCTTATAAGCTGTACAC
CAAGGGGAATCCGGAACGG -> AAGGGGAATCCGGAACGGG
CAATACGTAGGCCAGGTTG -> AATACGTAGGCCAGGTTGG
CAATAGATCCGGCACGGCG -> AATAGATCCGGCACGGCGC
CAATATATGAATCTTAGTA -> AATATATGAATCTTAGTAC
CAATCCCTTAGCCCTATTT -> AATCCCTTAGCCCTATTTC
CAATCGCTCCCGTGTTGGA -> AATCGCTCCCGTGTTGGAT
CAATGGCAACGAACAATTC -> AATGGCAACGAACAATTCC
CAATGGCTTTGAACCAAAT -> AATGGCTTTGAACCAAATG
CAATTCCAGGATGGTGTAC -> AATTCCAGGATGGTGTACC
CAATTGCAGAACTTTTGAG -> AATTGCAGAACTTTTGAGG
CAATTGTGGCCATGTCTGC -> AATTGTGGCCATGTCTGCT
CACAACTACAGAATGACCG -> ACAACTACAGAATGACCGC
CACAAGCCTCTCCGAGCTT -> ACAAGCCTCTCCGAGCTTA
CACACAGTACAGCTCCCGT -> ACACAGTACAGCTCCCGTC
CACAGTACAGCTCCCGTCA -> ACAGTACAGCTCCCGTCAT
CACAGTGGACAAACTCTGT -> ACAGTGGACAAACTCTGTA
CACATACACCAGCTGGCCT -> ACATACACCAGCTGGCCTG
CACATGATCCTGTCAGCGG -> ACATGATCCTGTCAGCGGA
CACATTTTATAATCATGAC -> ACATTTTATAATCATGACT
CACCAACGGTCCGCGTACC -> ACCAACGGTCCGCGTACCC
CACCAGCTGGCCTGTGGGG -> ACCAGCTGGCCTGTGGGGT
CACCATGATCCCAAGGGGA -> ACCATGATCCCAAGGGGAA
CACCCTGGGATATGATGTC -> ACCCTGGGATATGATGTCA
CACCGCATGTGGTATTAGC -> ACCGCATGTGGTATTAGCG
CACCGCTATCAGGCTTCTC -> ACCGCTATCAGGCTTCTCA
CACCGTCCTGGACGGTAGC -> ACCGTCCTGGACGGTAGCT
CACCTCAATATATGAATCT -> ACCTCAATATATGAATCTT
CACCTCCATTCATGGTTCG -> ACCTCCATTCATGGTTCGT
CACCTTACGTGTCAAAAAT -> ACCTTACGTGTCAAAAATA
CACGAGACTGTGAACAGGG -> ACGAGACTGTGAACAGGGA
CACGCATACCCGAGTCTGT -> ACGCATACCCGAGTCTGTT
CACGGCGCGAGCTGATTAC -> ACGGCGCGAGCTGATTACC
CACGGCTAGGCATTCCCTC -> ACGGCTAGGCATTCCCTCG
CACGTGGTGCTCTGCCTAA -> ACGTGGTGCTCTGCCTAAA
CACGTTACATTCCCAACCA -> ACGTTACATTCCCAACCAC
CACTAAACAGCCTCGTGTA -> ACTAAACAGCCTCGTGTAG
CACTAAACGCGTACTTCAC -> ACTAAACGCGTACTTCACG
CACTAATTGCACCGCATGT -> ACTAATTGCACCGCATGTG
CACTACCAATTGCAGAACT -> ACTACCAATTGCAGAACTT
CACTACGGTCCGGGGAGTT -> ACTACGGTCCGGGGAGTTA
CACTATATGCTATGCGTAC -> ACTATATGCTATGCGTACA
CACTCTCACCAACGGTCCG -> ACTCTCACCAACGGTCCGC
CACTGAACGTCCTTAATCA -> ACTGAACGTCCTTAATCAA
CACTTCCCAAGCAGCGAGG -> ACTTCCCAAGCAGCGAGGA
CAGAACTTTTGAGGGCGTC -> AGAACTTTTGAGGGCGTCT
CAGAAGGAACAAGCCCCCT -> AGAAGGAACAAGCCCCCTC
CAGAATGACCGCCTCCACG -> AGAATGACCGCCTCCACGA
CAGAATGCGAACTGGATGT -> AGAATGCGAACTGGATGTG
CAGAATTAAACAACAGACA -> AGAATTAAACAACAGACAG
CAGACAAACCGATCGCTCG -> AGACAAACCGATCGCTCGA
CAGACAGTACAGTTTGTCG -> AGACAGTACAGTTTGTCGT
CAGACATGGATGGTGTGAG -> AGACATGGATGGTGTGAGG
CAGACGTGCAGCGCCGACA -> AGACGTGCAGCGCCGACAG
CAGAGGCTTGTAGGCGCTT -> AGAGGCTTGTAGGCGCTTA
CAGAGTTACCGACGCCGTA -> AGAGTTACCGACGCCGTAT
CAGATAGAATCTGAAGTGG -> AGATAGAATCTGAAGTGGG
CAGATGTTTAACACATACA -> AGATGTTTAACACATACAC
CAGCACCGCTATCAGGCTT -> AGCACCGCTATCAGGCTTC
CAGCACTCTCACCAACGGT -> AGCACTCTCACCAACGGTC
CAGCATACCAAAACCAAAA -> AGCATACCAAAACCAAAAG
CAGCATTACTTGTGCAAGA -> AGCATTACTTGTGCAAGAC
CAGCCACGTTACATTCCCA -> AGCCACGTTACATTCCCAA
CAGCCGTCTAACATTTATA -> AGCCGTCTAACATTTATAT
CAGCCTCGTGTAGACCAGA -> AGCCTCGTGTAGACCAGAG
CAGCGAGGAAGCTTGGGTT -> AGCGAGGAAGCTTGGGTTG
CAGCGCCGACAGCCGTCTA -> AGCGCCGACAGCCGTCTAA
CAGCGGATAGCTGATCCAC -> AGCGGATAGCTGATCCACA
CAGCTAGCCTATTGTGACA -> AGCTAGCCTATTGTGACAT
CAGCTCCCGTCATCCAGGC -> AGCTCCCGTCATCCAGGCC
CAGCTCCCGTCATCCCGCA -> AGCTCCCGTCATCCCGCAA
CAGCTCCCGTCATCCGAAA -> AGCTCCCGTCATCCGAAAT
CAGCTCCCGTCATCCTTAG -> AGCTCCCGTCATCCTTAGA
CAGCTGGCCTGTGGGGTGC -> AGCTGGCCTGTGGGGTGCA
CAGCTGGGTGCTGCCATAG -> AGCTGGGTGCTGCCATAGT
CAGCTTGTCCAACCCTTCT -> AGCTTGTCCAACCCTTCTA
CAGGATGGTGTACCACTAA -> AGGATGGTGTACCACTAAA
CAGGCCATGCTGTGGGTAC -> AGGCCATGCTGTGGGTACA
CAGGCGCAGTTCTCTGAGT -> AGGCGCAGTTCTCTGAGTC
CAGGCTTCTCACCGTCCTG -> AGGCTTCTCACCGTCCTGG
CAGGGATGTCCCAGCATTA -> AGGGATGTCCCAGCATTAC
CAGGGGACTTTTACATCCC -> AGGGGACTTTTACATCCCA
CAGGTTGGGTTCGTTAACA -> AGGTTGGGTTCGTTAACAA
CAGTACAGCTCCCGTCATC -> AGTACAGCTCCCGTCATCC
CAGTACAGTTTGTCGTCGT -> AGTACAGTTTGTCGTCGTG
CAGTACGGTTAAGGGGAAT -> AGTACGGTTAAGGGGAATC
CAGTCAGCTAGCCTATTGT -> AGTCAGCTAGCCTATTGTG
CAGTCATTCTATGTGGGAT -> AGTCATTCTATGTGGGATT
CAGTGGACAAACTCTGTAC -> AGTGGACAAACTCTGTACA
CAGTTCCCCACAACTACAG -> AGTTCCCCACAACTACAGA
CAGTTCTCTGAGTCCGTTT -> AGTTCTCTGAGTCCGTTTC
CAGTTTGTCGTCGTGCTCG -> AGTTTGTCGTCGTGCTCGA
CATAATATTTGGTATCCTG -> ATAATATTTGGTATCCTGA
CATACACCAGCTGGCCTGT -> ATACACCAGCTGGCCTGTG
CATACCAAAACCAAAAGTC -> ATACCAAAACCAAAAGTCA
CATACCCGAGTCTGTTTAC -> ATACCCGAGTCTGTTTACC
CATACCGTTTGGGAAAAGT -> ATACCGTTTGGGAAAAGTG
CATACTCAACCAGACATGG -> ATACTCAACCAGACATGGA
CATACTTCGCGTAAACGCA -> ATACTTCGCGTAAACGCAA
CATAGTGGAGAGCTCCGTC -> ATAGTGGAGAGCTCCGTCA
CATATACCAGACGTGCAGC -> ATATACCAGACGTGCAGCG
CATCAAACCTGCGTCGTCT -> ATCAAACCTGCGTCGTCTA
CATCACTAAACGCGTACTT -> ATCACTAAACGCGTACTTC
CATCATCACTAAACGCGTA -> ATCATCACTAAACGCGTAC
CATCCAGGCCATGCTGTGG -> ATCCAGGCCATGCTGTGGG
CATCCCAAGCTTATAAGCT -> ATCCCAAGCTTATAAGCTG
CATCCCGCAATGGCTTTGA -> ATCCCGCAATGGCTTTGAA
CATCCGAAATTCGGCTTGA -> ATCCGAAATTCGGCTTGAA
CATCCTTAGAATATTATGA -> ATCCTTAGAATATTATGAA
CATCGACGCGAACGAAAAA -> ATCGACGCGAACGAAAAAT
CATGACTAGCCAACTCCCA -> ATGACTAGCCAACTCCCAC
CATGATCCCAAGGGGAATC -> ATGATCCCAAGGGGAATCC
CATGATCCTGTCAGCGGAT -> ATGATCCTGTCAGCGGATA
CATGATGAGCCTCCCCGTC -> ATGATGAGCCTCCCCGTCA
CATGCGAATTCGAGTCGGG -> ATGCGAATTCGAGTCGGGG
CATGCTGTGGGTACAGCTC -> ATGCTGTGGGTACAGCTCC
CATGGATAACATCAAACCT -> ATGGATAACATCAAACCTG
CATGGATGGTGTGAGGTCG -> ATGGATGGTGTGAGGTCGT
CATGGGGGTAACTCGTTGT -> ATGGGGGTAACTCGTTGTC
CATGGGTAGCGGAACGGAA -> ATGGGTAGCGGAACGGAAT
CATGGTTCGTCACACAGTA -> ATGGTTCGTCACACAGTAC
CATGTCTGCTTAACTCTAT -> ATGTCTGCTTAACTCTATG
CATGTGGTATTAGCGCGAT -> ATGTGGTATTAGCGCGATT
CATTAATCCAATCCCTTAG -> ATTAATCCAATCCCTTAGC
CATTACTTGTGCAAGACAA -> ATTACTTGTGCAAGACAAT
CATTCATGGTTCGTCACAC -> ATTCATGGTTCGTCACACA
CATTCCCAACCACCTCCAT -> ATTCCCAACCACCTCCATT
CATTCCCTCGCTCTTGTTT -> ATTCCCTCGCTCTTGTTTT
CATTCTATGTGGGATTCTG -> ATTCTATGTGGGATTCTGC
CATTGAACAGTTCCCCACA -> ATTGAACAGTTCCCCACAA
CATTGGTACGTATTAAAAC -> ATTGGTACGTATTAAAACC
CATTTATATCCAGTCAGCT -> ATTTATATCCAGTCAGCTA
CATTTTATAATCATGACTA -> ATTTTATAATCATGACTAG
CCAAAACCAAAAGTCATGA -> CAAAACCAAAAGTCATGAT
CCAAAACTACAGAGTTACC -> CAAAACTACAGAGTTACCG
CCAAAAGTCATGATGAGCC -> CAAAAGTCATGATGAGCCT
CCAAACGCCCATACTCAAC -> CAAACGCCCATACTCAACC
CCAAACTGCAGTCATTCTA -> CAAACTGCAGTCATTCTAT
CCAAATGTTGGAGCCAACC -> CAAATGTTGGAGCCAACCA
CCAAATGTTGGAGCCACTT -> CAAATGTTGGAGCCACTTC
CCAAATGTTGGAGCCATGG -> CAAATGTTGGAGCCATGGG
CCAAATGTTGGAGCCATTG -> CAAATGTTGGAGCCATTGG
CCAACCAAATGTTGGAGCC -> CAACCAAATGTTGGAGCCA
CCAACCACCTCCATTCATG -> CAACCACCTCCATTCATGG
CCAACCCTTCTACTAAAGT -> CAACCCTTCTACTAAAGTA
CCAACGGTCCGCGTACCCT -> CAACGGTCCGCGTACCCTT
CCAACTCCCACTGAACGTC -> CAACTCCCACTGAACGTCC
CCAAGCAGCGAGGAAGCTT -> CAAGCAGCGAGGAAGCTTG
CCAAGCTTATAAGCTGTAC -> CAAGCTTATAAGCTGTACA
CCAAGGGGAATCCGGAACG -> CAAGGGGAATCCGGAACGG
CCAATCCCTTAGCCCTATT -> CAATCCCTTAGCCCTATTT
CCAATTGCAGAACTTTTGA -> CAATTGCAGAACTTTTGAG
CCACAACTACAGAATGACC -> CACAACTACAGAATGACCG
CCACAGTGGACAAACTCTG -> CACAGTGGACAAACTCTGT
CCACATTTTATAATCATGA -> CACATTTTATAATCATGAC
CCACCTCCATTCATGGTTC -> CACCTCCATTCATGGTTCG
CCACGAGACTGTGAACAGG -> CACGAGACTGTGAACAGGG
CCACGTTACATTCCCAACC -> CACGTTACATTCCCAACCA
CCACTAAACAGCCTCGTGT -> CACTAAACAGCCTCGTGTA
CCACTAATTGCACCGCATG -> CACTAATTGCACCGCATGT
CCACTGAACGTCCTTAATC -> CACTGAACGTCCTTAATCA
CCACTTCCCAAGCAGCGAG -> CACTTCCCAAGCAGCGAGG
CCAGACATGGATGGTGTGA -> CAGACATGGATGGTGTGAG
CCAGACGTGCAGCGCCGAC -> CAGACGTGCAGCGCCGACA
CCAGAGGCTTGTAGGCGCT -> CAGAGGCTTGTAGGCGCTT
CCAGCACTCTCACCAACGG -> CAGCACTCTCACCAACGGT
CCAGCATACCAAAACCAAA -> CAGCATACCAAAACCAAAA
CCAGCATTACTTGTGCAAG -> CAGCATTACTTGTGCAAGA
CCAGCTGGCCTGTGGGGTG -> CAGCTGGCCTGTGGGGTGC
CCAGCTGGGTGCTGCCATA -> CAGCTGGGTGCTGCCATAG
CCAGGATGGTGTACCACTA -> CAGGATGGTGTACCACTAA
CCAGGCCATGCTGTGGGTA -> CAGGCCATGCTGTGGGTAC
CCAGGCGCAGTTCTCTGAG -> CAGGCGCAGTTCTCTGAGT
CCAGGGGACTTTTACATCC -> CAGGGGACTTTTACATCCC
CCAGGTTGGGTTCGTTAAC -> CAGGTTGGGTTCGTTAACA
CCAGTCAGCTAGCCTATTG -> CAGTCAGCTAGCCTATTGT
CCATACCGTTTGGGAAAAG -> CATACCGTTTGGGAAAAGT
CCATACTCAACCAGACATG -> CATACTCAACCAGACATGG
CCATAGTGGAGAGCTCCGT -> CATAGTGGAGAGCTCCGTC
CCATGATCCCAAGGGGAAT -> CATGATCCCAAGGGGAATC
CCATGCTGTGGGTACAGCT -> CATGCTGTGGGTACAGCTC
CCATGGGGGTAACTCGTTG -> CATGGGGGTAACTCGTTGT
CCATGGGTAGCGGAACGGA -> CATGGGTAGCGGAACGGAA
CCATGTCTGCTTAACTCTA -> CATGTCTGCTTAACTCTAT
CCATTCATGGTTCGTCACA -> CATTCATGGTTCGTCACAC
CCATTGGTACGTATTAAAA -> CATTGGTACGTATTAAAAC
CCCAAAACTACAGAGTTAC -> CCAAAACTACAGAGTTACC
CCCAACCACCTCCATTCAT -> CCAACCACCTCCATTCATG
CCCAAGCAGCGAGGAAGCT -> CCAAGCAGCGAGGAAGCTT
CCCAAGCTTATAAGCTGTA -> CCAAGCTTATAAGCTGTAC
CCCAAGGGGAATCCGGAAC -> CCAAGGGGAATCCGGAACG
CCCACAACTACAGAATGAC -> CCACAACTACAGAATGACC
CCCACTGAACGTCCTTAAT -> CCACTGAACGTCCTTAATC
CCCAGCATTACTTGTGCAA -> CCAGCATTACTTGTGCAAG
CCCAGGGGACTTTTACATC -> CCAGGGGACTTTTACATCC
CCCATACCGTTTGGGAAAA -> CCATACCGTTTGGGAAAAG
CCCATACTCAACCAGACAT -> CCATACTCAACCAGACATG
CCCCACAACTACAGAATGA -> CCCACAACTACAGAATGAC
CCCCCTCACCTCAATATAT -> CCCCTCACCTCAATATATG
CCCCGATATGTTGGGGTTG -> CCCGATATGTTGGGGTTGT
CCCCGTCATATACCAGACG -> CCCGTCATATACCAGACGT
CCCCTCACCTCAATATATG -> CCCTCACCTCAATATATGA
CCCGAGTCTGTTTACCAAA -> CCGAGTCTGTTTACCAAAC
CCCGATATGTTGGGGTTGT -> CCGATATGTTGGGGTTGTC
CCCGCAATGGCTTTGAACC -> CCGCAATGGCTTTGAACCA
CCCGCCCGGCCCATACCGT -> CCGCCCGGCCCATACCGTT
CCCGGCATACTTCGCGTAA -> CCGGCATACTTCGCGTAAA
CCCGGCCCATACCGTTTGG -> CCGGCCCATACCGTTTGGG
CCCGTCATATACCAGACGT -> CCGTCATATACCAGACGTG
CCCGTCATCCAGGCCATGC -> CCGTCATCCAGGCCATGCT
CCCGTCATCCCGCAATGGC -> CCGTCATCCCGCAATGGCT
CCCGTCATCCGAAATTCGG -> CCGTCATCCGAAATTCGGC
CCCGTCATCCTTAGAATAT -> CCGTCATCCTTAGAATATT
CCCGTGTTGGATGTACACT -> CCGTGTTGGATGTACACTA
CCCTATTTCCACTAATTGC -> CCTATTTCCACTAATTGCA
CCCTCACCTCAATATATGA -> CCTCACCTCAATATATGAA
CCCTCGCTCTTGTTTTGCT -> CCTCGCTCTTGTTTTGCTA
CCCTGACGAGCTCCAGGCG -> CCTGACGAGCTCCAGGCGC
CCCTGGGATATGATGTCAG -> CCTGGGATATGATGTCAGT
CCCTTAGCCCTATTTCCAC -> CCTTAGCCCTATTTCCACT
CCCTTCACCATGATCCCAA -> CCTTCACCATGATCCCAAG
CCCTTCTACTAAAGTAGGG -> CCTTCTACTAAAGTAGGGA
CCGAAATTCGGCTTGAACC -> CGAAATTCGGCTTGAACCA
CCGAACGGGGACTGTTTGG -> CGAACGGGGACTGTTTGGA
CCGACAGCCGTCTAACATT -> CGACAGCCGTCTAACATTT
CCGACGCCGTATAGCTCCC -> CGACGCCGTATAGCTCCCC
CCGAGCTTAGCTGTAATGG -> CGAGCTTAGCTGTAATGGC
CCGAGTCTGTTTACCAAAC -> CGAGTCTGTTTACCAAACG
CCGATATGTTGGGGTTGTC -> CGATATGTTGGGGTTGTCA
CCGATCGCTCGAATCCTCT -> CGATCGCTCGAATCCTCTT
CCGCAATGGCTTTGAACCA -> CGCAATGGCTTTGAACCAA
CCGCATAATATTTGGTATC -> CGCATAATATTTGGTATCC
CCGCATGTGGTATTAGCGC -> CGCATGTGGTATTAGCGCG
CCGCCCGGCCCATACCGTT -> CGCCCGGCCCATACCGTTT
CCGCCTCCACGAGACTGTG -> CGCCTCCACGAGACTGTGA
CCGCGCCCAGGGGACTTTT -> CGCGCCCAGGGGACTTTTA
CCGCGTACCCTTCACCATG -> CGCGTACCCTTCACCATGA
CCGCTATCAGGCTTCTCAC -> CGCTATCAGGCTTCTCACC
CCGGAACGGGGTACCATGG -> CGGAACGGGGTACCATGGG
CCGGCACGGCGCGAGCTGA -> CGGCACGGCGCGAGCTGAT
CCGGCATACTTCGCGTAAA -> CGGCATACTTCGCGTAAAC
CCGGCCCATACCGTTTGGG -> CGGCCCATACCGTTTGGGA
CCGGGGAGTTACCAGCACT -> CGGGGAGTTACCAGCACTC
CCGGTTAGCAGACAAACCG -> CGGTTAGCAGACAAACCGA
CCGTAAGACATGCGAATTC -> CGTAAGACATGCGAATTCG
CCGTATAGCTCCCCGATAT -> CGTATAGCTCCCCGATATG
CCGTCAACGTGACGCAGAT -> CGTCAACGTGACGCAGATG
CCGTCAATAGATCCGGCAC -> CGTCAATAGATCCGGCACG
CCGTCATATACCAGACGTG -> CGTCATATACCAGACGTGC
CCGTCATCCAGGCCATGCT -> CGTCATCCAGGCCATGCTG
CCGTCATCCCGCAATGGCT -> CGTCATCCCGCAATGGCTT
CCGTCATCCGAAATTCGGC -> CGTCATCCGAAATTCGGCT
CCGTCATCCTTAGAATATT -> CGTCATCCTTAGAATATTA
CCGTCCTGGACGGTAGCTC -> CGTCCTGGACGGTAGCTCC
CCGTCTAACATTTATATCC -> CGTCTAACATTTATATCCA
CCGTGTTGGATGTACACTA -> CGTGTTGGATGTACACTAT
CCGTTTCTTTGGCTCGGGA -> CGTTTCTTTGGCTCGGGAA
CCGTTTGAAGGATTTGACC -> CGTTTGAAGGATTTGACCG
CCGTTTGGGAAAAGTGAGT -> CGTTTGGGAAAAGTGAGTC
CCTAAACCAAACTGCAGTC -> CTAAACCAAACTGCAGTCA
CCTACCCGCCCGGCCCATA -> CTACCCGCCCGGCCCATAC
CCTATTGTGACATCGACGC -> CTATTGTGACATCGACGCG
CCTATTTCCACTAATTGCA -> CTATTTCCACTAATTGCAC
CCTCAATATATGAATCTTA -> CTCAATATATGAATCTTAG
CCTCACCTCAATATATGAA -> CTCACCTCAATATATGAAT
CCTCCACGAGACTGTGAAC -> CTCCACGAGACTGTGAACA
CCTCCATTCATGGTTCGTC -> CTCCATTCATGGTTCGTCA
CCTCCCCGTCATATACCAG -> CTCCCCGTCATATACCAGA
CCTCGCTCTTGTTTTGCTA -> CTCGCTCTTGTTTTGCTAA
CCTCGTGTAGACCAGAGGC -> CTCGTGTAGACCAGAGGCT
CCTCTCCGAGCTTAGCTGT -> CTCTCCGAGCTTAGCTGTA
CCTCTTGGAAATTCGAACG -> CTCTTGGAAATTCGAACGT
CCTGACGAGCTCCAGGCGC -> CTGACGAGCTCCAGGCGCA
CCTGACGGCCTTGAGTGAC -> CTGACGGCCTTGAGTGACC
CCTGCGTCGTCTAGAAGGG -> CTGCGTCGTCTAGAAGGGT
CCTGGACGGTAGCTCCAGC -> CTGGACGGTAGCTCCAGCT
CCTGGGATATGATGTCAGT -> CTGGGATATGATGTCAGTA
CCTGTCAGCGGATAGCTGA -> CTGTCAGCGGATAGCTGAT
CCTGTCGTGGGGCTTCTGT -> CTGTCGTGGGGCTTCTGTC
CCTGTGGGGTGCAACATCA -> CTGTGGGGTGCAACATCAT
CCTTAATCAATACGTAGGC -> CTTAATCAATACGTAGGCC
CCTTACGTGTCAAAAATAG -> CTTACGTGTCAAAAATAGC
CCTTAGAATATTATGAACC -> CTTAGAATATTATGAACCA
CCTTAGCCCTATTTCCACT -> CTTAGCCCTATTTCCACTA
CCTTCACCATGATCCCAAG -> CTTCACCATGATCCCAAGG
CCTTCTACTAAAGTAGGGA -> CTTCTACTAAAGTAGGGAA
CCTTGAGTGACCTTTCGTC -> CTTGAGTGACCTTTCGTCA
CCTTTAACTCTTTTACGAG -> CTTTAACTCTTTTACGAGC
CCTTTCGTCAATCGCTCCC -> CTTTCGTCAATCGCTCCCG
CGAAAAATTAGACTTTTAG -> GAAAAATTAGACTTTTAGA
CGAAATTCGGCTTGAACCA -> GAAATTCGGCTTGAACCAA
CGAACAATTCCAGGATGGT -> GAACAATTCCAGGATGGTG
CGAACGAAAAATTAGACTT -> GAACGAAAAATTAGACTTT
CGAACGGGGACTGTTTGGA -> GAACGGGGACTGTTTGGAA
CGAACGTGCCCGGCATACT -> GAACGTGCCCGGCATACTT
CGAACTGGATGTGATGTAC -> GAACTGGATGTGATGTACA
CGAATAATCAACCGGTTAG -> GAATAATCAACCGGTTAGC
CGAATCCTCTTGGAAATTC -> GAATCCTCTTGGAAATTCG
CGAATTCGAGTCGGGGGCA -> GAATTCGAGTCGGGGGCAG
CGACAGCCGTCTAACATTT -> GACAGCCGTCTAACATTTA
CGACGCCGTATAGCTCCCC -> GACGCCGTATAGCTCCCCG
CGACGCGAACGAAAAATTA -> GACGCGAACGAAAAATTAG
CGACTCAACGGACCGAACG -> GACTCAACGGACCGAACGG
CGAGACTGTGAACAGGGAT -> GAGACTGTGAACAGGGATG
CGAGCCTGTCGTGGGGCTT -> GAGCCTGTCGTGGGGCTTC
CGAGCTCCAGGCGCAGTTC -> GAGCTCCAGGCGCAGTTCT
CGAGCTGATTACCTTTAAC -> GAGCTGATTACCTTTAACT
CGAGCTTAGCTGTAATGGC -> GAGCTTAGCTGTAATGGCA
CGAGGAAGCTTGGGTTGCC -> GAGGAAGCTTGGGTTGCCC
CGAGTCAGCACCGCTATCA -> GAGTCAGCACCGCTATCAG
CGAGTCGGGGGCAGAATGC -> GAGTCGGGGGCAGAATGCG
CGAGTCTGTTTACCAAACG -> GAGTCTGTTTACCAAACGC
CGATATGTTGGGGTTGTCA -> GATATGTTGGGGTTGTCAT
CGATCGCTCGAATCCTCTT -> GATCGCTCGAATCCTCTTG
CGATTATGGCCACATTTTA -> GATTATGGCCACATTTTAT
CGATTTAGTAGCAGATAGA -> GATTTAGTAGCAGATAGAA
CGCAAAGCAGAATTAAACA -> GCAAAGCAGAATTAAACAA
CGCAATGGCTTTGAACCAA -> GCAATGGCTTTGAACCAAA
CGCACGGCTAGGCATTCCC -> GCACGGCTAGGCATTCCCT
CGCAGATGTTTAACACATA -> GCAGATGTTTAACACATAC
CGCAGTTCTCTGAGTCCGT -> GCAGTTCTCTGAGTCCGTT
CGCATAATATTTGGTATCC -> GCATAATATTTGGTATCCT
CGCATACCCGAGTCTGTTT -> GCATACCCGAGTCTGTTTA
CGCATGTGGTATTAGCGCG -> GCATGTGGTATTAGCGCGA
CGCCCAGGGGACTTTTACA -> GCCCAGGGGACTTTTACAT
CGCCCATACTCAACCAGAC -> GCCCATACTCAACCAGACA
CGCCCGGCCCATACCGTTT -> GCCCGGCCCATACCGTTTG
CGCCGACAGCCGTCTAACA -> GCCGACAGCCGTCTAACAT
CGCCGTATAGCTCCCCGAT -> GCCGTATAGCTCCCCGATA
CGCCTCCACGAGACTGTGA -> GCCTCCACGAGACTGTGAA
CGCGAACGAAAAATTAGAC -> GCGAACGAAAAATTAGACT
CGCGAGCTGATTACCTTTA -> GCGAGCTGATTACCTTTAA
CGCGATTTAGTAGCAGATA -> GCGATTTAGTAGCAGATAG
CGCGCCCAGGGGACTTTTA -> GCGCCCAGGGGACTTTTAC
CGCGTAAACGCAAAGCAGA -> GCGTAAACGCAAAGCAGAA
CGCGTACCCTTCACCATGA -> GCGTACCCTTCACCATGAT
CGCGTACTTCACGTGGTGC -> GCGTACTTCACGTGGTGCT
CGCTATCAGGCTTCTCACC -> GCTATCAGGCTTCTCACCG
CGCTCCCGTGTTGGATGTA -> GCTCCCGTGTTGGATGTAC
CGCTCGAATCCTCTTGGAA -> GCTCGAATCCTCTTGGAAA
CGCTCTTGTTTTGCTAATG -> GCTCTTGTTTTGCTAATGG
CGCTTAAAGATAATCACCC -> GCTTAAAGATAATCACCCT
CGGAACGGAATCGTGACAT -> GGAACGGAATCGTGACATG
CGGAACGGGGTACCATGGG -> GGAACGGGGTACCATGGGT
CGGAATCGTGACATGGATA -> GGAATCGTGACATGGATAA
CGGACACGCATACCCGAGT -> GGACACGCATACCCGAGTC
CGGACCGAACGGGGACTGT -> GGACCGAACGGGGACTGTT
CGGATAGCTGATCCACAGT -> GGATAGCTGATCCACAGTG
CGGCACGGCGCGAGCTGAT -> GGCACGGCGCGAGCTGATT
CGGCATACTTCGCGTAAAC -> GGCATACTTCGCGTAAACG
CGGCCCATACCGTTTGGGA -> GGCCCATACCGTTTGGGAA
CGGCCTTGAGTGACCTTTC -> GGCCTTGAGTGACCTTTCG
CGGCGCGAGCTGATTACCT -> GGCGCGAGCTGATTACCTT
CGGCTAGGCATTCCCTCGC -> GGCTAGGCATTCCCTCGCT
CGGCTTGAACCAAATGTTG -> GGCTTGAACCAAATGTTGG
CGGGAACTGGATGAGGGAG -> GGGAACTGGATGAGGGAGA
CGGGGACTGTTTGGAAAGA -> GGGGACTGTTTGGAAAGAA
CGGGGAGTTACCAGCACTC -> GGGGAGTTACCAGCACTCT
CGGGGGCAGAATGCGAACT -> GGGGGCAGAATGCGAACTG
CGGGGTACCATGGGTAGCG -> GGGGTACCATGGGTAGCGG
CGGTAGCTCCAGCTGGGTG -> GGTAGCTCCAGCTGGGTGC
CGGTCCGCGTACCCTTCAC -> GGTCCGCGTACCCTTCACC
CGGTCCGGGGAGTTACCAG -> GGTCCGGGGAGTTACCAGC
CGGTTAAGGGGAATCGTAT -> GGTTAAGGGGAATCGTATG
CGGTTAGCAGACAAACCGA -> GGTTAGCAGACAAACCGAT
CGTAAACGCAAAGCAGAAT -> GTAAACGCAAAGCAGAATT
CGTAAGACATGCGAATTCG -> GTAAGACATGCGAATTCGA
CGTAAGTTTGCGAGTCAGC -> GTAAGTTTGCGAGTCAGCA
CGTACAGCTCCCGTCATCC -> GTACAGCTCCCGTCATCCC
CGTACCCTTCACCATGATC -> GTACCCTTCACCATGATCC
CGTACTTCACGTGGTGCTC -> GTACTTCACGTGGTGCTCT
CGTAGGCCAGGTTGGGTTC -> GTAGGCCAGGTTGGGTTCG
CGTATAGCTCCCCGATATG -> GTATAGCTCCCCGATATGT
CGTATGACCGTAAGACATG -> GTATGACCGTAAGACATGC
CGTATTAAAACCGTTTGAA -> GTATTAAAACCGTTTGAAG
CGTATTAAATGAGGTTAGG -> GTATTAAATGAGGTTAGGT
CGTCAACGTGACGCAGATG -> GTCAACGTGACGCAGATGT
CGTCAATAGATCCGGCACG -> GTCAATAGATCCGGCACGG
CGTCAATCGCTCCCGTGTT -> GTCAATCGCTCCCGTGTTG
CGTCACACAGTACAGCTCC -> GTCACACAGTACAGCTCCC
CGTCATATACCAGACGTGC -> GTCATATACCAGACGTGCA
CGTCATCCAGGCCATGCTG -> GTCATCCAGGCCATGCTGT
CGTCATCCCGCAATGGCTT -> GTCATCCCGCAATGGCTTT
CGTCATCCGAAATTCGGCT -> GTCATCCGAAATTCGGCTT
CGTCATCCTTAGAATATTA -> GTCATCCTTAGAATATTAT
CGTCCTGGACGGTAGCTCC -> GTCCTGGACGGTAGCTCCA
CGTCCTTAATCAATACGTA -> GTCCTTAATCAATACGTAG
CGTCGTCTAGAAGGGTCTA -> GTCGTCTAGAAGGGTCTAA
CGTCGTGCTCGATTATGGC -> GTCGTGCTCGATTATGGCC
CGTCTAACATTTATATCCA -> GTCTAACATTTATATCCAG
CGTCTAGAAGGGTCTAAGC -> GTCTAGAAGGGTCTAAGCA
CGTCTCATTGAACAGTTCC -> GTCTCATTGAACAGTTCCC
CGTGACATGGATAACATCA -> GTGACATGGATAACATCAA
CGTGACGCAGATGTTTAAC -> GTGACGCAGATGTTTAACA
CGTGCAGCGCCGACAGCCG -> GTGCAGCGCCGACAGCCGT
CGTGCCCGGCATACTTCGC -> GTGCCCGGCATACTTCGCG
CGTGCTCGATTATGGCCAC -> GTGCTCGATTATGGCCACA
CGTGGGGCTTCTGTCCCAA -> GTGGGGCTTCTGTCCCAAA
CGTGGTGCTCTGCCTAAAC -> GTGGTGCTCTGCCTAAACC
CGTGTAGACCAGAGGCTTG -> GTGTAGACCAGAGGCTTGT
CGTGTCAAAAATAGCGGAC -> GTGTCAAAAATAGCGGACA
CGTGTTGGATGTACACTAT -> GTGTTGGATGTACACTATA
CGTTAACAAAACACTACCA -> GTTAACAAAACACTACCAA
CGTTACATTCCCAACCACC -> GTTACATTCCCAACCACCT
CGTTGTCTGGGGTACCGTC -> GTTGTCTGGGGTACCGTCA
CGTTTCTTTGGCTCGGGAA -> GTTTCTTTGGCTCGGGAAC
CGTTTGAAGGATTTGACCG -> GTTTGAAGGATTTGACCGC
CGTTTGGGAAAAGTGAGTC -> GTTTGGGAAAAGTGAGTCA
CTAAACAGCCTCGTGTAGA -> TAAACAGCCTCGTGTAGAC
CTAAACCAAACTGCAGTCA -> TAAACCAAACTGCAGTCAT
CTAAACGCGTACTTCACGT -> TAAACGCGTACTTCACGTG
CTAAAGTAGGGAAAAGTCC -> TAAAGTAGGGAAAAGTCCG
CTAACATTTATATCCAGTC -> TAACATTTATATCCAGTCA
CTAAGCAGAAGGAACAAGC -> TAAGCAGAAGGAACAAGCC
CTAATGGTAGCCAGCATAC -> TAATGGTAGCCAGCATACC
CTAATTGCACCGCATGTGG -> TAATTGCACCGCATGTGGT
CTACAGAATGACCGCCTCC -> TACAGAATGACCGCCTCCA
CTACAGAGTTACCGACGCC -> TACAGAGTTACCGACGCCG
CTACCAATTGCAGAACTTT -> TACCAATTGCAGAACTTTT
CTACCCGCCCGGCCCATAC -> TACCCGCCCGGCCCATACC
CTACGGTCCGGGGAGTTAC -> TACGGTCCGGGGAGTTACC
CTACTAAAGTAGGGAAAAG -> TACTAAAGTAGGGAAAAGT
CTAGAAGGGTCTAAGCAGA -> TAGAAGGGTCTAAGCAGAA
CTAGCCAACTCCCACTGAA -> TAGCCAACTCCCACTGAAC
CTAGCCTATTGTGACATCG -> TAGCCTATTGTGACATCGA
CTAGGCATTCCCTCGCTCT -> TAGGCATTCCCTCGCTCTT
CTATATGCTATGCGTACAG -> TATATGCTATGCGTACAGC
CTATCAGGCTTCTCACCGT -> TATCAGGCTTCTCACCGTC
CTATGCGTACAGCTCCCGT -> TATGCGTACAGCTCCCGTC
CTATGTGGGATTCTGCACA -> TATGTGGGATTCTGCACAA
CTATGTTACGCACGGCTAG -> TATGTTACGCACGGCTAGG
CTATTGTGACATCGACGCG -> TATTGTGACATCGACGCGA
CTATTTCCACTAATTGCAC -> TATTTCCACTAATTGCACC
CTCAACCAGACATGGATGG -> TCAACCAGACATGGATGGT
CTCAACGGACCGAACGGGG -> TCAACGGACCGAACGGGGA
CTCAATATATGAATCTTAG -> TCAATATATGAATCTTAGT
CTCACCAACGGTCCGCGTA -> TCACCAACGGTCCGCGTAC
CTCACCGTCCTGGACGGTA -> TCACCGTCCTGGACGGTAG
CTCACCTCAATATATGAAT -> TCACCTCAATATATGAATC
CTCATTGAACAGTTCCCCA -> TCATTGAACAGTTCCCCAC
CTCCACGAGACTGTGAACA -> TCCACGAGACTGTGAACAG
CTCCAGCTGGGTGCTGCCA -> TCCAGCTGGGTGCTGCCAT
CTCCAGGCGCAGTTCTCTG -> TCCAGGCGCAGTTCTCTGA
CTCCATTCATGGTTCGTCA -> TCCATTCATGGTTCGTCAC
CTCCCACTGAACGTCCTTA -> TCCCACTGAACGTCCTTAA
CTCCCCGATATGTTGGGGT -> TCCCCGATATGTTGGGGTT
CTCCCCGTCATATACCAGA -> TCCCCGTCATATACCAGAC
CTCCCGTCATCCAGGCCAT -> TCCCGTCATCCAGGCCATG
CTCCCGTCATCCCGCAATG -> TCCCGTCATCCCGCAATGG
CTCCCGTCATCCGAAATTC -> TCCCGTCATCCGAAATTCG
CTCCCGTCATCCTTAGAAT -> TCCCGTCATCCTTAGAATA
CTCCCGTGTTGGATGTACA -> TCCCGTGTTGGATGTACAC
CTCCGAGCTTAGCTGTAAT -> TCCGAGCTTAGCTGTAATG
CTCCGTCAACGTGACGCAG -> TCCGTCAACGTGACGCAGA
CTCCTACCCGCCCGGCCCA -> TCCTACCCGCCCGGCCCAT
CTCGAATCCTCTTGGAAAT -> TCGAATCCTCTTGGAAATT
CTCGATTATGGCCACATTT -> TCGATTATGGCCACATTTT
CTCGCTCTTGTTTTGCTAA -> TCGCTCTTGTTTTGCTAAT
CTCGGGAACTGGATGAGGG -> TCGGGAACTGGATGAGGGA
CTCGTGTAGACCAGAGGCT -> TCGTGTAGACCAGAGGCTT
CTCGTTGTCTGGGGTACCG -> TCGTTGTCTGGGGTACCGT
CTCTATGTTACGCACGGCT -> TCTATGTTACGCACGGCTA
CTCTCACCAACGGTCCGCG -> TCTCACCAACGGTCCGCGT
CTCTCCGAGCTTAGCTGTA -> TCTCCGAGCTTAGCTGTAA
CTCTGAGTCCGTTTCTTTG -> TCTGAGTCCGTTTCTTTGG
CTCTGCCTAAACCAAACTG -> TCTGCCTAAACCAAACTGC
CTCTGTACACCTTACGTGT -> TCTGTACACCTTACGTGTC
CTCTTGGAAATTCGAACGT -> TCTTGGAAATTCGAACGTG
CTCTTGTTTTGCTAATGGT -> TCTTGTTTTGCTAATGGTA
CTCTTTTACGAGCCTGTCG -> TCTTTTACGAGCCTGTCGT
CTGAACGTCCTTAATCAAT -> TGAACGTCCTTAATCAATA
CTGAAGTGGGTTCAATGGC -> TGAAGTGGGTTCAATGGCA
CTGACGAGCTCCAGGCGCA -> TGACGAGCTCCAGGCGCAG
CTGACGGCCTTGAGTGACC -> TGACGGCCTTGAGTGACCT
CTGAGTCCGTTTCTTTGGC -> TGAGTCCGTTTCTTTGGCT
CTGATCCACAGTGGACAAA -> TGATCCACAGTGGACAAAC
CTGATTACCTTTAACTCTT -> TGATTACCTTTAACTCTTT
CTGCACAAGCCTCTCCGAG -> TGCACAAGCCTCTCCGAGC
CTGCAGTCATTCTATGTGG -> TGCAGTCATTCTATGTGGG
CTGCCATAGTGGAGAGCTC -> TGCCATAGTGGAGAGCTCC
CTGCCTAAACCAAACTGCA -> TGCCTAAACCAAACTGCAG
CTGCGTCGTCTAGAAGGGT -> TGCGTCGTCTAGAAGGGTC
CTGCTTAACTCTATGTTAC -> TGCTTAACTCTATGTTACG
CTGGACGGTAGCTCCAGCT -> TGGACGGTAGCTCCAGCTG
CTGGATGAGGGAGACGTAT -> TGGATGAGGGAGACGTATT
CTGGATGTGATGTACAGCT -> TGGATGTGATGTACAGCTC
CTGGCCTGTGGGGTGCAAC -> TGGCCTGTGGGGTGCAACA
CTGGGATATGATGTCAGTA -> TGGGATATGATGTCAGTAC
CTGGGGTACCGTCAATAGA -> TGGGGTACCGTCAATAGAT
CTGGGTGCTGCCATAGTGG -> TGGGTGCTGCCATAGTGGA
CTGTAATGGCAGCTTGTCC -> TGTAATGGCAGCTTGTCCA
CTGTACACATGATCCTGTC -> TGTACACATGATCCTGTCA
CTGTACACCTTACGTGTCA -> TGTACACCTTACGTGTCAA
CTGTCAGCGGATAGCTGAT -> TGTCAGCGGATAGCTGATC
CTGTCCCAAAACTACAGAG -> TGTCCCAAAACTACAGAGT
CTGTCGTGGGGCTTCTGTC -> TGTCGTGGGGCTTCTGTCC
CTGTGAACAGGGATGTCCC -> TGTGAACAGGGATGTCCCA
CTGTGGGGTGCAACATCAT -> TGTGGGGTGCAACATCATC
CTGTGGGTACAGCTCCCGT -> TGTGGGTACAGCTCCCGTC
CTGTTTACCAAACGCCCAT -> TGTTTACCAAACGCCCATA
CTGTTTGGAAAGAATGGCT -> TGTTTGGAAAGAATGGCTC
CTTAAAGATAATCACCCTG -> TTAAAGATAATCACCCTGG
CTTAACTCTATGTTACGCA -> TTAACTCTATGTTACGCAC
CTTAATCAATACGTAGGCC -> TTAATCAATACGTAGGCCA
CTTACGTGTCAAAAATAGC -> TTACGTGTCAAAAATAGCG
CTTAGAATATTATGAACCA -> TTAGAATATTATGAACCAA
CTTAGCCCTATTTCCACTA -> TTAGCCCTATTTCCACTAA
CTTAGCTGTAATGGCAGCT -> TTAGCTGTAATGGCAGCTT
CTTAGTACGACTCAACGGA -> TTAGTACGACTCAACGGAC
CTTATAAGCTGTACACATG -> TTATAAGCTGTACACATGA
CTTCACCATGATCCCAAGG -> TTCACCATGATCCCAAGGG
CTTCACGTGGTGCTCTGCC -> TTCACGTGGTGCTCTGCCT
CTTCCCAAGCAGCGAGGAA -> TTCCCAAGCAGCGAGGAAG
CTTCGCGTAAACGCAAAGC -> TTCGCGTAAACGCAAAGCA
CTTCTACTAAAGTAGGGAA -> TTCTACTAAAGTAGGGAAA
CTTCTCACCGTCCTGGACG -> TTCTCACCGTCCTGGACGG
CTTCTGTCCCAAAACTACA -> TTCTGTCCCAAAACTACAG
CTTGAACCAAATGTTGGAG -> TTGAACCAAATGTTGGAGC
CTTGAGTGACCTTTCGTCA -> TTGAGTGACCTTTCGTCAA
CTTGGAAATTCGAACGTGC -> TTGGAAATTCGAACGTGCC
CTTGGGTTGCCCTGACGAG -> TTGGGTTGCCCTGACGAGC
CTTGTAGGCGCTTAAAGAT -> TTGTAGGCGCTTAAAGATA
CTTGTCCAACCCTTCTACT -> TTGTCCAACCCTTCTACTA
CTTGTGCAAGACAATTGTG -> TTGTGCAAGACAATTGTGG
CTTGTTTTGCTAATGGTAG -> TTGTTTTGCTAATGGTAGC
CTTTAACTCTTTTACGAGC -> TTTAACTCTTTTACGAGCC
CTTTCGTCAATCGCTCCCG -> TTTCGTCAATCGCTCCCGT
CTTTGAACCAAATGTTGGA -> TTTGAACCAAATGTTGGAG
CTTTGGCTCGGGAACTGGA -> TTTGGCTCGGGAACTGGAT
CTTTTACATCCCAAGCTTA -> TTTTACATCCCAAGCTTAT
CTTTTACGAGCCTGTCGTG -> TTTTACGAGCCTGTCGTGG
CTTTTAGATACAACACTAC -> TTTTAGATACAACACTACG
CTTTTGAGGGCGTCTCTTA -> TTTTGAGGGCGTCTCTTAG
GAAAAATTAGACTTTTAGA -> AAAAATTAGACTTTTAGAT
GAAAAGTCCGCATAATATT -> AAAAGTCCGCATAATATTT
GAAAAGTGAGTCAGCCACG -> AAAAGTGAGTCAGCCACGT
GAAAGAATGGCTCCTACCC -> AAAGAATGGCTCCTACCCG
GAAATTCGAACGTGCCCGG -> AAATTCGAACGTGCCCGGC
GAAATTCGGCTTGAACCAA -> AAATTCGGCTTGAACCAAA
GAACAAGCCCCCTCACCTC -> AACAAGCCCCCTCACCTCA
GAACAATTCCAGGATGGTG -> AACAATTCCAGGATGGTGT
GAACAGGGATGTCCCAGCA -> AACAGGGATGTCCCAGCAT
GAACAGTTCCCCACAACTA -> AACAGTTCCCCACAACTAC
GAACCAAATGTTGGAGCCA -> AACCAAATGTTGGAGCCAA,AACCAAATGTTGGAGCCAC,AACCAAATGTTGGAGCCAT
GAACGAAAAATTAGACTTT -> AACGAAAAATTAGACTTTT
GAACGGAATCGTGACATGG -> AACGGAATCGTGACATGGA
GAACGGGGACTGTTTGGAA -> AACGGGGACTGTTTGGAAA
GAACGGGGTACCATGGGTA -> AACGGGGTACCATGGGTAG
GAACGTCCTTAATCAATAC -> AACGTCCTTAATCAATACG
GAACGTGCCCGGCATACTT -> AACGTGCCCGGCATACTTC
GAACTGGATGAGGGAGACG -> AACTGGATGAGGGAGACGT
GAACTGGATGTGATGTACA -> AACTGGATGTGATGTACAG
GAACTTTTGAGGGCGTCTC -> AACTTTTGAGGGCGTCTCT
GAAGCTTGGGTTGCCCTGA -> AAGCTTGGGTTGCCCTGAC
GAAGGAACAAGCCCCCTCA -> AAGGAACAAGCCCCCTCAC
GAAGGATTTGACCGCGCCC -> AAGGATTTGACCGCGCCCA
GAAGGGTCTAAGCAGAAGG -> AAGGGTCTAAGCAGAAGGA
GAAGTGGGTTCAATGGCAA -> AAGTGGGTTCAATGGCAAC
GAATAATCAACCGGTTAGC -> AATAATCAACCGGTTAGCA
GAATATTATGAACCAAATG -> AATATTATGAACCAAATGT
GAATCCGGAACGGGGTACC -> AATCCGGAACGGGGTACCA
GAATCCTCTTGGAAATTCG -> AATCCTCTTGGAAATTCGA
GAATCGTATGACCGTAAGA -> AATCGTATGACCGTAAGAC
GAATCGTGACATGGATAAC -> AATCGTGACATGGATAACA
GAATCTGAAGTGGGTTCAA -> AATCTGAAGTGGGTTCAAT
GAATCTTAGTACGACTCAA -> AATCTTAGTACGACTCAAC
GAATGACCGCCTCCACGAG -> AATGACCGCCTCCACGAGA
GAATGCGAACTGGATGTGA -> AATGCGAACTGGATGTGAT
GAATGGCTCCTACCCGCCC -> AATGGCTCCTACCCGCCCG
GAATTAAACAACAGACAGT -> AATTAAACAACAGACAGTA
GAATTCGAGTCGGGGGCAG -> AATTCGAGTCGGGGGCAGA
GACAAACCGATCGCTCGAA -> ACAAACCGATCGCTCGAAT
GACAAACTCTGTACACCTT -> ACAAACTCTGTACACCTTA
GACAATTGTGGCCATGTCT -> ACAATTGTGGCCATGTCTG
GACACGCATACCCGAGTCT -> ACACGCATACCCGAGTCTG
GACAGCCGTCTAACATTTA -> ACAGCCGTCTAACATTTAT
GACAGTACAGTTTGTCGTC -> ACAGTACAGTTTGTCGTCG
GACATCGACGCGAACGAAA -> ACATCGACGCGAACGAAAA
GACATGCGAATTCGAGTCG -> ACATGCGAATTCGAGTCGG
GACATGGATAACATCAAAC -> ACATGGATAACATCAAACC
GACATGGATGGTGTGAGGT -> ACATGGATGGTGTGAGGTC
GACCAGAGGCTTGTAGGCG -> ACCAGAGGCTTGTAGGCGC
GACCGAACGGGGACTGTTT -> ACCGAACGGGGACTGTTTG
GACCGCCTCCACGAGACTG -> ACCGCCTCCACGAGACTGT
GACCGCGCCCAGGGGACTT -> ACCGCGCCCAGGGGACTTT
GACCGTAAGACATGCGAAT -> ACCGTAAGACATGCGAATT
GACCTTTCGTCAATCGCTC -> ACCTTTCGTCAATCGCTCC
GACGAGCTCCAGGCGCAGT -> ACGAGCTCCAGGCGCAGTT
GACGCAGATGTTTAACACA -> ACGCAGATGTTTAACACAT
GACGCCGTATAGCTCCCCG -> ACGCCGTATAGCTCCCCGA
GACGCGAACGAAAAATTAG -> ACGCGAACGAAAAATTAGA
GACGGCCTTGAGTGACCTT -> ACGGCCTTGAGTGACCTTT
GACGGTAGCTCCAGCTGGG -> ACGGTAGCTCCAGCTGGGT
GACGTATTAAATGAGGTTA -> ACGTATTAAATGAGGTTAG
GACGTGCAGCGCCGACAGC -> ACGTGCAGCGCCGACAGCC
GACTAGCCAACTCCCACTG -> ACTAGCCAACTCCCACTGA
GACTCAACGGACCGAACGG -> ACTCAACGGACCGAACGGG
GACTGTGAACAGGGATGTC -> ACTGTGAACAGGGATGTCC
GACTGTTTGGAAAGAATGG -> ACTGTTTGGAAAGAATGGC
GACTTTTACATCCCAAGCT -> ACTTTTACATCCCAAGCTT
GACTTTTAGATACAACACT -> ACTTTTAGATACAACACTA
GAGACGTATTAAATGAGGT -> AGACGTATTAAATGAGGTT
GAGACTGTGAACAGGGATG -> AGACTGTGAACAGGGATGT
GAGAGCTCCGTCAACGTGA -> AGAGCTCCGTCAACGTGAC
GAGCCAACCAAATGTTGGA -> AGCCAACCAAATGTTGGAG
GAGCCACTTCCCAAGCAGC -> AGCCACTTCCCAAGCAGCG
GAGCCATGGGGGTAACTCG -> AGCCATGGGGGTAACTCGT
GAGCCATTGGTACGTATTA -> AGCCATTGGTACGTATTAA
GAGCCTCCCCGTCATATAC -> AGCCTCCCCGTCATATACC
GAGCCTGTCGTGGGGCTTC -> AGCCTGTCGTGGGGCTTCT
GAGCTCCAGGCGCAGTTCT -> AGCTCCAGGCGCAGTTCTC
GAGCTCCGTCAACGTGACG -> AGCTCCGTCAACGTGACGC
GAGCTGATTACCTTTAACT -> AGCTGATTACCTTTAACTC
GAGCTTAGCTGTAATGGCA -> AGCTTAGCTGTAATGGCAG
GAGGAAGCTTGGGTTGCCC -> AGGAAGCTTGGGTTGCCCT
GAGGCTTGTAGGCGCTTAA -> AGGCTTGTAGGCGCTTAAA
GAGGGAGACGTATTAAATG -> AGGGAGACGTATTAAATGA
GAGGGCGTCTCTTAGACGT -> AGGGCGTCTCTTAGACGTC
GAGGTCGTCTCATTGAACA -> AGGTCGTCTCATTGAACAG
GAGGTTAGGTACGAATAAT -> AGGTTAGGTACGAATAATC
GAGTCAGCACCGCTATCAG -> AGTCAGCACCGCTATCAGG
GAGTCAGCCACGTTACATT -> AGTCAGCCACGTTACATTC
GAGTCCGTTTCTTTGGCTC -> AGTCCGTTTCTTTGGCTCG
GAGTCGGGGGCAGAATGCG -> AGTCGGGGGCAGAATGCGA
GAGTCTGTTTACCAAACGC -> AGTCTGTTTACCAAACGCC
GAGTGACCTTTCGTCAATC -> AGTGACCTTTCGTCAATCG
GAGTTACCAGCACTCTCAC -> AGTTACCAGCACTCTCACC
GAGTTACCGACGCCGTATA -> AGTTACCGACGCCGTATAG
GATAACATCAAACCTGCGT -> ATAACATCAAACCTGCGTC
GATAATCACCCTGGGATAT -> ATAATCACCCTGGGATATG
GATACAACACTACGGTCCG -> ATACAACACTACGGTCCGG
GATAGAATCTGAAGTGGGT -> ATAGAATCTGAAGTGGGTT
GATAGCTGATCCACAGTGG -> ATAGCTGATCCACAGTGGA
GATATGATGTCAGTACGGT -> ATATGATGTCAGTACGGTT
GATATGTTGGGGTTGTCAT -> ATATGTTGGGGTTGTCATT
GATCCACAGTGGACAAACT -> ATCCACAGTGGACAAACTC
GATCCCAAGGGGAATCCGG -> ATCCCAAGGGGAATCCGGA
GATCCGGCACGGCGCGAGC -> ATCCGGCACGGCGCGAGCT
GATCCTGTCAGCGGATAGC -> ATCCTGTCAGCGGATAGCT
GATCGCTCGAATCCTCTTG -> ATCGCTCGAATCCTCTTGG
GATGAGCCTCCCCGTCATA -> ATGAGCCTCCCCGTCATAT
GATGAGGGAGACGTATTAA -> ATGAGGGAGACGTATTAAA
GATGGTGTACCACTAAACA -> ATGGTGTACCACTAAACAG
GATGGTGTGAGGTCGTCTC -> ATGGTGTGAGGTCGTCTCA
GATGTACACTATATGCTAT -> ATGTACACTATATGCTATG
GATGTACAGCTCCCGTCAT -> ATGTACAGCTCCCGTCATC
GATGTCAGTACGGTTAAGG -> ATGTCAGTACGGTTAAGGG
GATGTCCCAGCATTACTTG -> ATGTCCCAGCATTACTTGT
GATGTGATGTACAGCTCCC -> ATGTGATGTACAGCTCCCG
GATGTTTAACACATACACC -> ATGTTTAACACATACACCA
GATTACCTTTAACTCTTTT -> ATTACCTTTAACTCTTTTA
GATTATGGCCACATTTTAT -> ATTATGGCCACATTTTATA
GATTCTGCACAAGCCTCTC -> ATTCTGCACAAGCCTCTCC
GATTTAGTAGCAGATAGAA -> ATTTAGTAGCAGATAGAAT
GATTTGACCGCGCCCAGGG -> ATTTGACCGCGCCCAGGGG
GCAAAGCAGAATTAAACAA -> CAAAGCAGAATTAAACAAC
GCAACATCATCACTAAACG -> CAACATCATCACTAAACGC
GCAACGAACAATTCCAGGA -> CAACGAACAATTCCAGGAT
GCAAGACAATTGTGGCCAT -> CAAGACAATTGTGGCCATG
GCAATGGCTTTGAACCAAA -> CAATGGCTTTGAACCAAAT
GCACAAGCCTCTCCGAGCT -> CACAAGCCTCTCCGAGCTT
GCACCGCATGTGGTATTAG -> CACCGCATGTGGTATTAGC
GCACCGCTATCAGGCTTCT -> CACCGCTATCAGGCTTCTC
GCACGGCGCGAGCTGATTA -> CACGGCGCGAGCTGATTAC
GCACGGCTAGGCATTCCCT -> CACGGCTAGGCATTCCCTC
GCACTCTCACCAACGGTCC -> CACTCTCACCAACGGTCCG
GCAGAACTTTTGAGGGCGT -> CAGAACTTTTGAGGGCGTC
GCAGAAGGAACAAGCCCCC -> CAGAAGGAACAAGCCCCCT
GCAGAATGCGAACTGGATG -> CAGAATGCGAACTGGATGT
GCAGAATTAAACAACAGAC -> CAGAATTAAACAACAGACA
GCAGACAAACCGATCGCTC -> CAGACAAACCGATCGCTCG
GCAGATAGAATCTGAAGTG -> CAGATAGAATCTGAAGTGG
GCAGATGTTTAACACATAC -> CAGATGTTTAACACATACA
GCAGCGAGGAAGCTTGGGT -> CAGCGAGGAAGCTTGGGTT
GCAGCGCCGACAGCCGTCT -> CAGCGCCGACAGCCGTCTA
GCAGCTTGTCCAACCCTTC -> CAGCTTGTCCAACCCTTCT
GCAGTCATTCTATGTGGGA -> CAGTCATTCTATGTGGGAT
GCAGTTCTCTGAGTCCGTT -> CAGTTCTCTGAGTCCGTTT
GCATAATATTTGGTATCCT -> CATAATATTTGGTATCCTG
GCATACCAAAACCAAAAGT -> CATACCAAAACCAAAAGTC
GCATACCCGAGTCTGTTTA -> CATACCCGAGTCTGTTTAC
GCATACTTCGCGTAAACGC -> CATACTTCGCGTAAACGCA
GCATGTGGTATTAGCGCGA -> CATGTGGTATTAGCGCGAT
GCATTACTTGTGCAAGACA -> CATTACTTGTGCAAGACAA
GCATTCCCTCGCTCTTGTT -> CATTCCCTCGCTCTTGTTT
GCCAACCAAATGTTGGAGC -> CCAACCAAATGTTGGAGCC
GCCAACTCCCACTGAACGT -> CCAACTCCCACTGAACGTC
GCCACATTTTATAATCATG -> CCACATTTTATAATCATGA
GCCACGTTACATTCCCAAC -> CCACGTTACATTCCCAACC
GCCACTTCCCAAGCAGCGA -> CCACTTCCCAAGCAGCGAG
GCCAGCATACCAAAACCAA -> CCAGCATACCAAAACCAAA
GCCAGGTTGGGTTCGTTAA -> CCAGGTTGGGTTCGTTAAC
GCCATAGTGGAGAGCTCCG -> CCATAGTGGAGAGCTCCGT
GCCATGCTGTGGGTACAGC -> CCATGCTGTGGGTACAGCT
GCCATGGGGGTAACTCGTT -> CCATGGGGGTAACTCGTTG
GCCATGTCTGCTTAACTCT -> CCATGTCTGCTTAACTCTA
GCCATTGGTACGTATTAAA -> CCATTGGTACGTATTAAAA
GCCCAGGGGACTTTTACAT -> CCCAGGGGACTTTTACATC
GCCCATACCGTTTGGGAAA -> CCCATACCGTTTGGGAAAA
GCCCATACTCAACCAGACA -> CCCATACTCAACCAGACAT
GCCCCCTCACCTCAATATA -> CCCCCTCACCTCAATATAT
GCCCGGCATACTTCGCGTA -> CCCGGCATACTTCGCGTAA
GCCCGGCCCATACCGTTTG -> CCCGGCCCATACCGTTTGG
GCCCTATTTCCACTAATTG -> CCCTATTTCCACTAATTGC
GCCCTGACGAGCTCCAGGC -> CCCTGACGAGCTCCAGGCG
GCCGACAGCCGTCTAACAT -> CCGACAGCCGTCTAACATT
GCCGTATAGCTCCCCGATA -> CCGTATAGCTCCCCGATAT
GCCGTCTAACATTTATATC -> CCGTCTAACATTTATATCC
GCCTAAACCAAACTGCAGT -> CCTAAACCAAACTGCAGTC
GCCTATTGTGACATCGACG -> CCTATTGTGACATCGACGC
GCCTCCACGAGACTGTGAA -> CCTCCACGAGACTGTGAAC
GCCTCCCCGTCATATACCA -> CCTCCCCGTCATATACCAG
GCCTCGTGTAGACCAGAGG -> CCTCGTGTAGACCAGAGGC
GCCTCTCCGAGCTTAGCTG -> CCTCTCCGAGCTTAGCTGT
GCCTGTCGTGGGGCTTCTG -> CCTGTCGTGGGGCTTCTGT
GCCTGTGGGGTGCAACATC -> CCTGTGGGGTGCAACATCA
GCCTTGAGTGACCTTTCGT -> CCTTGAGTGACCTTTCGTC
GCGAACGAAAAATTAGACT -> CGAACGAAAAATTAGACTT
GCGAACTGGATGTGATGTA -> CGAACTGGATGTGATGTAC
GCGAATTCGAGTCGGGGGC -> CGAATTCGAGTCGGGGGCA
GCGAGCTGATTACCTTTAA -> CGAGCTGATTACCTTTAAC
GCGAGGAAGCTTGGGTTGC -> CGAGGAAGCTTGGGTTGCC
GCGAGTCAGCACCGCTATC -> CGAGTCAGCACCGCTATCA
GCGATTTAGTAGCAGATAG -> CGATTTAGTAGCAGATAGA
GCGCAGTTCTCTGAGTCCG -> CGCAGTTCTCTGAGTCCGT
GCGCCCAGGGGACTTTTAC -> CGCCCAGGGGACTTTTACA
GCGCCGACAGCCGTCTAAC -> CGCCGACAGCCGTCTAACA
GCGCGAGCTGATTACCTTT -> CGCGAGCTGATTACCTTTA
GCGCGATTTAGTAGCAGAT -> CGCGATTTAGTAGCAGATA
GCGCTTAAAGATAATCACC -> CGCTTAAAGATAATCACCC
GCGGAACGGAATCGTGACA -> CGGAACGGAATCGTGACAT
GCGGACACGCATACCCGAG -> CGGACACGCATACCCGAGT
GCGGATAGCTGATCCACAG -> CGGATAGCTGATCCACAGT
GCGTAAACGCAAAGCAGAA -> CGTAAACGCAAAGCAGAAT
GCGTACAGCTCCCGTCATC -> CGTACAGCTCCCGTCATCC
GCGTACCCTTCACCATGAT -> CGTACCCTTCACCATGATC
GCGTACTTCACGTGGTGCT -> CGTACTTCACGTGGTGCTC
GCGTCGTCTAGAAGGGTCT -> CGTCGTCTAGAAGGGTCTA
GCTAATGGTAGCCAGCATA -> CTAATGGTAGCCAGCATAC
GCTAGCCTATTGTGACATC -> CTAGCCTATTGTGACATCG
GCTAGGCATTCCCTCGCTC -> CTAGGCATTCCCTCGCTCT
GCTATCAGGCTTCTCACCG -> CTATCAGGCTTCTCACCGT
GCTATGCGTACAGCTCCCG -> CTATGCGTACAGCTCCCGT
GCTCCAGCTGGGTGCTGCC -> CTCCAGCTGGGTGCTGCCA
GCTCCAGGCGCAGTTCTCT -> CTCCAGGCGCAGTTCTCTG
GCTCCCCGATATGTTGGGG -> CTCCCCGATATGTTGGGGT
GCTCCCGTCATCCAGGCCA -> CTCCCGTCATCCAGGCCAT
GCTCCCGTCATCCCGCAAT -> CTCCCGTCATCCCGCAATG
GCTCCCGTCATCCGAAATT -> CTCCCGTCATCCGAAATTC
GCTCCCGTCATCCTTAGAA -> CTCCCGTCATCCTTAGAAT
GCTCCCGTGTTGGATGTAC -> CTCCCGTGTTGGATGTACA
GCTCCGTCAACGTGACGCA -> CTCCGTCAACGTGACGCAG
GCTCCTACCCGCCCGGCCC -> CTCCTACCCGCCCGGCCCA
GCTCGAATCCTCTTGGAAA -> CTCGAATCCTCTTGGAAAT
GCTCGATTATGGCCACATT -> CTCGATTATGGCCACATTT
GCTCGGGAACTGGATGAGG -> CTCGGGAACTGGATGAGGG
GCTCTGCCTAAACCAAACT -> CTCTGCCTAAACCAAACTG
GCTCTTGTTTTGCTAATGG -> CTCTTGTTTTGCTAATGGT
GCTGATCCACAGTGGACAA -> CTGATCCACAGTGGACAAA
GCTGATTACCTTTAACTCT -> CTGATTACCTTTAACTCTT
GCTGCCATAGTGGAGAGCT -> CTGCCATAGTGGAGAGCTC
GCTGGCCTGTGGGGTGCAA -> CTGGCCTGTGGGGTGCAAC
GCTGGGTGCTGCCATAGTG -> CTGGGTGCTGCCATAGTGG
GCTGTAATGGCAGCTTGTC -> CTGTAATGGCAGCTTGTCC
GCTGTACACATGATCCTGT -> CTGTACACATGATCCTGTC
GCTGTGGGTACAGCTCCCG -> CTGTGGGTACAGCTCCCGT
GCTTAAAGATAATCACCCT -> CTTAAAGATAATCACCCTG
GCTTAACTCTATGTTACGC -> CTTAACTCTATGTTACGCA
GCTTAGCTGTAATGGCAGC -> CTTAGCTGTAATGGCAGCT
GCTTATAAGCTGTACACAT -> CTTATAAGCTGTACACATG
GCTTCTCACCGTCCTGGAC -> CTTCTCACCGTCCTGGACG
GCTTCTGTCCCAAAACTAC -> CTTCTGTCCCAAAACTACA
GCTTGAACCAAATGTTGGA -> CTTGAACCAAATGTTGGAG
GCTTGGGTTGCCCTGACGA -> CTTGGGTTGCCCTGACGAG
GCTTGTAGGCGCTTAAAGA -> CTTGTAGGCGCTTAAAGAT
GCTTGTCCAACCCTTCTAC -> CTTGTCCAACCCTTCTACT
GCTTTGAACCAAATGTTGG -> CTTTGAACCAAATGTTGGA
GGAAAAGTCCGCATAATAT -> GAAAAGTCCGCATAATATT
GGAAAAGTGAGTCAGCCAC -> GAAAAGTGAGTCAGCCACG
GGAAAGAATGGCTCCTACC -> GAAAGAATGGCTCCTACCC
GGAAATTCGAACGTGCCCG -> GAAATTCGAACGTGCCCGG
GGAACAAGCCCCCTCACCT -> GAACAAGCCCCCTCACCTC
GGAACGGAATCGTGACATG -> GAACGGAATCGTGACATGG
GGAACGGGGTACCATGGGT -> GAACGGGGTACCATGGGTA
GGAACTGGATGAGGGAGAC -> GAACTGGATGAGGGAGACG
GGAAGCTTGGGTTGCCCTG -> GAAGCTTGGGTTGCCCTGA
GGAATCCGGAACGGGGTAC -> GAATCCGGAACGGGGTACC
GGAATCGTATGACCGTAAG -> GAATCGTATGACCGTAAGA
GGAATCGTGACATGGATAA -> GAATCGTGACATGGATAAC
GGACAAACTCTGTACACCT -> GACAAACTCTGTACACCTT
GGACACGCATACCCGAGTC -> GACACGCATACCCGAGTCT
GGACCGAACGGGGACTGTT -> GACCGAACGGGGACTGTTT
GGACGGTAGCTCCAGCTGG -> GACGGTAGCTCCAGCTGGG
GGACTGTTTGGAAAGAATG -> GACTGTTTGGAAAGAATGG
GGACTTTTACATCCCAAGC -> GACTTTTACATCCCAAGCT
GGAGACGTATTAAATGAGG -> GAGACGTATTAAATGAGGT
GGAGAGCTCCGTCAACGTG -> GAGAGCTCCGTCAACGTGA
GGAGCCAACCAAATGTTGG -> GAGCCAACCAAATGTTGGA
GGAGCCACTTCCCAAGCAG -> GAGCCACTTCCCAAGCAGC
GGAGCCATGGGGGTAACTC -> GAGCCATGGGGGTAACTCG
GGAGCCATTGGTACGTATT -> GAGCCATTGGTACGTATTA
GGAGTTACCAGCACTCTCA -> GAGTTACCAGCACTCTCAC
GGATAACATCAAACCTGCG -> GATAACATCAAACCTGCGT
GGATAGCTGATCCACAGTG -> GATAGCTGATCCACAGTGG
GGATATGATGTCAGTACGG -> GATATGATGTCAGTACGGT
GGATGAGGGAGACGTATTA -> GATGAGGGAGACGTATTAA
GGATGGTGTACCACTAAAC -> GATGGTGTACCACTAAACA
GGATGGTGTGAGGTCGTCT -> GATGGTGTGAGGTCGTCTC
GGATGTACACTATATGCTA -> GATGTACACTATATGCTAT
GGATGTCCCAGCATTACTT -> GATGTCCCAGCATTACTTG
GGATGTGATGTACAGCTCC -> GATGTGATGTACAGCTCCC
GGATTCTGCACAAGCCTCT -> GATTCTGCACAAGCCTCTC
GGATTTGACCGCGCCCAGG -> GATTTGACCGCGCCCAGGG
GGCAACGAACAATTCCAGG -> GCAACGAACAATTCCAGGA
GGCACGGCGCGAGCTGATT -> GCACGGCGCGAGCTGATTA
GGCAGAATGCGAACTGGAT -> GCAGAATGCGAACTGGATG
GGCAGCTTGTCCAACCCTT -> GCAGCTTGTCCAACCCTTC
GGCATACTTCGCGTAAACG -> GCATACTTCGCGTAAACGC
GGCATTCCCTCGCTCTTGT -> GCATTCCCTCGCTCTTGTT
GGCCACATTTTATAATCAT -> GCCACATTTTATAATCATG
GGCCAGGTTGGGTTCGTTA -> GCCAGGTTGGGTTCGTTAA
GGCCATGCTGTGGGTACAG -> GCCATGCTGTGGGTACAGC
GGCCATGTCTGCTTAACTC -> GCCATGTCTGCTTAACTCT
GGCCCATACCGTTTGGGAA -> GCCCATACCGTTTGGGAAA
GGCCTGTGGGGTGCAACAT -> GCCTGTGGGGTGCAACATC
GGCCTTGAGTGACCTTTCG -> GCCTTGAGTGACCTTTCGT
GGCGCAGTTCTCTGAGTCC -> GCGCAGTTCTCTGAGTCCG
GGCGCGAGCTGATTACCTT -> GCGCGAGCTGATTACCTTT
GGCGCTTAAAGATAATCAC -> GCGCTTAAAGATAATCACC
GGCTAGGCATTCCCTCGCT -> GCTAGGCATTCCCTCGCTC
GGCTCCTACCCGCCCGGCC -> GCTCCTACCCGCCCGGCCC
GGCTCGGGAACTGGATGAG -> GCTCGGGAACTGGATGAGG
GGCTTCTCACCGTCCTGGA -> GCTTCTCACCGTCCTGGAC
GGCTTCTGTCCCAAAACTA -> GCTTCTGTCCCAAAACTAC
GGCTTGAACCAAATGTTGG -> GCTTGAACCAAATGTTGGA
GGCTTGTAGGCGCTTAAAG -> GCTTGTAGGCGCTTAAAGA
GGCTTTGAACCAAATGTTG -> GCTTTGAACCAAATGTTGG
GGGAAAAGTCCGCATAATA -> GGAAAAGTCCGCATAATAT
GGGAAAAGTGAGTCAGCCA -> GGAAAAGTGAGTCAGCCAC
GGGAACTGGATGAGGGAGA -> GGAACTGGATGAGGGAGAC
GGGAATCCGGAACGGGGTA -> GGAATCCGGAACGGGGTAC
GGGAATCGTATGACCGTAA -> GGAATCGTATGACCGTAAG
GGGACTGTTTGGAAAGAAT -> GGACTGTTTGGAAAGAATG
GGGACTTTTACATCCCAAG -> GGACTTTTACATCCCAAGC
GGGAGACGTATTAAATGAG -> GGAGACGTATTAAATGAGG
GGGAGTTACCAGCACTCTC -> GGAGTTACCAGCACTCTCA
GGGATATGATGTCAGTACG -> GGATATGATGTCAGTACGG
GGGATGTCCCAGCATTACT -> GGATGTCCCAGCATTACTT
GGGATTCTGCACAAGCCTC -> GGATTCTGCACAAGCCTCT
GGGCAGAATGCGAACTGGA -> GGCAGAATGCGAACTGGAT
GGGCGTCTCTTAGACGTCT -> GGCGTCTCTTAGACGTCTA
GGGCTTCTGTCCCAAAACT -> GGCTTCTGTCCCAAAACTA
GGGGAATCCGGAACGGGGT -> GGGAATCCGGAACGGGGTA
GGGGAATCGTATGACCGTA -> GGGAATCGTATGACCGTAA
GGGGACTGTTTGGAAAGAA -> GGGACTGTTTGGAAAGAAT
GGGGACTTTTACATCCCAA -> GGGACTTTTACATCCCAAG
GGGGAGTTACCAGCACTCT -> GGGAGTTACCAGCACTCTC
GGGGCAGAATGCGAACTGG -> GGGCAGAATGCGAACTGGA
GGGGCTTCTGTCCCAAAAC -> GGGCTTCTGTCCCAAAACT
GGGGGCAGAATGCGAACTG -> GGGGCAGAATGCGAACTGG
GGGGGTAACTCGTTGTCTG -> GGGGTAACTCGTTGTCTGG
GGGGTAACTCGTTGTCTGG -> GGGTAACTCGTTGTCTGGG
GGGGTACCATGGGTAGCGG -> GGGTACCATGGGTAGCGGA
GGGGTACCGTCAATAGATC -> GGGTACCGTCAATAGATCC
GGGGTGCAACATCATCACT -> GGGTGCAACATCATCACTA
GGGGTTGTCATTAATCCAA -> GGGTTGTCATTAATCCAAT
GGGTAACTCGTTGTCTGGG -> GGTAACTCGTTGTCTGGGG
GGGTACAGCTCCCGTCATC -> GGTACAGCTCCCGTCATCC
GGGTACCATGGGTAGCGGA -> GGTACCATGGGTAGCGGAA
GGGTACCGTCAATAGATCC -> GGTACCGTCAATAGATCCG
GGGTAGCGGAACGGAATCG -> GGTAGCGGAACGGAATCGT
GGGTCTAAGCAGAAGGAAC -> GGTCTAAGCAGAAGGAACA
GGGTGCAACATCATCACTA -> GGTGCAACATCATCACTAA
GGGTGCTGCCATAGTGGAG -> GGTGCTGCCATAGTGGAGA
GGGTTCAATGGCAACGAAC -> GGTTCAATGGCAACGAACA
GGGTTCGTTAACAAAACAC -> GGTTCGTTAACAAAACACT
GGGTTGCCCTGACGAGCTC -> GGTTGCCCTGACGAGCTCC
GGGTTGTCATTAATCCAAT -> GGTTGTCATTAATCCAATC
GGTAACTCGTTGTCTGGGG -> GTAACTCGTTGTCTGGGGT
GGTACAGCTCCCGTCATCC -> GTACAGCTCCCGTCATCCG
GGTACCATGGGTAGCGGAA -> GTACCATGGGTAGCGGAAC
GGTACCGTCAATAGATCCG -> GTACCGTCAATAGATCCGG
GGTACGAATAATCAACCGG -> GTACGAATAATCAACCGGT
GGTACGTATTAAAACCGTT -> GTACGTATTAAAACCGTTT
GGTAGCCAGCATACCAAAA -> GTAGCCAGCATACCAAAAC
GGTAGCGGAACGGAATCGT -> GTAGCGGAACGGAATCGTG
GGTAGCTCCAGCTGGGTGC -> GTAGCTCCAGCTGGGTGCT
GGTATCCTGACGGCCTTGA -> GTATCCTGACGGCCTTGAG
GGTATTAGCGCGATTTAGT -> GTATTAGCGCGATTTAGTA
GGTCCGCGTACCCTTCACC -> GTCCGCGTACCCTTCACCA
GGTCCGGGGAGTTACCAGC -> GTCCGGGGAGTTACCAGCA
GGTCGTCTCATTGAACAGT -> GTCGTCTCATTGAACAGTT
GGTCTAAGCAGAAGGAACA -> GTCTAAGCAGAAGGAACAA
GGTGCAACATCATCACTAA -> GTGCAACATCATCACTAAA
GGTGCTCTGCCTAAACCAA -> GTGCTCTGCCTAAACCAAA
GGTGCTGCCATAGTGGAGA -> GTGCTGCCATAGTGGAGAG
GGTGTACCACTAAACAGCC -> GTGTACCACTAAACAGCCT
GGTGTGAGGTCGTCTCATT -> GTGTGAGGTCGTCTCATTG
GGTTAAGGGGAATCGTATG -> GTTAAGGGGAATCGTATGA
GGTTAGCAGACAAACCGAT -> GTTAGCAGACAAACCGATC
GGTTAGGTACGAATAATCA -> GTTAGGTACGAATAATCAA
GGTTCAATGGCAACGAACA -> GTTCAATGGCAACGAACAA
GGTTCGTCACACAGTACAG -> GTTCGTCACACAGTACAGC
GGTTCGTTAACAAAACACT -> GTTCGTTAACAAAACACTA
GGTTGCCCTGACGAGCTCC -> GTTGCCCTGACGAGCTCCA
GGTTGGGTTCGTTAACAAA -> GTTGGGTTCGTTAACAAAA
GGTTGTCATTAATCCAATC -> GTTGTCATTAATCCAATCC
GTAAACGCAAAGCAGAATT -> TAAACGCAAAGCAGAATTA
GTAACTCGTTGTCTGGGGT -> TAACTCGTTGTCTGGGGTA
GTAAGACATGCGAATTCGA -> TAAGACATGCGAATTCGAG
GTAAGTTTGCGAGTCAGCA -> TAAGTTTGCGAGTCAGCAC
GTAATGGCAGCTTGTCCAA -> TAATGGCAGCTTGTCCAAC
GTACACATGATCCTGTCAG -> TACACATGATCCTGTCAGC
GTACACCTTACGTGTCAAA -> TACACCTTACGTGTCAAAA
GTACACTATATGCTATGCG -> TACACTATATGCTATGCGT
GTACAGCTCCCGTCATCCA -> TACAGCTCCCGTCATCCAG
GTACAGCTCCCGTCATCCC -> TACAGCTCCCGTCATCCCG
GTACAGCTCCCGTCATCCG -> TACAGCTCCCGTCATCCGA
GTACAGCTCCCGTCATCCT -> TACAGCTCCCGTCATCCTT
GTACAGTTTGTCGTCGTGC -> TACAGTTTGTCGTCGTGCT
GTACCACTAAACAGCCTCG -> TACCACTAAACAGCCTCGT
GTACCATGGGTAGCGGAAC -> TACCATGGGTAGCGGAACG
GTACCCTTCACCATGATCC -> TACCCTTCACCATGATCCC
GTACCGTCAATAGATCCGG -> TACCGTCAATAGATCCGGC
GTACGAATAATCAACCGGT -> TACGAATAATCAACCGGTT
GTACGACTCAACGGACCGA -> TACGACTCAACGGACCGAA
GTACGGTTAAGGGGAATCG -> TACGGTTAAGGGGAATCGT
GTACGTATTAAAACCGTTT -> TACGTATTAAAACCGTTTG
GTACTTCACGTGGTGCTCT -> TACTTCACGTGGTGCTCTG
GTAGACCAGAGGCTTGTAG -> TAGACCAGAGGCTTGTAGG
GTAGCAGATAGAATCTGAA -> TAGCAGATAGAATCTGAAG
GTAGCCAGCATACCAAAAC -> TAGCCAGCATACCAAAACC
GTAGCGGAACGGAATCGTG -> TAGCGGAACGGAATCGTGA
GTAGCTCCAGCTGGGTGCT -> TAGCTCCAGCTGGGTGCTG
GTAGGCCAGGTTGGGTTCG -> TAGGCCAGGTTGGGTTCGT
GTAGGCGCTTAAAGATAAT -> TAGGCGCTTAAAGATAATC
GTAGGGAAAAGTCCGCATA -> TAGGGAAAAGTCCGCATAA
GTATAGCTCCCCGATATGT -> TATAGCTCCCCGATATGTT
GTATCCTGACGGCCTTGAG -> TATCCTGACGGCCTTGAGT
GTATGACCGTAAGACATGC -> TATGACCGTAAGACATGCG
GTATTAAAACCGTTTGAAG -> TATTAAAACCGTTTGAAGG
GTATTAAATGAGGTTAGGT -> TATTAAATGAGGTTAGGTA
GTATTAGCGCGATTTAGTA -> TATTAGCGCGATTTAGTAG
GTCAAAAATAGCGGACACG -> TCAAAAATAGCGGACACGC
GTCAACGTGACGCAGATGT -> TCAACGTGACGCAGATGTT
GTCAATAGATCCGGCACGG -> TCAATAGATCCGGCACGGC
GTCAATCGCTCCCGTGTTG -> TCAATCGCTCCCGTGTTGG
GTCACACAGTACAGCTCCC -> TCACACAGTACAGCTCCCG
GTCAGCACCGCTATCAGGC -> TCAGCACCGCTATCAGGCT
GTCAGCCACGTTACATTCC -> TCAGCCACGTTACATTCCC
GTCAGCGGATAGCTGATCC -> TCAGCGGATAGCTGATCCA
GTCAGCTAGCCTATTGTGA -> TCAGCTAGCCTATTGTGAC
GTCAGTACGGTTAAGGGGA -> TCAGTACGGTTAAGGGGAA
GTCATATACCAGACGTGCA -> TCATATACCAGACGTGCAG
GTCATCCAGGCCATGCTGT -> TCATCCAGGCCATGCTGTG
GTCATCCCGCAATGGCTTT -> TCATCCCGCAATGGCTTTG
GTCATCCGAAATTCGGCTT -> TCATCCGAAATTCGGCTTG
GTCATCCTTAGAATATTAT -> TCATCCTTAGAATATTATG
GTCATGATGAGCCTCCCCG -> TCATGATGAGCCTCCCCGT
GTCATTAATCCAATCCCTT -> TCATTAATCCAATCCCTTA
GTCATTCTATGTGGGATTC -> TCATTCTATGTGGGATTCT
GTCCAACCCTTCTACTAAA -> TCCAACCCTTCTACTAAAG
GTCCCAAAACTACAGAGTT -> TCCCAAAACTACAGAGTTA
GTCCCAGCATTACTTGTGC -> TCCCAGCATTACTTGTGCA
GTCCGCATAATATTTGGTA -> TCCGCATAATATTTGGTAT
GTCCGCGTACCCTTCACCA -> TCCGCGTACCCTTCACCAT
GTCCGGGGAGTTACCAGCA -> TCCGGGGAGTTACCAGCAC
GTCCGTTTCTTTGGCTCGG -> TCCGTTTCTTTGGCTCGGG
GTCCTGGACGGTAGCTCCA -> TCCTGGACGGTAGCTCCAG
GTCCTTAATCAATACGTAG -> TCCTTAATCAATACGTAGG
GTCGGGGGCAGAATGCGAA -> TCGGGGGCAGAATGCGAAC
GTCGTCGTGCTCGATTATG -> TCGTCGTGCTCGATTATGG
GTCGTCTAGAAGGGTCTAA -> TCGTCTAGAAGGGTCTAAG
GTCGTCTCATTGAACAGTT -> TCGTCTCATTGAACAGTTC
GTCGTGCTCGATTATGGCC -> TCGTGCTCGATTATGGCCA
GTCGTGGGGCTTCTGTCCC -> TCGTGGGGCTTCTGTCCCA
GTCTAACATTTATATCCAG -> TCTAACATTTATATCCAGT
GTCTAAGCAGAAGGAACAA -> TCTAAGCAGAAGGAACAAG
GTCTAGAAGGGTCTAAGCA -> TCTAGAAGGGTCTAAGCAG
GTCTCATTGAACAGTTCCC -> TCTCATTGAACAGTTCCCC
GTCTGCTTAACTCTATGTT -> TCTGCTTAACTCTATGTTA
GTCTGGGGTACCGTCAATA -> TCTGGGGTACCGTCAATAG
GTCTGTTTACCAAACGCCC -> TCTGTTTACCAAACGCCCA
GTGAACAGGGATGTCCCAG -> TGAACAGGGATGTCCCAGC
GTGACATCGACGCGAACGA -> TGACATCGACGCGAACGAA
GTGACATGGATAACATCAA -> TGACATGGATAACATCAAA
GTGACCTTTCGTCAATCGC -> TGACCTTTCGTCAATCGCT
GTGACGCAGATGTTTAACA -> TGACGCAGATGTTTAACAC
GTGAGGTCGTCTCATTGAA -> TGAGGTCGTCTCATTGAAC
GTGAGTCAGCCACGTTACA -> TGAGTCAGCCACGTTACAT
GTGATGTACAGCTCCCGTC -> TGATGTACAGCTCCCGTCA
GTGCAACATCATCACTAAA -> TGCAACATCATCACTAAAC
GTGCAAGACAATTGTGGCC -> TGCAAGACAATTGTGGCCA
GTGCAGCGCCGACAGCCGT -> TGCAGCGCCGACAGCCGTC
GTGCCCGGCATACTTCGCG -> TGCCCGGCATACTTCGCGT
GTGCTCGATTATGGCCACA -> TGCTCGATTATGGCCACAT
GTGCTCTGCCTAAACCAAA -> TGCTCTGCCTAAACCAAAC
GTGCTGCCATAGTGGAGAG -> TGCTGCCATAGTGGAGAGC
GTGGACAAACTCTGTACAC -> TGGACAAACTCTGTACACC
GTGGAGAGCTCCGTCAACG -> TGGAGAGCTCCGTCAACGT
GTGGCCATGTCTGCTTAAC -> TGGCCATGTCTGCTTAACT
GTGGGATTCTGCACAAGCC -> TGGGATTCTGCACAAGCCT
GTGGGGCTTCTGTCCCAAA -> TGGGGCTTCTGTCCCAAAA
GTGGGGTGCAACATCATCA -> TGGGGTGCAACATCATCAC
GTGGGTACAGCTCCCGTCA -> TGGGTACAGCTCCCGTCAT
GTGGGTTCAATGGCAACGA -> TGGGTTCAATGGCAACGAA
GTGGTATTAGCGCGATTTA -> TGGTATTAGCGCGATTTAG
GTGGTGCTCTGCCTAAACC -> TGGTGCTCTGCCTAAACCA
GTGTACCACTAAACAGCCT -> TGTACCACTAAACAGCCTC
GTGTAGACCAGAGGCTTGT -> TGTAGACCAGAGGCTTGTA
GTGTCAAAAATAGCGGACA -> TGTCAAAAATAGCGGACAC
GTGTGAGGTCGTCTCATTG -> TGTGAGGTCGTCTCATTGA
GTGTTGGATGTACACTATA -> TGTTGGATGTACACTATAT
GTTAACAAAACACTACCAA -> TTAACAAAACACTACCAAT
GTTAAGGGGAATCGTATGA -> TTAAGGGGAATCGTATGAC
GTTACATTCCCAACCACCT -> TTACATTCCCAACCACCTC
GTTACCAGCACTCTCACCA -> TTACCAGCACTCTCACCAA
GTTACCGACGCCGTATAGC -> TTACCGACGCCGTATAGCT
GTTACGCACGGCTAGGCAT -> TTACGCACGGCTAGGCATT
GTTAGCAGACAAACCGATC -> TTAGCAGACAAACCGATCG
GTTAGGTACGAATAATCAA -> TTAGGTACGAATAATCAAC
GTTCAATGGCAACGAACAA -> TTCAATGGCAACGAACAAT
GTTCCCCACAACTACAGAA -> TTCCCCACAACTACAGAAT
GTTCGTCACACAGTACAGC -> TTCGTCACACAGTACAGCT
GTTCGTTAACAAAACACTA -> TTCGTTAACAAAACACTAC
GTTCTCTGAGTCCGTTTCT -> TTCTCTGAGTCCGTTTCTT
GTTGCCCTGACGAGCTCCA -> TTGCCCTGACGAGCTCCAG
GTTGGAGCCAACCAAATGT -> TTGGAGCCAACCAAATGTT
GTTGGAGCCACTTCCCAAG -> TTGGAGCCACTTCCCAAGC
GTTGGAGCCATGGGGGTAA -> TTGGAGCCATGGGGGTAAC
GTTGGAGCCATTGGTACGT -> TTGGAGCCATTGGTACGTA
GTTGGATGTACACTATATG -> TTGGATGTACACTATATGC
GTTGGGGTTGTCATTAATC -> TTGGGGTTGTCATTAATCC
GTTGGGTTCGTTAACAAAA -> TTGGGTTCGTTAACAAAAC
GTTGTCATTAATCCAATCC -> TTGTCATTAATCCAATCCC
GTTGTCTGGGGTACCGTCA -> TTGTCTGGGGTACCGTCAA
GTTTAACACATACACCAGC -> TTTAACACATACACCAGCT
GTTTACCAAACGCCCATAC -> TTTACCAAACGCCCATACT
GTTTCTTTGGCTCGGGAAC -> TTTCTTTGGCTCGGGAACT
GTTTGAAGGATTTGACCGC -> TTTGAAGGATTTGACCGCG
GTTTGCGAGTCAGCACCGC -> TTTGCGAGTCAGCACCGCT
GTTTGGAAAGAATGGCTCC -> TTTGGAAAGAATGGCTCCT
GTTTGGGAAAAGTGAGTCA -> TTTGGGAAAAGTGAGTCAG
GTTTGTCGTCGTGCTCGAT -> TTTGTCGTCGTGCTCGATT
GTTTTGCTAATGGTAGCCA -> TTTTGCTAATGGTAGCCAG
TAAAACCGTTTGAAGGATT -> AAAACCGTTTGAAGGATTT
TAAACAACAGACAGTACAG -> AAACAACAGACAGTACAGT
TAAACAGCCTCGTGTAGAC -> AAACAGCCTCGTGTAGACC
TAAACCAAACTGCAGTCAT -> AAACCAAACTGCAGTCATT
TAAACGCAAAGCAGAATTA -> AAACGCAAAGCAGAATTAA
TAAACGCGTACTTCACGTG -> AAACGCGTACTTCACGTGG
TAAAGATAATCACCCTGGG -> AAAGATAATCACCCTGGGA
TAAAGTAGGGAAAAGTCCG -> AAAGTAGGGAAAAGTCCGC
TAAATGAGGTTAGGTACGA -> AAATGAGGTTAGGTACGAA
TAACAAAACACTACCAATT -> AACAAAACACTACCAATTG
TAACACATACACCAGCTGG -> AACACATACACCAGCTGGC
TAACATCAAACCTGCGTCG -> AACATCAAACCTGCGTCGT
TAACATTTATATCCAGTCA -> AACATTTATATCCAGTCAG
TAACTCGTTGTCTGGGGTA -> AACTCGTTGTCTGGGGTAC
TAACTCTATGTTACGCACG -> AACTCTATGTTACGCACGG
TAACTCTTTTACGAGCCTG -> AACTCTTTTACGAGCCTGT
TAAGACATGCGAATTCGAG -> AAGACATGCGAATTCGAGT
TAAGCAGAAGGAACAAGCC -> AAGCAGAAGGAACAAGCCC
TAAGCTGTACACATGATCC -> AAGCTGTACACATGATCCT
TAAGGGGAATCGTATGACC -> AAGGGGAATCGTATGACCG
TAAGTTTGCGAGTCAGCAC -> AAGTTTGCGAGTCAGCACC
TAATATTTGGTATCCTGAC -> AATATTTGGTATCCTGACG
TAATCAACCGGTTAGCAGA -> AATCAACCGGTTAGCAGAC
TAATCAATACGTAGGCCAG -> AATCAATACGTAGGCCAGG
TAATCACCCTGGGATATGA -> AATCACCCTGGGATATGAT
TAATCATGACTAGCCAACT -> AATCATGACTAGCCAACTC
TAATCCAATCCCTTAGCCC -> AATCCAATCCCTTAGCCCT
TAATGGCAGCTTGTCCAAC -> AATGGCAGCTTGTCCAACC
TAATGGTAGCCAGCATACC -> AATGGTAGCCAGCATACCA
TAATTGCACCGCATGTGGT -> AATTGCACCGCATGTGGTA
TACAACACTACGGTCCGGG -> ACAACACTACGGTCCGGGG
TACACATGATCCTGTCAGC -> ACACATGATCCTGTCAGCG
TACACCAGCTGGCCTGTGG -> ACACCAGCTGGCCTGTGGG
TACACCTTACGTGTCAAAA -> ACACCTTACGTGTCAAAAA
TACACTATATGCTATGCGT -> ACACTATATGCTATGCGTA
TACAGAATGACCGCCTCCA -> ACAGAATGACCGCCTCCAC
TACAGAGTTACCGACGCCG -> ACAGAGTTACCGACGCCGT
TACAGCTCCCGTCATCCAG -> ACAGCTCCCGTCATCCAGG
TACAGCTCCCGTCATCCCG -> ACAGCTCCCGTCATCCCGC
TACAGCTCCCGTCATCCGA -> ACAGCTCCCGTCATCCGAA
TACAGCTCCCGTCATCCTT -> ACAGCTCCCGTCATCCTTA
TACAGTTTGTCGTCGTGCT -> ACAGTTTGTCGTCGTGCTC
TACATCCCAAGCTTATAAG -> ACATCCCAAGCTTATAAGC
TACATTCCCAACCACCTCC -> ACATTCCCAACCACCTCCA
TACCAAAACCAAAAGTCAT -> ACCAAAACCAAAAGTCATG
TACCAAACGCCCATACTCA -> ACCAAACGCCCATACTCAA
TACCAATTGCAGAACTTTT -> ACCAATTGCAGAACTTTTG
TACCACTAAACAGCCTCGT -> ACCACTAAACAGCCTCGTG
TACCAGACGTGCAGCGCCG -> ACCAGACGTGCAGCGCCGA
TACCAGCACTCTCACCAAC -> ACCAGCACTCTCACCAACG
TACCATGGGTAGCGGAACG -> ACCATGGGTAGCGGAACGG
TACCCGAGTCTGTTTACCA -> ACCCGAGTCTGTTTACCAA
TACCCGCCCGGCCCATACC -> ACCCGCCCGGCCCATACCG
TACCCTTCACCATGATCCC -> ACCCTTCACCATGATCCCA
TACCGACGCCGTATAGCTC -> ACCGACGCCGTATAGCTCC
TACCGTCAATAGATCCGGC -> ACCGTCAATAGATCCGGCA
TACCGTTTGGGAAAAGTGA -> ACCGTTTGGGAAAAGTGAG
TACCTTTAACTCTTTTACG -> ACCTTTAACTCTTTTACGA
TACGAATAATCAACCGGTT -> ACGAATAATCAACCGGTTA
TACGACTCAACGGACCGAA -> ACGACTCAACGGACCGAAC
TACGAGCCTGTCGTGGGGC -> ACGAGCCTGTCGTGGGGCT
TACGCACGGCTAGGCATTC -> ACGCACGGCTAGGCATTCC
TACGGTCCGGGGAGTTACC -> ACGGTCCGGGGAGTTACCA
TACGGTTAAGGGGAATCGT -> ACGGTTAAGGGGAATCGTA
TACGTAGGCCAGGTTGGGT -> ACGTAGGCCAGGTTGGGTT
TACGTATTAAAACCGTTTG -> ACGTATTAAAACCGTTTGA
TACGTGTCAAAAATAGCGG -> ACGTGTCAAAAATAGCGGA
TACTAAAGTAGGGAAAAGT -> ACTAAAGTAGGGAAAAGTC
TACTCAACCAGACATGGAT -> ACTCAACCAGACATGGATG
TACTTCACGTGGTGCTCTG -> ACTTCACGTGGTGCTCTGC
TACTTCGCGTAAACGCAAA -> ACTTCGCGTAAACGCAAAG
TACTTGTGCAAGACAATTG -> ACTTGTGCAAGACAATTGT
TAGAAGGGTCTAAGCAGAA -> AGAAGGGTCTAAGCAGAAG
TAGAATATTATGAACCAAA -> AGAATATTATGAACCAAAT
TAGAATCTGAAGTGGGTTC -> AGAATCTGAAGTGGGTTCA
TAGACCAGAGGCTTGTAGG -> AGACCAGAGGCTTGTAGGC
TAGACTTTTAGATACAACA -> AGACTTTTAGATACAACAC
TAGATACAACACTACGGTC -> AGATACAACACTACGGTCC
TAGATCCGGCACGGCGCGA -> AGATCCGGCACGGCGCGAG
TAGCAGACAAACCGATCGC -> AGCAGACAAACCGATCGCT
TAGCAGATAGAATCTGAAG -> AGCAGATAGAATCTGAAGT
TAGCCAACTCCCACTGAAC -> AGCCAACTCCCACTGAACG
TAGCCAGCATACCAAAACC -> AGCCAGCATACCAAAACCA
TAGCCCTATTTCCACTAAT -> AGCCCTATTTCCACTAATT
TAGCCTATTGTGACATCGA -> AGCCTATTGTGACATCGAC
TAGCGCGATTTAGTAGCAG -> AGCGCGATTTAGTAGCAGA
TAGCGGAACGGAATCGTGA -> AGCGGAACGGAATCGTGAC
TAGCGGACACGCATACCCG -> AGCGGACACGCATACCCGA
TAGCTCCAGCTGGGTGCTG -> AGCTCCAGCTGGGTGCTGC
TAGCTCCCCGATATGTTGG -> AGCTCCCCGATATGTTGGG
TAGCTGATCCACAGTGGAC -> AGCTGATCCACAGTGGACA
TAGCTGTAATGGCAGCTTG -> AGCTGTAATGGCAGCTTGT
TAGGCATTCCCTCGCTCTT -> AGGCATTCCCTCGCTCTTG
TAGGCCAGGTTGGGTTCGT -> AGGCCAGGTTGGGTTCGTT
TAGGCGCTTAAAGATAATC -> AGGCGCTTAAAGATAATCA
TAGGGAAAAGTCCGCATAA -> AGGGAAAAGTCCGCATAAT
TAGGTACGAATAATCAACC -> AGGTACGAATAATCAACCG
TAGTACGACTCAACGGACC -> AGTACGACTCAACGGACCG
TAGTAGCAGATAGAATCTG -> AGTAGCAGATAGAATCTGA
TAGTGGAGAGCTCCGTCAA -> AGTGGAGAGCTCCGTCAAC
TATAAGCTGTACACATGAT -> ATAAGCTGTACACATGATC
TATAATCATGACTAGCCAA -> ATAATCATGACTAGCCAAC
TATACCAGACGTGCAGCGC -> ATACCAGACGTGCAGCGCC
TATAGCTCCCCGATATGTT -> ATAGCTCCCCGATATGTTG
TATATCCAGTCAGCTAGCC -> ATATCCAGTCAGCTAGCCT
TATATGAATCTTAGTACGA -> ATATGAATCTTAGTACGAC
TATATGCTATGCGTACAGC -> ATATGCTATGCGTACAGCT
TATCAGGCTTCTCACCGTC -> ATCAGGCTTCTCACCGTCC
TATCCAGTCAGCTAGCCTA -> ATCCAGTCAGCTAGCCTAT
TATCCTGACGGCCTTGAGT -> ATCCTGACGGCCTTGAGTG
TATGAACCAAATGTTGGAG -> ATGAACCAAATGTTGGAGC
TATGAATCTTAGTACGACT -> ATGAATCTTAGTACGACTC
TATGACCGTAAGACATGCG -> ATGACCGTAAGACATGCGA
TATGATGTCAGTACGGTTA -> ATGATGTCAGTACGGTTAA
TATGCGTACAGCTCCCGTC -> ATGCGTACAGCTCCCGTCA
TATGCTATGCGTACAGCTC -> ATGCTATGCGTACAGCTCC
TATGGCCACATTTTATAAT -> ATGGCCACATTTTATAATC
TATGTGGGATTCTGCACAA -> ATGTGGGATTCTGCACAAG
TATGTTACGCACGGCTAGG -> ATGTTACGCACGGCTAGGC
TATGTTGGGGTTGTCATTA -> ATGTTGGGGTTGTCATTAA
TATTAAAACCGTTTGAAGG -> ATTAAAACCGTTTGAAGGA
TATTAAATGAGGTTAGGTA -> ATTAAATGAGGTTAGGTAC
TATTAGCGCGATTTAGTAG -> ATTAGCGCGATTTAGTAGC
TATTATGAACCAAATGTTG -> ATTATGAACCAAATGTTGG
TATTGTGACATCGACGCGA -> ATTGTGACATCGACGCGAA
TATTTCCACTAATTGCACC -> ATTTCCACTAATTGCACCG
TATTTGGTATCCTGACGGC -> ATTTGGTATCCTGACGGCC
TCAAAAATAGCGGACACGC -> CAAAAATAGCGGACACGCA
TCAAACCTGCGTCGTCTAG -> CAAACCTGCGTCGTCTAGA
TCAACCAGACATGGATGGT -> CAACCAGACATGGATGGTG
TCAACCGGTTAGCAGACAA -> CAACCGGTTAGCAGACAAA
TCAACGGACCGAACGGGGA -> CAACGGACCGAACGGGGAC
TCAACGTGACGCAGATGTT -> CAACGTGACGCAGATGTTT
TCAATACGTAGGCCAGGTT -> CAATACGTAGGCCAGGTTG
TCAATAGATCCGGCACGGC -> CAATAGATCCGGCACGGCG
TCAATATATGAATCTTAGT -> CAATATATGAATCTTAGTA
TCAATCGCTCCCGTGTTGG -> CAATCGCTCCCGTGTTGGA
TCAATGGCAACGAACAATT -> CAATGGCAACGAACAATTC
TCACACAGTACAGCTCCCG -> CACACAGTACAGCTCCCGT
TCACCAACGGTCCGCGTAC -> CACCAACGGTCCGCGTACC
TCACCATGATCCCAAGGGG -> CACCATGATCCCAAGGGGA
TCACCCTGGGATATGATGT -> CACCCTGGGATATGATGTC
TCACCGTCCTGGACGGTAG -> CACCGTCCTGGACGGTAGC
TCACCTCAATATATGAATC -> CACCTCAATATATGAATCT
TCACGTGGTGCTCTGCCTA -> CACGTGGTGCTCTGCCTAA
TCACTAAACGCGTACTTCA -> CACTAAACGCGTACTTCAC
TCAGCACCGCTATCAGGCT -> CAGCACCGCTATCAGGCTT
TCAGCCACGTTACATTCCC -> CAGCCACGTTACATTCCCA
TCAGCGGATAGCTGATCCA -> CAGCGGATAGCTGATCCAC
TCAGCTAGCCTATTGTGAC -> CAGCTAGCCTATTGTGACA
TCAGGCTTCTCACCGTCCT -> CAGGCTTCTCACCGTCCTG
TCAGTACGGTTAAGGGGAA -> CAGTACGGTTAAGGGGAAT
TCATATACCAGACGTGCAG -> CATATACCAGACGTGCAGC
TCATCACTAAACGCGTACT -> CATCACTAAACGCGTACTT
TCATCCAGGCCATGCTGTG -> CATCCAGGCCATGCTGTGG
TCATCCCGCAATGGCTTTG -> CATCCCGCAATGGCTTTGA
TCATCCGAAATTCGGCTTG -> CATCCGAAATTCGGCTTGA
TCATCCTTAGAATATTATG -> CATCCTTAGAATATTATGA
TCATGACTAGCCAACTCCC -> CATGACTAGCCAACTCCCA
TCATGATGAGCCTCCCCGT -> CATGATGAGCCTCCCCGTC
TCATGGTTCGTCACACAGT -> CATGGTTCGTCACACAGTA
TCATTAATCCAATCCCTTA -> CATTAATCCAATCCCTTAG
TCATTCTATGTGGGATTCT -> CATTCTATGTGGGATTCTG
TCATTGAACAGTTCCCCAC -> CATTGAACAGTTCCCCACA
TCCAACCCTTCTACTAAAG -> CCAACCCTTCTACTAAAGT
TCCAATCCCTTAGCCCTAT -> CCAATCCCTTAGCCCTATT
TCCACAGTGGACAAACTCT -> CCACAGTGGACAAACTCTG
TCCACGAGACTGTGAACAG -> CCACGAGACTGTGAACAGG
TCCACTAATTGCACCGCAT -> CCACTAATTGCACCGCATG
TCCAGCTGGGTGCTGCCAT -> CCAGCTGGGTGCTGCCATA
TCCAGGATGGTGTACCACT -> CCAGGATGGTGTACCACTA
TCCAGGCCATGCTGTGGGT -> CCAGGCCATGCTGTGGGTA
TCCAGGCGCAGTTCTCTGA -> CCAGGCGCAGTTCTCTGAG
TCCAGTCAGCTAGCCTATT -> CCAGTCAGCTAGCCTATTG
TCCATTCATGGTTCGTCAC -> CCATTCATGGTTCGTCACA
TCCCAAAACTACAGAGTTA -> CCCAAAACTACAGAGTTAC
TCCCAACCACCTCCATTCA -> CCCAACCACCTCCATTCAT
TCCCAAGCAGCGAGGAAGC -> CCCAAGCAGCGAGGAAGCT
TCCCAAGCTTATAAGCTGT -> CCCAAGCTTATAAGCTGTA
TCCCAAGGGGAATCCGGAA -> CCCAAGGGGAATCCGGAAC
TCCCACTGAACGTCCTTAA -> CCCACTGAACGTCCTTAAT
TCCCAGCATTACTTGTGCA -> CCCAGCATTACTTGTGCAA
TCCCCACAACTACAGAATG -> CCCCACAACTACAGAATGA
TCCCCGATATGTTGGGGTT -> CCCCGATATGTTGGGGTTG
TCCCCGTCATATACCAGAC -> CCCCGTCATATACCAGACG
TCCCGCAATGGCTTTGAAC -> CCCGCAATGGCTTTGAACC
TCCCGTCATCCAGGCCATG -> CCCGTCATCCAGGCCATGC
TCCCGTCATCCCGCAATGG -> CCCGTCATCCCGCAATGGC
TCCCGTCATCCGAAATTCG -> CCCGTCATCCGAAATTCGG
TCCCGTCATCCTTAGAATA -> CCCGTCATCCTTAGAATAT
TCCCGTGTTGGATGTACAC -> CCCGTGTTGGATGTACACT
TCCCTCGCTCTTGTTTTGC -> CCCTCGCTCTTGTTTTGCT
TCCCTTAGCCCTATTTCCA -> CCCTTAGCCCTATTTCCAC
TCCGAAATTCGGCTTGAAC -> CCGAAATTCGGCTTGAACC
TCCGAGCTTAGCTGTAATG -> CCGAGCTTAGCTGTAATGG
TCCGCATAATATTTGGTAT -> CCGCATAATATTTGGTATC
TCCGCGTACCCTTCACCAT -> CCGCGTACCCTTCACCATG
TCCGGAACGGGGTACCATG -> CCGGAACGGGGTACCATGG
TCCGGCACGGCGCGAGCTG -> CCGGCACGGCGCGAGCTGA
TCCGGGGAGTTACCAGCAC -> CCGGGGAGTTACCAGCACT
TCCGTCAACGTGACGCAGA -> CCGTCAACGTGACGCAGAT
TCCGTTTCTTTGGCTCGGG -> CCGTTTCTTTGGCTCGGGA
TCCTACCCGCCCGGCCCAT -> CCTACCCGCCCGGCCCATA
TCCTCTTGGAAATTCGAAC -> CCTCTTGGAAATTCGAACG
TCCTGACGGCCTTGAGTGA -> CCTGACGGCCTTGAGTGAC
TCCTGGACGGTAGCTCCAG -> CCTGGACGGTAGCTCCAGC
TCCTGTCAGCGGATAGCTG -> CCTGTCAGCGGATAGCTGA
TCCTTAATCAATACGTAGG -> CCTTAATCAATACGTAGGC
TCCTTAGAATATTATGAAC -> CCTTAGAATATTATGAACC
TCGAACGTGCCCGGCATAC -> CGAACGTGCCCGGCATACT
TCGAATCCTCTTGGAAATT -> CGAATCCTCTTGGAAATTC
TCGACGCGAACGAAAAATT -> CGACGCGAACGAAAAATTA
TCGAGTCGGGGGCAGAATG -> CGAGTCGGGGGCAGAATGC
TCGATTATGGCCACATTTT -> CGATTATGGCCACATTTTA
TCGCGTAAACGCAAAGCAG -> CGCGTAAACGCAAAGCAGA
TCGCTCCCGTGTTGGATGT -> CGCTCCCGTGTTGGATGTA
TCGCTCGAATCCTCTTGGA -> CGCTCGAATCCTCTTGGAA
TCGCTCTTGTTTTGCTAAT -> CGCTCTTGTTTTGCTAATG
TCGGCTTGAACCAAATGTT -> CGGCTTGAACCAAATGTTG
TCGGGAACTGGATGAGGGA -> CGGGAACTGGATGAGGGAG
TCGGGGGCAGAATGCGAAC -> CGGGGGCAGAATGCGAACT
TCGTATGACCGTAAGACAT -> CGTATGACCGTAAGACATG
TCGTCAATCGCTCCCGTGT -> CGTCAATCGCTCCCGTGTT
TCGTCACACAGTACAGCTC -> CGTCACACAGTACAGCTCC
TCGTCGTGCTCGATTATGG -> CGTCGTGCTCGATTATGGC
TCGTCTAGAAGGGTCTAAG -> CGTCTAGAAGGGTCTAAGC
TCGTCTCATTGAACAGTTC -> CGTCTCATTGAACAGTTCC
TCGTGACATGGATAACATC -> CGTGACATGGATAACATCA
TCGTGCTCGATTATGGCCA -> CGTGCTCGATTATGGCCAC
TCGTGGGGCTTCTGTCCCA -> CGTGGGGCTTCTGTCCCAA
TCGTGTAGACCAGAGGCTT -> CGTGTAGACCAGAGGCTTG
TCGTTAACAAAACACTACC -> CGTTAACAAAACACTACCA
TCGTTGTCTGGGGTACCGT -> CGTTGTCTGGGGTACCGTC
TCTAACATTTATATCCAGT -> CTAACATTTATATCCAGTC
TCTAAGCAGAAGGAACAAG -> CTAAGCAGAAGGAACAAGC
TCTACTAAAGTAGGGAAAA -> CTACTAAAGTAGGGAAAAG
TCTAGAAGGGTCTAAGCAG -> CTAGAAGGGTCTAAGCAGA
TCTATGTGGGATTCTGCAC -> CTATGTGGGATTCTGCACA
TCTATGTTACGCACGGCTA -> CTATGTTACGCACGGCTAG
TCTCACCAACGGTCCGCGT -> CTCACCAACGGTCCGCGTA
TCTCACCGTCCTGGACGGT -> CTCACCGTCCTGGACGGTA
TCTCATTGAACAGTTCCCC -> CTCATTGAACAGTTCCCCA
TCTCCGAGCTTAGCTGTAA -> CTCCGAGCTTAGCTGTAAT
TCTCTGAGTCCGTTTCTTT -> CTCTGAGTCCGTTTCTTTG
TCTGAAGTGGGTTCAATGG -> CTGAAGTGGGTTCAATGGC
TCTGAGTCCGTTTCTTTGG -> CTGAGTCCGTTTCTTTGGC
TCTGCACAAGCCTCTCCGA -> CTGCACAAGCCTCTCCGAG
TCTGCCTAAACCAAACTGC -> CTGCCTAAACCAAACTGCA
TCTGCTTAACTCTATGTTA -> CTGCTTAACTCTATGTTAC
TCTGGGGTACCGTCAATAG -> CTGGGGTACCGTCAATAGA
TCTGTACACCTTACGTGTC -> CTGTACACCTTACGTGTCA
TCTGTCCCAAAACTACAGA -> CTGTCCCAAAACTACAGAG
TCTGTTTACCAAACGCCCA -> CTGTTTACCAAACGCCCAT
TCTTAGTACGACTCAACGG -> CTTAGTACGACTCAACGGA
TCTTGGAAATTCGAACGTG -> CTTGGAAATTCGAACGTGC
TCTTGTTTTGCTAATGGTA -> CTTGTTTTGCTAATGGTAG
TCTTTGGCTCGGGAACTGG -> CTTTGGCTCGGGAACTGGA
TCTTTTACGAGCCTGTCGT -> CTTTTACGAGCCTGTCGTG
TGAACAGGGATGTCCCAGC -> GAACAGGGATGTCCCAGCA
TGAACAGTTCCCCACAACT -> GAACAGTTCCCCACAACTA
TGAACCAAATGTTGGAGCC -> GAACCAAATGTTGGAGCCA,GAACCAAATGTTGGAGCCA,GAACCAAATGTTGGAGCCA
TGAACGTCCTTAATCAATA -> GAACGTCCTTAATCAATAC
TGAAGGATTTGACCGCGCC -> GAAGGATTTGACCGCGCCC
TGAAGTGGGTTCAATGGCA -> GAAGTGGGTTCAATGGCAA
TGAATCTTAGTACGACTCA -> GAATCTTAGTACGACTCAA
TGACATCGACGCGAACGAA -> GACATCGACGCGAACGAAA
TGACATGGATAACATCAAA -> GACATGGATAACATCAAAC
TGACCGCCTCCACGAGACT -> GACCGCCTCCACGAGACTG
TGACCGCGCCCAGGGGACT -> GACCGCGCCCAGGGGACTT
TGACCGTAAGACATGCGAA -> GACCGTAAGACATGCGAAT
TGACCTTTCGTCAATCGCT -> GACCTTTCGTCAATCGCTC
TGACGAGCTCCAGGCGCAG -> GACGAGCTCCAGGCGCAGT
TGACGCAGATGTTTAACAC -> GACGCAGATGTTTAACACA
TGACGGCCTTGAGTGACCT -> GACGGCCTTGAGTGACCTT
TGACTAGCCAACTCCCACT -> GACTAGCCAACTCCCACTG
TGAGCCTCCCCGTCATATA -> GAGCCTCCCCGTCATATAC
TGAGGGAGACGTATTAAAT -> GAGGGAGACGTATTAAATG
TGAGGGCGTCTCTTAGACG -> GAGGGCGTCTCTTAGACGT
TGAGGTCGTCTCATTGAAC -> GAGGTCGTCTCATTGAACA
TGAGGTTAGGTACGAATAA -> GAGGTTAGGTACGAATAAT
TGAGTCAGCCACGTTACAT -> GAGTCAGCCACGTTACATT
TGAGTCCGTTTCTTTGGCT -> GAGTCCGTTTCTTTGGCTC
TGAGTGACCTTTCGTCAAT -> GAGTGACCTTTCGTCAATC
TGATCCACAGTGGACAAAC -> GATCCACAGTGGACAAACT
TGATCCCAAGGGGAATCCG -> GATCCCAAGGGGAATCCGG
TGATCCTGTCAGCGGATAG -> GATCCTGTCAGCGGATAGC
TGATGAGCCTCCCCGTCAT -> GATGAGCCTCCCCGTCATA
TGATGTACAGCTCCCGTCA -> GATGTACAGCTCCCGTCAT
TGATGTCAGTACGGTTAAG -> GATGTCAGTACGGTTAAGG
TGATTACCTTTAACTCTTT -> GATTACCTTTAACTCTTTT
TGCAACATCATCACTAAAC -> GCAACATCATCACTAAACG
TGCAAGACAATTGTGGCCA -> GCAAGACAATTGTGGCCAT
TGCACAAGCCTCTCCGAGC -> GCACAAGCCTCTCCGAGCT
TGCACCGCATGTGGTATTA -> GCACCGCATGTGGTATTAG
TGCAGAACTTTTGAGGGCG -> GCAGAACTTTTGAGGGCGT
TGCAGCGCCGACAGCCGTC -> GCAGCGCCGACAGCCGTCT
TGCAGTCATTCTATGTGGG -> GCAGTCATTCTATGTGGGA
TGCCATAGTGGAGAGCTCC -> GCCATAGTGGAGAGCTCCG
TGCCCGGCATACTTCGCGT -> GCCCGGCATACTTCGCGTA
TGCCCTGACGAGCTCCAGG -> GCCCTGACGAGCTCCAGGC
TGCCTAAACCAAACTGCAG -> GCCTAAACCAAACTGCAGT
TGCGAACTGGATGTGATGT -> GCGAACTGGATGTGATGTA
TGCGAATTCGAGTCGGGGG -> GCGAATTCGAGTCGGGGGC
TGCGAGTCAGCACCGCTAT -> GCGAGTCAGCACCGCTATC
TGCGTACAGCTCCCGTCAT -> GCGTACAGCTCCCGTCATC
TGCGTCGTCTAGAAGGGTC -> GCGTCGTCTAGAAGGGTCT
TGCTAATGGTAGCCAGCAT -> GCTAATGGTAGCCAGCATA
TGCTATGCGTACAGCTCCC -> GCTATGCGTACAGCTCCCG
TGCTCGATTATGGCCACAT -> GCTCGATTATGGCCACATT
TGCTCTGCCTAAACCAAAC -> GCTCTGCCTAAACCAAACT
TGCTGCCATAGTGGAGAGC -> GCTGCCATAGTGGAGAGCT
TGCTGTGGGTACAGCTCCC -> GCTGTGGGTACAGCTCCCG
TGCTTAACTCTATGTTACG -> GCTTAACTCTATGTTACGC
TGGAAAGAATGGCTCCTAC -> GGAAAGAATGGCTCCTACC
TGGAAATTCGAACGTGCCC -> GGAAATTCGAACGTGCCCG
TGGACAAACTCTGTACACC -> GGACAAACTCTGTACACCT
TGGACGGTAGCTCCAGCTG -> GGACGGTAGCTCCAGCTGG
TGGAGAGCTCCGTCAACGT -> GGAGAGCTCCGTCAACGTG
TGGAGCCAACCAAATGTTG -> GGAGCCAACCAAATGTTGG
TGGAGCCACTTCCCAAGCA -> GGAGCCACTTCCCAAGCAG
TGGAGCCATGGGGGTAACT -> GGAGCCATGGGGGTAACTC
TGGAGCCATTGGTACGTAT -> GGAGCCATTGGTACGTATT
TGGATAACATCAAACCTGC -> GGATAACATCAAACCTGCG
TGGATGAGGGAGACGTATT -> GGATGAGGGAGACGTATTA
TGGATGGTGTGAGGTCGTC -> GGATGGTGTGAGGTCGTCT
TGGATGTACACTATATGCT -> GGATGTACACTATATGCTA
TGGATGTGATGTACAGCTC -> GGATGTGATGTACAGCTCC
TGGCAACGAACAATTCCAG -> GGCAACGAACAATTCCAGG
TGGCAGCTTGTCCAACCCT -> GGCAGCTTGTCCAACCCTT
TGGCCACATTTTATAATCA -> GGCCACATTTTATAATCAT
TGGCCATGTCTGCTTAACT -> GGCCATGTCTGCTTAACTC
TGGCCTGTGGGGTGCAACA -> GGCCTGTGGGGTGCAACAT
TGGCTCCTACCCGCCCGGC -> GGCTCCTACCCGCCCGGCC
TGGCTCGGGAACTGGATGA -> GGCTCGGGAACTGGATGAG
TGGCTTTGAACCAAATGTT -> GGCTTTGAACCAAATGTTG
TGGGAAAAGTGAGTCAGCC -> GGGAAAAGTGAGTCAGCCA
TGGGATATGATGTCAGTAC -> GGGATATGATGTCAGTACG
TGGGATTCTGCACAAGCCT -> GGGATTCTGCACAAGCCTC
TGGGGCTTCTGTCCCAAAA -> GGGGCTTCTGTCCCAAAAC
TGGGGGTAACTCGTTGTCT -> GGGGGTAACTCGTTGTCTG
TGGGGTACCGTCAATAGAT -> GGGGTACCGTCAATAGATC
TGGGGTGCAACATCATCAC -> GGGGTGCAACATCATCACT
TGGGGTTGTCATTAATCCA -> GGGGTTGTCATTAATCCAA
TGGGTACAGCTCCCGTCAT -> GGGTACAGCTCCCGTCATC
TGGGTAGCGGAACGGAATC -> GGGTAGCGGAACGGAATCG
TGGGTGCTGCCATAGTGGA -> GGGTGCTGCCATAGTGGAG
TGGGTTCAATGGCAACGAA -> GGGTTCAATGGCAACGAAC
TGGGTTCGTTAACAAAACA -> GGGTTCGTTAACAAAACAC
TGGGTTGCCCTGACGAGCT -> GGGTTGCCCTGACGAGCTC
TGGTACGTATTAAAACCGT -> GGTACGTATTAAAACCGTT
TGGTAGCCAGCATACCAAA -> GGTAGCCAGCATACCAAAA
TGGTATCCTGACGGCCTTG -> GGTATCCTGACGGCCTTGA
TGGTATTAGCGCGATTTAG -> GGTATTAGCGCGATTTAGT
TGGTGCTCTGCCTAAACCA -> GGTGCTCTGCCTAAACCAA
TGGTGTACCACTAAACAGC -> GGTGTACCACTAAACAGCC
TGGTGTGAGGTCGTCTCAT -> GGTGTGAGGTCGTCTCATT
TGGTTCGTCACACAGTACA -> GGTTCGTCACACAGTACAG
TGTAATGGCAGCTTGTCCA -> GTAATGGCAGCTTGTCCAA
TGTACACATGATCCTGTCA -> GTACACATGATCCTGTCAG
TGTACACCTTACGTGTCAA -> GTACACCTTACGTGTCAAA
TGTACACTATATGCTATGC -> GTACACTATATGCTATGCG
TGTACAGCTCCCGTCATCC -> GTACAGCTCCCGTCATCCT
TGTACCACTAAACAGCCTC -> GTACCACTAAACAGCCTCG
TGTAGACCAGAGGCTTGTA -> GTAGACCAGAGGCTTGTAG
TGTAGGCGCTTAAAGATAA -> GTAGGCGCTTAAAGATAAT
TGTCAAAAATAGCGGACAC -> GTCAAAAATAGCGGACACG
TGTCAGCGGATAGCTGATC -> GTCAGCGGATAGCTGATCC
TGTCAGTACGGTTAAGGGG -> GTCAGTACGGTTAAGGGGA
TGTCATTAATCCAATCCCT -> GTCATTAATCCAATCCCTT
TGTCCAACCCTTCTACTAA -> GTCCAACCCTTCTACTAAA
TGTCCCAAAACTACAGAGT -> GTCCCAAAACTACAGAGTT
TGTCCCAGCATTACTTGTG -> GTCCCAGCATTACTTGTGC
TGTCGTCGTGCTCGATTAT -> GTCGTCGTGCTCGATTATG
TGTCGTGGGGCTTCTGTCC -> GTCGTGGGGCTTCTGTCCC
TGTCTGCTTAACTCTATGT -> GTCTGCTTAACTCTATGTT
TGTCTGGGGTACCGTCAAT -> GTCTGGGGTACCGTCAATA
TGTGAACAGGGATGTCCCA -> GTGAACAGGGATGTCCCAG
TGTGACATCGACGCGAACG -> GTGACATCGACGCGAACGA
TGTGAGGTCGTCTCATTGA -> GTGAGGTCGTCTCATTGAA
TGTGATGTACAGCTCCCGT -> GTGATGTACAGCTCCCGTC
TGTGCAAGACAATTGTGGC -> GTGCAAGACAATTGTGGCC
TGTGGCCATGTCTGCTTAA -> GTGGCCATGTCTGCTTAAC
TGTGGGATTCTGCACAAGC -> GTGGGATTCTGCACAAGCC
TGTGGGGTGCAACATCATC -> GTGGGGTGCAACATCATCA
TGTGGGTACAGCTCCCGTC -> GTGGGTACAGCTCCCGTCA
TGTGGTATTAGCGCGATTT -> GTGGTATTAGCGCGATTTA
TGTTACGCACGGCTAGGCA -> GTTACGCACGGCTAGGCAT
TGTTGGAGCCAACCAAATG -> GTTGGAGCCAACCAAATGT
TGTTGGAGCCACTTCCCAA -> GTTGGAGCCACTTCCCAAG
TGTTGGAGCCATGGGGGTA -> GTTGGAGCCATGGGGGTAA
TGTTGGAGCCATTGGTACG -> GTTGGAGCCATTGGTACGT
TGTTGGATGTACACTATAT -> GTTGGATGTACACTATATG
TGTTGGGGTTGTCATTAAT -> GTTGGGGTTGTCATTAATC
TGTTTAACACATACACCAG -> GTTTAACACATACACCAGC
TGTTTACCAAACGCCCATA -> GTTTACCAAACGCCCATAC
TGTTTGGAAAGAATGGCTC -> GTTTGGAAAGAATGGCTCC
TGTTTTGCTAATGGTAGCC -> GTTTTGCTAATGGTAGCCA
TTAAAACCGTTTGAAGGAT -> TAAAACCGTTTGAAGGATT
TTAAACAACAGACAGTACA -> TAAACAACAGACAGTACAG
TTAAAGATAATCACCCTGG -> TAAAGATAATCACCCTGGG
TTAAATGAGGTTAGGTACG -> TAAATGAGGTTAGGTACGA
TTAACAAAACACTACCAAT -> TAACAAAACACTACCAATT
TTAACACATACACCAGCTG -> TAACACATACACCAGCTGG
TTAACTCTATGTTACGCAC -> TAACTCTATGTTACGCACG
TTAACTCTTTTACGAGCCT -> TAACTCTTTTACGAGCCTG
TTAAGGGGAATCGTATGAC -> TAAGGGGAATCGTATGACC
TTAATCAATACGTAGGCCA -> TAATCAATACGTAGGCCAG
TTAATCCAATCCCTTAGCC -> TAATCCAATCCCTTAGCCC
TTACATCCCAAGCTTATAA -> TACATCCCAAGCTTATAAG
TTACATTCCCAACCACCTC -> TACATTCCCAACCACCTCC
TTACCAAACGCCCATACTC -> TACCAAACGCCCATACTCA
TTACCAGCACTCTCACCAA -> TACCAGCACTCTCACCAAC
TTACCGACGCCGTATAGCT -> TACCGACGCCGTATAGCTC
TTACCTTTAACTCTTTTAC -> TACCTTTAACTCTTTTACG
TTACGAGCCTGTCGTGGGG -> TACGAGCCTGTCGTGGGGC
TTACGCACGGCTAGGCATT -> TACGCACGGCTAGGCATTC
TTACGTGTCAAAAATAGCG -> TACGTGTCAAAAATAGCGG
TTACTTGTGCAAGACAATT -> TACTTGTGCAAGACAATTG
TTAGAATATTATGAACCAA -> TAGAATATTATGAACCAAA
TTAGACTTTTAGATACAAC -> TAGACTTTTAGATACAACA
TTAGATACAACACTACGGT -> TAGATACAACACTACGGTC
TTAGCAGACAAACCGATCG -> TAGCAGACAAACCGATCGC
TTAGCCCTATTTCCACTAA -> TAGCCCTATTTCCACTAAT
TTAGCGCGATTTAGTAGCA -> TAGCGCGATTTAGTAGCAG
TTAGCTGTAATGGCAGCTT -> TAGCTGTAATGGCAGCTTG
TTAGGTACGAATAATCAAC -> TAGGTACGAATAATCAACC
TTAGTACGACTCAACGGAC -> TAGTACGACTCAACGGACC
TTAGTAGCAGATAGAATCT -> TAGTAGCAGATAGAATCTG
TTATAAGCTGTACACATGA -> TATAAGCTGTACACATGAT
TTATAATCATGACTAGCCA -> TATAATCATGACTAGCCAA
TTATATCCAGTCAGCTAGC -> TATATCCAGTCAGCTAGCC
TTATGAACCAAATGTTGGA -> TATGAACCAAATGTTGGAG
TTATGGCCACATTTTATAA -> TATGGCCACATTTTATAAT
TTCAATGGCAACGAACAAT -> TCAATGGCAACGAACAATT
TTCACCATGATCCCAAGGG -> TCACCATGATCCCAAGGGG
TTCACGTGGTGCTCTGCCT -> TCACGTGGTGCTCTGCCTA
TTCATGGTTCGTCACACAG -> TCATGGTTCGTCACACAGT
TTCCACTAATTGCACCGCA -> TCCACTAATTGCACCGCAT
TTCCAGGATGGTGTACCAC -> TCCAGGATGGTGTACCACT
TTCCCAACCACCTCCATTC -> TCCCAACCACCTCCATTCA
TTCCCAAGCAGCGAGGAAG -> TCCCAAGCAGCGAGGAAGC
TTCCCCACAACTACAGAAT -> TCCCCACAACTACAGAATG
TTCCCTCGCTCTTGTTTTG -> TCCCTCGCTCTTGTTTTGC
TTCGAACGTGCCCGGCATA -> TCGAACGTGCCCGGCATAC
TTCGAGTCGGGGGCAGAAT -> TCGAGTCGGGGGCAGAATG
TTCGCGTAAACGCAAAGCA -> TCGCGTAAACGCAAAGCAG
TTCGGCTTGAACCAAATGT -> TCGGCTTGAACCAAATGTT
TTCGTCAATCGCTCCCGTG -> TCGTCAATCGCTCCCGTGT
TTCGTCACACAGTACAGCT -> TCGTCACACAGTACAGCTC
TTCGTTAACAAAACACTAC -> TCGTTAACAAAACACTACC
TTCTACTAAAGTAGGGAAA -> TCTACTAAAGTAGGGAAAA
TTCTATGTGGGATTCTGCA -> TCTATGTGGGATTCTGCAC
TTCTCACCGTCCTGGACGG -> TCTCACCGTCCTGGACGGT
TTCTCTGAGTCCGTTTCTT -> TCTCTGAGTCCGTTTCTTT
TTCTGCACAAGCCTCTCCG -> TCTGCACAAGCCTCTCCGA
TTCTGTCCCAAAACTACAG -> TCTGTCCCAAAACTACAGA
TTCTTTGGCTCGGGAACTG -> TCTTTGGCTCGGGAACTGG
TTGAACAGTTCCCCACAAC -> TGAACAGTTCCCCACAACT
TTGAACCAAATGTTGGAGC -> TGAACCAAATGTTGGAGCC,TGAACCAAATGTTGGAGCC
TTGAAGGATTTGACCGCGC -> TGAAGGATTTGACCGCGCC
TTGACCGCGCCCAGGGGAC -> TGACCGCGCCCAGGGGACT
TTGAGGGCGTCTCTTAGAC -> TGAGGGCGTCTCTTAGACG
TTGAGTGACCTTTCGTCAA -> TGAGTGACCTTTCGTCAAT
TTGCACCGCATGTGGTATT -> TGCACCGCATGTGGTATTA
TTGCAGAACTTTTGAGGGC -> TGCAGAACTTTTGAGGGCG
TTGCCCTGACGAGCTCCAG -> TGCCCTGACGAGCTCCAGG
TTGCGAGTCAGCACCGCTA -> TGCGAGTCAGCACCGCTAT
TTGCTAATGGTAGCCAGCA -> TGCTAATGGTAGCCAGCAT
TTGGAAAGAATGGCTCCTA -> TGGAAAGAATGGCTCCTAC
TTGGAAATTCGAACGTGCC -> TGGAAATTCGAACGTGCCC
TTGGAGCCAACCAAATGTT -> TGGAGCCAACCAAATGTTG
TTGGAGCCACTTCCCAAGC -> TGGAGCCACTTCCCAAGCA
TTGGAGCCATGGGGGTAAC -> TGGAGCCATGGGGGTAACT
TTGGAGCCATTGGTACGTA -> TGGAGCCATTGGTACGTAT
TTGGATGTACACTATATGC -> TGGATGTACACTATATGCT
TTGGCTCGGGAACTGGATG -> TGGCTCGGGAACTGGATGA
TTGGGAAAAGTGAGTCAGC -> TGGGAAAAGTGAGTCAGCC
TTGGGGTTGTCATTAATCC -> TGGGGTTGTCATTAATCCA
TTGGGTTCGTTAACAAAAC -> TGGGTTCGTTAACAAAACA
TTGGGTTGCCCTGACGAGC -> TGGGTTGCCCTGACGAGCT
TTGGTACGTATTAAAACCG -> TGGTACGTATTAAAACCGT
TTGGTATCCTGACGGCCTT -> TGGTATCCTGACGGCCTTG
TTGTAGGCGCTTAAAGATA -> TGTAGGCGCTTAAAGATAA
TTGTCATTAATCCAATCCC -> TGTCATTAATCCAATCCCT
TTGTCCAACCCTTCTACTA -> TGTCCAACCCTTCTACTAA
TTGTCGTCGTGCTCGATTA -> TGTCGTCGTGCTCGATTAT
TTGTCTGGGGTACCGTCAA -> TGTCTGGGGTACCGTCAAT
TTGTGACATCGACGCGAAC -> TGTGACATCGACGCGAACG
TTGTGCAAGACAATTGTGG -> TGTGCAAGACAATTGTGGC
TTGTGGCCATGTCTGCTTA -> TGTGGCCATGTCTGCTTAA
TTGTTTTGCTAATGGTAGC -> TGTTTTGCTAATGGTAGCC
TTTAACACATACACCAGCT -> TTAACACATACACCAGCTG
TTTAACTCTTTTACGAGCC -> TTAACTCTTTTACGAGCCT
TTTACATCCCAAGCTTATA -> TTACATCCCAAGCTTATAA
TTTACCAAACGCCCATACT -> TTACCAAACGCCCATACTC
TTTACGAGCCTGTCGTGGG -> TTACGAGCCTGTCGTGGGG
TTTAGATACAACACTACGG -> TTAGATACAACACTACGGT
TTTAGTAGCAGATAGAATC -> TTAGTAGCAGATAGAATCT
TTTATAATCATGACTAGCC -> TTATAATCATGACTAGCCA
TTTATATCCAGTCAGCTAG -> TTATATCCAGTCAGCTAGC
TTTCCACTAATTGCACCGC -> TTCCACTAATTGCACCGCA
TTTCGTCAATCGCTCCCGT -> TTCGTCAATCGCTCCCGTG
TTTCTTTGGCTCGGGAACT -> TTCTTTGGCTCGGGAACTG
TTTGAACCAAATGTTGGAG -> TTGAACCAAATGTTGGAGC
TTTGAAGGATTTGACCGCG -> TTGAAGGATTTGACCGCGC
TTTGACCGCGCCCAGGGGA -> TTGACCGCGCCCAGGGGAC
TTTGAGGGCGTCTCTTAGA -> TTGAGGGCGTCTCTTAGAC
TTTGCGAGTCAGCACCGCT -> TTGCGAGTCAGCACCGCTA
TTTGCTAATGGTAGCCAGC -> TTGCTAATGGTAGCCAGCA
TTTGGAAAGAATGGCTCCT -> TTGGAAAGAATGGCTCCTA
TTTGGCTCGGGAACTGGAT -> TTGGCTCGGGAACTGGATG
TTTGGGAAAAGTGAGTCAG -> TTGGGAAAAGTGAGTCAGC
TTTGGTATCCTGACGGCCT -> TTGGTATCCTGACGGCCTT
TTTGTCGTCGTGCTCGATT -> TTGTCGTCGTGCTCGATTA
TTTTACATCCCAAGCTTAT -> TTTACATCCCAAGCTTATA
TTTTACGAGCCTGTCGTGG -> TTTACGAGCCTGTCGTGGG
TTTTAGATACAACACTACG -> TTTAGATACAACACTACGG
TTTTATAATCATGACTAGC -> TTTATAATCATGACTAGCC
TTTTGAGGGCGTCTCTTAG -> TTTGAGGGCGTCTCTTAGA
TTTTGCTAATGGTAGCCAG -> TTTGCTAATGGTAGCCAGC
