AGGACCTTCCGGCACCCCGC -> AAGGACCTTCCGGCACCCCG
GTTCTACACAACTTTGGCGA -> CGTTCTACACAACTTTGGCG
GAACCGGGCCTAGACAGTCA -> TGAACCGGGCCTAGACAGTC
AAGCTAACGTCATGCCTTTG -> TAAGCTAACGTCATGCCTTT
TGTACTTTACGCGCCCTGGC -> CTGTACTTTACGCGCCCTGG
AGTCTAGCGCTTCACACTAC -> AAGTCTAGCGCTTCACACTA
TGCATAGTTTGCCCTATTCT -> CTGCATAGTTTGCCCTATTC
ACTTTCGCTGACCCATCACC -> CACTTTCGCTGACCCATCAC
ATTTCGGCGCAAGAGGCAAA -> TATTTCGGCGCAAGAGGCAA
GTGTCGAAGAAGCATCTGAA -> CGTGTCGAAGAAGCATCTGA
TAGGATTATAATGCAATACG -> CTAGGATTATAATGCAATAC
CTTGATCTTCCTACTAGGCC -> CCTTGATCTTCCTACTAGGC
AATGTCACTTTCGCTGACCC -> AAATGTCACTTTCGCTGACC
CCTAGACAGTCATTTATCTC -> GCCTAGACAGTCATTTATCT
TCACTTTCGCTGACCCATCA -> GTCACTTTCGCTGACCCATC
CTCGATGGCTTCTACCGCCA -> TCTCGATGGCTTCTACCGCC
CGATTAGATCAGTGTGTCGG -> CCGATTAGATCAGTGTGTCG
AAGCATATTTCGGCGCAAGA -> GAAGCATATTTCGGCGCAAG
ACTTTACGCGCCCTGGCCTT -> TACTTTACGCGCCCTGGCCT
ACCACTAGTTCTGAACCGGG -> CACCACTAGTTCTGAACCGG
TATTTGGGTCCTCCGTCAGA -> ATATTTGGGTCCTCCGTCAG
TCGCTGACCCATCACCCCTG -> TTCGCTGACCCATCACCCCT
CACAACTTTGGCGAGCATTG -> ACACAACTTTGGCGAGCATT
TTCCGACGTTCTACACAACT -> GTTCCGACGTTCTACACAAC
CCACGATCGACGACGCTCGA -> TCCACGATCGACGACGCTCG
ACTACAGGATCTACAGTCCT -> CACTACAGGATCTACAGTCC
AATACGCGAGACAGACCAAT -> CAATACGCGAGACAGACCAA
TTTGGCGAGCATTGACTACG -> CTTTGGCGAGCATTGACTAC
GTCCTCCGTCAGATTGGGAG -> GGTCCTCCGTCAGATTGGGA
TTACGAGCCGATTAGATCAG -> TTTACGAGCCGATTAGATCA
TGAAGCGGGTGGCACTCGCT -> CTGAAGCGGGTGGCACTCGC
GCAGTGACGTGGGCGATTCT -> GGCAGTGACGTGGGCGATTC
GCTCCTTTACCTTTACGAGC -> GGCTCCTTTACCTTTACGAG
CGCGCCCTGGCCTTCTAGCT -> ACGCGCCCTGGCCTTCTAGC
TCATTGATCTCGAGAGCTAA -> TTCATTGATCTCGAGAGCTA
AGCGCTTGGCTCCGCGTGCC -> TAGCGCTTGGCTCCGCGTGC
ACAGTCATTTATCTCGATGG -> GACAGTCATTTATCTCGATG
AATGGAAGCATATTTCGGCG -> AAATGGAAGCATATTTCGGC
CACCAGGTTAGGATAGGACG -> ACACCAGGTTAGGATAGGAC
AGATTGGGAGGTGTCGGGAT -> CAGATTGGGAGGTGTCGGGA
CCGGCCCCCAACGTTCATTG -> CCCGGCCCCCAACGTTCATT
AGGTTAGGATAGGACGTTTC -> CAGGTTAGGATAGGACGTTT
GGCCTAGACAGTCATTTATC -> GGGCCTAGACAGTCATTTAT
GGCTCCGCGTGCCTCCTCTT -> TGGCTCCGCGTGCCTCCTCT
CCGCCCTAACAGGGCTCCTT -> GCCGCCCTAACAGGGCTCCT
CGAGCCGATTAGATCAGTGT -> ACGAGCCGATTAGATCAGTG
AAAATATAAGGACCTTCCGG -> TAAAATATAAGGACCTTCCG
ACAGGGCTCCTTTACCTTTA -> AACAGGGCTCCTTTACCTTT
ACGAACGACCTGTATTGGTG -> GACGAACGACCTGTATTGGT
TTGGCGAGCATTGACTACGC -> TTTGGCGAGCATTGACTACG
CCTTTACGAGCCGATTAGAT -> ACCTTTACGAGCCGATTAGA
GTGACGTGGGCGATTCTCCA -> AGTGACGTGGGCGATTCTCC
CGCTCGCTAGGATTATAATG -> TCGCTCGCTAGGATTATAAT
GCGCAAGAGGCAAAAAGACT -> GGCGCAAGAGGCAAAAAGAC
CCCCCAACGTTCATTGATCT -> GCCCCCAACGTTCATTGATC
GACGTTTCTTCTAGCGCTTG -> GGACGTTTCTTCTAGCGCTT
GGCCTCCCGGCCCCCAACGT -> AGGCCTCCCGGCCCCCAACG
TGATGTAGTCTGGTAAAAAT -> CTGATGTAGTCTGGTAAAAA
AGGCAAAAAGACTACCGACA -> GAGGCAAAAAGACTACCGAC
CAGATTGGGAGGTGTCGGGA -> TCAGATTGGGAGGTGTCGGG
TCCTGTTTTTCTGCTCAGAC -> GTCCTGTTTTTCTGCTCAGA
CCTCTTGTTAAAATATAAGG -> TCCTCTTGTTAAAATATAAG
TACCGACATAAGCACGGAGT -> CTACCGACATAAGCACGGAG
CCTCCCGGCCCCCAACGTTC -> GCCTCCCGGCCCCCAACGTT
CTGAATTGACACTGCCGCCC -> TCTGAATTGACACTGCCGCC
CTCGAAGACAGGGACTAAGC -> GCTCGAAGACAGGGACTAAG
CTCTCACCACTAGTTCTGAA -> ACTCTCACCACTAGTTCTGA
GCCGATTAGATCAGTGTGTC -> AGCCGATTAGATCAGTGTGT
GGACGTTTCTTCTAGCGCTT -> AGGACGTTTCTTCTAGCGCT
TGGCACTCGCTCTTAGATGG -> GTGGCACTCGCTCTTAGATG
GCATTGACTACGCAACAGTT -> AGCATTGACTACGCAACAGT
GTTAGCTTACGGGCGGCACT -> CGTTAGCTTACGGGCGGCAC
GGAGTGCCGGGCGACACCAG -> CGGAGTGCCGGGCGACACCA
TGCAATACGCGAGACAGACC -> ATGCAATACGCGAGACAGAC
TCGCTAGGATTATAATGCAA -> CTCGCTAGGATTATAATGCA
CATCTGAATTGACACTGCCG -> GCATCTGAATTGACACTGCC
ACCAATCATATTTGGGTCCT -> GACCAATCATATTTGGGTCC
TTTCGCTGACCCATCACCCC -> CTTTCGCTGACCCATCACCC
AGAGCTAACGGTCGTATTCT -> GAGAGCTAACGGTCGTATTC
TGCCTTTGGGTCCTGTTTTT -> ATGCCTTTGGGTCCTGTTTT
GGGCTCCTTTACCTTTACGA -> AGGGCTCCTTTACCTTTACG
AAAATGGAAGCATATTTCGG -> AAAAATGGAAGCATATTTCG
CGCAAGAGGCAAAAAGACTA -> GCGCAAGAGGCAAAAAGACT
TAAGGGTGTTGACTCATTGC -> GTAAGGGTGTTGACTCATTG
GGACTAAGCTAACGTCATGC -> GGGACTAAGCTAACGTCATG
ACCACTCCTTGATCTTCCTA -> GACCACTCCTTGATCTTCCT
CTTCTAGCTTGCGGTCCAGT -> CCTTCTAGCTTGCGGTCCAG
GATTCCTGTACTTTACGCGC -> TGATTCCTGTACTTTACGCG
CTATTCTGGTTTGTAGAAAA -> CCTATTCTGGTTTGTAGAAA
TTGGTGGTTAAATCGCTCGC -> ATTGGTGGTTAAATCGCTCG
GTACTGAAGCGGGTGGCACT -> CGTACTGAAGCGGGTGGCAC
TAAATCGCTCGCTAGGATTA -> TTAAATCGCTCGCTAGGATT
ACTAAGCTAACGTCATGCCT -> GACTAAGCTAACGTCATGCC
CTGCTCAGACGAACGACCTG -> TCTGCTCAGACGAACGACCT
TACACAACTTTGGCGAGCAT -> CTACACAACTTTGGCGAGCA
ATCAGTGTGTCGGTAAGGGT -> GATCAGTGTGTCGGTAAGGG
GGGTCCTCCGTCAGATTGGG -> TGGGTCCTCCGTCAGATTGG
GTGTCGGTAAGGGTGTTGAC -> TGTGTCGGTAAGGGTGTTGA
CATGCCTTTGGGTCCTGTTT -> TCATGCCTTTGGGTCCTGTT
GCGTACTGAAGCGGGTGGCA -> CGCGTACTGAAGCGGGTGGC
GAAAAGCGCTCCACGATCGA -> AGAAAAGCGCTCCACGATCG
ATTGACACTGCCGCCCTAAC -> AATTGACACTGCCGCCCTAA
CCGACATAAGCACGGAGTGC -> ACCGACATAAGCACGGAGTG
TGCCCGCTAAATGTCACTTT -> TTGCCCGCTAAATGTCACTT
GTCGAAGAAGCATCTGAATT -> TGTCGAAGAAGCATCTGAAT
CAACAGTTGATTCCTGTACT -> GCAACAGTTGATTCCTGTAC
CCGGTAGAATTAGGTTCTGC -> GCCGGTAGAATTAGGTTCTG
TCCTACTAGGCCTCCCGGCC -> TTCCTACTAGGCCTCCCGGC
CTCCTTGATCTTCCTACTAG -> ACTCCTTGATCTTCCTACTA
TGGGTCCTGTTTTTCTGCTC -> TTGGGTCCTGTTTTTCTGCT
GTCATTTATCTCGATGGCTT -> AGTCATTTATCTCGATGGCT
TTGGCTCCGCGTGCCTCCTC -> CTTGGCTCCGCGTGCCTCCT
GCAACAGTTGATTCCTGTAC -> CGCAACAGTTGATTCCTGTA
TTTACGAGCCGATTAGATCA -> CTTTACGAGCCGATTAGATC
ACTAGGCCTCCCGGCCCCCA -> TACTAGGCCTCCCGGCCCCC
GATGGGTTCCGACGTTCTAC -> AGATGGGTTCCGACGTTCTA
GCTAACGGTCGTATTCTCGG -> AGCTAACGGTCGTATTCTCG
CGAGCATTGACTACGCAACA -> GCGAGCATTGACTACGCAAC
GACTACGCAACAGTTGATTC -> TGACTACGCAACAGTTGATT
CCTTTGGGTCCTGTTTTTCT -> GCCTTTGGGTCCTGTTTTTC
CGCTTGGCTCCGCGTGCCTC -> GCGCTTGGCTCCGCGTGCCT
GCATAGTTTGCCCTATTCTG -> TGCATAGTTTGCCCTATTCT
TTTACCTTTACGAGCCGATT -> CTTTACCTTTACGAGCCGAT
TAAATGTCACTTTCGCTGAC -> CTAAATGTCACTTTCGCTGA
ACGTTTCTTCTAGCGCTTGG -> GACGTTTCTTCTAGCGCTTG
AAGTGCCGGTAGAATTAGGT -> AAAGTGCCGGTAGAATTAGG
CACTGCCGCCCTAACAGGGC -> ACACTGCCGCCCTAACAGGG
CGTATTCTCGGTTGCGGCAG -> TCGTATTCTCGGTTGCGGCA
CAGGTTAGGATAGGACGTTT -> CCAGGTTAGGATAGGACGTT
CGCTTCACACTACAGGATCT -> GCGCTTCACACTACAGGATC
CCTTTACCTTTACGAGCCGA -> TCCTTTACCTTTACGAGCCG
GGGCCTAGACAGTCATTTAT -> CGGGCCTAGACAGTCATTTA
CTCGCTAGGATTATAATGCA -> GCTCGCTAGGATTATAATGC
TAGGTTCTGCTGCGCTCGCG -> TTAGGTTCTGCTGCGCTCGC
GTGTGTCGGTAAGGGTGTTG -> AGTGTGTCGGTAAGGGTGTT
GTTTTTCTGCTCAGACGAAC -> TGTTTTTCTGCTCAGACGAA
GCTCGCTAGGATTATAATGC -> CGCTCGCTAGGATTATAATG
TCATATTTGGGTCCTCCGTC -> ATCATATTTGGGTCCTCCGT
CCGGCACCCCGCCTGACGAA -> TCCGGCACCCCGCCTGACGA
GGTTCCGACGTTCTACACAA -> GGGTTCCGACGTTCTACACA
CATTCGACGCATAGCTCGCG -> TCATTCGACGCATAGCTCGC
TGAGAGGCGACCACTCCTTG -> GTGAGAGGCGACCACTCCTT
TCTCGATGGCTTCTACCGCC -> ATCTCGATGGCTTCTACCGC
AATATAAGGACCTTCCGGCA -> AAATATAAGGACCTTCCGGC
CGGCAGTGACGTGGGCGATT -> GCGGCAGTGACGTGGGCGAT
ATTGATCTCGAGAGCTAACG -> CATTGATCTCGAGAGCTAAC
ATGGGTTCCGACGTTCTACA -> GATGGGTTCCGACGTTCTAC
TTTGCCCTATTCTGGTTTGT -> GTTTGCCCTATTCTGGTTTG
AGTGTGTCGGTAAGGGTGTT -> CAGTGTGTCGGTAAGGGTGT
ATTCTCCAACGTGAGGAAGT -> GATTCTCCAACGTGAGGAAG
CTACGCAACAGTTGATTCCT -> ACTACGCAACAGTTGATTCC
GTTCTGCTGCGCTCGCGTAC -> GGTTCTGCTGCGCTCGCGTA
GCGCCCTGGCCTTCTAGCTT -> CGCGCCCTGGCCTTCTAGCT
TGTCACTTTCGCTGACCCAT -> ATGTCACTTTCGCTGACCCA
CAGTCCTGATGTAGTCTGGT -> ACAGTCCTGATGTAGTCTGG
TGCCTCCTCTTGTTAAAATA -> GTGCCTCCTCTTGTTAAAAT
TTGACTACGCAACAGTTGAT -> ATTGACTACGCAACAGTTGA
GACAGTCATTTATCTCGATG -> AGACAGTCATTTATCTCGAT
GACGAACGACCTGTATTGGT -> AGACGAACGACCTGTATTGG
GATGTAGTCTGGTAAAAATG -> TGATGTAGTCTGGTAAAAAT
CTTTGGCGAGCATTGACTAC -> ACTTTGGCGAGCATTGACTA
ACCTGTATTGGTGGTTAAAT -> GACCTGTATTGGTGGTTAAA
TCACCACTAGTTCTGAACCG -> CTCACCACTAGTTCTGAACC
CTCCTTTACCTTTACGAGCC -> GCTCCTTTACCTTTACGAGC
AGCCCCGGTGCGGTGAGAGG -> GAGCCCCGGTGCGGTGAGAG
GGCTCCTTTACCTTTACGAG -> GGGCTCCTTTACCTTTACGA
ACTCATTGCCCGCTAAATGT -> GACTCATTGCCCGCTAAATG
GGAGCCCCGGTGCGGTGAGA -> CGGAGCCCCGGTGCGGTGAG
TGGAAGCATATTTCGGCGCA -> ATGGAAGCATATTTCGGCGC
CGACGTTCTACACAACTTTG -> CCGACGTTCTACACAACTTT
GGTTTGTAGAAAAGCGCTCC -> TGGTTTGTAGAAAAGCGCTC
GAAGCGGGTGGCACTCGCTC -> TGAAGCGGGTGGCACTCGCT
ATGGAAGCATATTTCGGCGC -> AATGGAAGCATATTTCGGCG
TTCATTGATCTCGAGAGCTA -> GTTCATTGATCTCGAGAGCT
GCCGGGCGACACCAGGTTAG -> TGCCGGGCGACACCAGGTTA
ACCGGTCGGAGCCCCGGTGC -> TACCGGTCGGAGCCCCGGTG
CCTGATGTAGTCTGGTAAAA -> TCCTGATGTAGTCTGGTAAA
ACAACTTTGGCGAGCATTGA -> CACAACTTTGGCGAGCATTG
ACGCAACAGTTGATTCCTGT -> TACGCAACAGTTGATTCCTG
CATATTTGGGTCCTCCGTCA -> TCATATTTGGGTCCTCCGTC
GAGACAGACCAATCATATTT -> CGAGACAGACCAATCATATT
CTCGGTTGCGGCAGTGACGT -> TCTCGGTTGCGGCAGTGACG
TTGTTAAAATATAAGGACCT -> CTTGTTAAAATATAAGGACC
TGGTTTGTAGAAAAGCGCTC -> CTGGTTTGTAGAAAAGCGCT
CCTTGATCTTCCTACTAGGC -> TCCTTGATCTTCCTACTAGG
TTATCTCGATGGCTTCTACC -> TTTATCTCGATGGCTTCTAC
GCACTCTCACCACTAGTTCT -> GGCACTCTCACCACTAGTTC
TTTATCTCGATGGCTTCTAC -> ATTTATCTCGATGGCTTCTA
TTGCCCGCTAAATGTCACTT -> ATTGCCCGCTAAATGTCACT
CACTACAGGATCTACAGTCC -> ACACTACAGGATCTACAGTC
AAAGACTACCGACATAAGCA -> AAAAGACTACCGACATAAGC
CTACAGTCCTGATGTAGTCT -> TCTACAGTCCTGATGTAGTC
TCAGTGTGTCGGTAAGGGTG -> ATCAGTGTGTCGGTAAGGGT
TAGAAAAGCGCTCCACGATC -> GTAGAAAAGCGCTCCACGAT
TACTTTACGCGCCCTGGCCT -> GTACTTTACGCGCCCTGGCC
ATTTATCTCGATGGCTTCTA -> CATTTATCTCGATGGCTTCT
ACCTTCCGGCACCCCGCCTG -> GACCTTCCGGCACCCCGCCT
TCGACGCATAGCTCGCGCGT -> TTCGACGCATAGCTCGCGCG
TCTACAGTCCTGATGTAGTC -> ATCTACAGTCCTGATGTAGT
TCGAAGACAGGGACTAAGCT -> CTCGAAGACAGGGACTAAGC
TATTCTCGGTTGCGGCAGTG -> GTATTCTCGGTTGCGGCAGT
CCGACGTTCTACACAACTTT -> TCCGACGTTCTACACAACTT
ACGTGGGCGATTCTCCAACG -> GACGTGGGCGATTCTCCAAC
AGACAGACCAATCATATTTG -> GAGACAGACCAATCATATTT
ACTGAAGCGGGTGGCACTCG -> TACTGAAGCGGGTGGCACTC
CCGATTAGATCAGTGTGTCG -> GCCGATTAGATCAGTGTGTC
GAAGCATATTTCGGCGCAAG -> GGAAGCATATTTCGGCGCAA
GTTAAAATATAAGGACCTTC -> TGTTAAAATATAAGGACCTT
GGCTTCTACCGCCAACACAC -> TGGCTTCTACCGCCAACACA
TTAGATCAGTGTGTCGGTAA -> ATTAGATCAGTGTGTCGGTA
AGCGCTTCACACTACAGGAT -> TAGCGCTTCACACTACAGGA
GTCGGTAAGGGTGTTGACTC -> TGTCGGTAAGGGTGTTGACT
GACACCAGGTTAGGATAGGA -> CGACACCAGGTTAGGATAGG
CTAGCTTGCGGTCCAGTTAC -> TCTAGCTTGCGGTCCAGTTA
TTGACTCATTGCCCGCTAAA -> GTTGACTCATTGCCCGCTAA
GTCTGGTAAAAATGGAAGCA -> AGTCTGGTAAAAATGGAAGC
GCTCCACGATCGACGACGCT -> CGCTCCACGATCGACGACGC
CGCTCGCGTACTGAAGCGGG -> GCGCTCGCGTACTGAAGCGG
CTCCCGGCCCCCAACGTTCA -> CCTCCCGGCCCCCAACGTTC
ACGCATAGCTCGCGCGTGTC -> GACGCATAGCTCGCGCGTGT
TGGGCGATTCTCCAACGTGA -> GTGGGCGATTCTCCAACGTG
TCCAGTTACCGGTCGGAGCC -> GTCCAGTTACCGGTCGGAGC
CTGTATTGGTGGTTAAATCG -> CCTGTATTGGTGGTTAAATC
AGAGGCGACCACTCCTTGAT -> GAGAGGCGACCACTCCTTGA
GACAGGGACTAAGCTAACGT -> AGACAGGGACTAAGCTAACG
AATGCAATACGCGAGACAGA -> TAATGCAATACGCGAGACAG
CGACATAAGCACGGAGTGCC -> CCGACATAAGCACGGAGTGC
GCGGTCCAGTTACCGGTCGG -> TGCGGTCCAGTTACCGGTCG
AAGACAGGGACTAAGCTAAC -> GAAGACAGGGACTAAGCTAA
CCTGTATTGGTGGTTAAATC -> ACCTGTATTGGTGGTTAAAT
TTAGATGGGTTCCGACGTTC -> CTTAGATGGGTTCCGACGTT
GCTCGAAGACAGGGACTAAG -> CGCTCGAAGACAGGGACTAA
AATCGCTCGCTAGGATTATA -> AAATCGCTCGCTAGGATTAT
CCGCTCATTCGACGCATAGC -> TCCGCTCATTCGACGCATAG
CTAACGTCATGCCTTTGGGT -> GCTAACGTCATGCCTTTGGG
CTAAGCTAACGTCATGCCTT -> ACTAAGCTAACGTCATGCCT
TGGTAAAAATGGAAGCATAT -> CTGGTAAAAATGGAAGCATA
ATTCTCGGTTGCGGCAGTGA -> TATTCTCGGTTGCGGCAGTG
AGAAAAGCGCTCCACGATCG -> TAGAAAAGCGCTCCACGATC
GCTAACGTCATGCCTTTGGG -> AGCTAACGTCATGCCTTTGG
GCTCAGACGAACGACCTGTA -> TGCTCAGACGAACGACCTGT
CGTACTGAAGCGGGTGGCAC -> GCGTACTGAAGCGGGTGGCA
AACGTTCATTGATCTCGAGA -> CAACGTTCATTGATCTCGAG
ATCTACAGTCCTGATGTAGT -> GATCTACAGTCCTGATGTAG
CCACTCCTTGATCTTCCTAC -> ACCACTCCTTGATCTTCCTA
CCTCCGTCAGATTGGGAGGT -> TCCTCCGTCAGATTGGGAGG
CTGCATAGTTTGCCCTATTC -> CCTGCATAGTTTGCCCTATT
CGATCGACGACGCTCGAAGA -> ACGATCGACGACGCTCGAAG
TCTAGCGCTTGGCTCCGCGT -> TTCTAGCGCTTGGCTCCGCG
TAGGCCTCCCGGCCCCCAAC -> CTAGGCCTCCCGGCCCCCAA
TCTCACCACTAGTTCTGAAC -> CTCTCACCACTAGTTCTGAA
ATCTTCCTACTAGGCCTCCC -> GATCTTCCTACTAGGCCTCC
CCGGGCCTAGACAGTCATTT -> ACCGGGCCTAGACAGTCATT
GAGGAAGTCTAGCGCTTCAC -> TGAGGAAGTCTAGCGCTTCA
GTATTCTCGGTTGCGGCAGT -> CGTATTCTCGGTTGCGGCAG
GAGGCGACCACTCCTTGATC -> AGAGGCGACCACTCCTTGAT
GCCGGTAGAATTAGGTTCTG -> TGCCGGTAGAATTAGGTTCT
CTTGTTAAAATATAAGGACC -> TCTTGTTAAAATATAAGGAC
CGTTTCTTCTAGCGCTTGGC -> ACGTTTCTTCTAGCGCTTGG
GCGAGCATTGACTACGCAAC -> GGCGAGCATTGACTACGCAA
CTGAACCGGGCCTAGACAGT -> TCTGAACCGGGCCTAGACAG
GACCTGTATTGGTGGTTAAA -> CGACCTGTATTGGTGGTTAA
TGTCGAAGAAGCATCTGAAT -> GTGTCGAAGAAGCATCTGAA
ACCTGCATAGTTTGCCCTAT -> CACCTGCATAGTTTGCCCTA
GAACGACCTGTATTGGTGGT -> CGAACGACCTGTATTGGTGG
TAACAGGGCTCCTTTACCTT -> CTAACAGGGCTCCTTTACCT
CGCGCGTGTCGAAGAAGCAT -> TCGCGCGTGTCGAAGAAGCA
AACGTGAGGAAGTCTAGCGC -> CAACGTGAGGAAGTCTAGCG
CACTAGTTCTGAACCGGGCC -> CCACTAGTTCTGAACCGGGC
TCAGATTGGGAGGTGTCGGG -> GTCAGATTGGGAGGTGTCGG
ATTGCCCGCTAAATGTCACT -> CATTGCCCGCTAAATGTCAC
ACGCGAGACAGACCAATCAT -> TACGCGAGACAGACCAATCA
GCGCGTGTCGAAGAAGCATC -> CGCGCGTGTCGAAGAAGCAT
ACACTACAGGATCTACAGTC -> CACACTACAGGATCTACAGT
CTAAATGTCACTTTCGCTGA -> GCTAAATGTCACTTTCGCTG
TAAAAATGGAAGCATATTTC -> GTAAAAATGGAAGCATATTT
ATGCAATACGCGAGACAGAC -> AATGCAATACGCGAGACAGA
GCACGGAGTGCCGGGCGACA -> AGCACGGAGTGCCGGGCGAC
TGATCTTCCTACTAGGCCTC -> TTGATCTTCCTACTAGGCCT
CGTGCCTCCTCTTGTTAAAA -> GCGTGCCTCCTCTTGTTAAA
TACAGTCCTGATGTAGTCTG -> CTACAGTCCTGATGTAGTCT
ACACCAGGTTAGGATAGGAC -> GACACCAGGTTAGGATAGGA
GAAAGTGCCGGTAGAATTAG -> GGAAAGTGCCGGTAGAATTA
TGGTTAAATCGCTCGCTAGG -> GTGGTTAAATCGCTCGCTAG
CAATCATATTTGGGTCCTCC -> CCAATCATATTTGGGTCCTC
CTCAGACGAACGACCTGTAT -> GCTCAGACGAACGACCTGTA
TCTTCCTACTAGGCCTCCCG -> ATCTTCCTACTAGGCCTCCC
TTACCGGTCGGAGCCCCGGT -> GTTACCGGTCGGAGCCCCGG
TCCTTGATCTTCCTACTAGG -> CTCCTTGATCTTCCTACTAG
TGTAGTCTGGTAAAAATGGA -> ATGTAGTCTGGTAAAAATGG
ATCGCTCGCTAGGATTATAA -> AATCGCTCGCTAGGATTATA
CGGTTGCGGCAGTGACGTGG -> TCGGTTGCGGCAGTGACGTG
CACGGAGTGCCGGGCGACAC -> GCACGGAGTGCCGGGCGACA
CCGGGCGACACCAGGTTAGG -> GCCGGGCGACACCAGGTTAG
ATCTCGAGAGCTAACGGTCG -> GATCTCGAGAGCTAACGGTC
GAGCCCCGGTGCGGTGAGAG -> GGAGCCCCGGTGCGGTGAGA
CGCTAGGATTATAATGCAAT -> TCGCTAGGATTATAATGCAA
GATGCGTTAGCTTACGGGCG -> TGATGCGTTAGCTTACGGGC
GCTAAATGTCACTTTCGCTG -> CGCTAAATGTCACTTTCGCT
CTAGACAGTCATTTATCTCG -> CCTAGACAGTCATTTATCTC
TAGTTCTGAACCGGGCCTAG -> CTAGTTCTGAACCGGGCCTA
AACACACCTGCATAGTTTGC -> CAACACACCTGCATAGTTTG
CTGAAGCGGGTGGCACTCGC -> ACTGAAGCGGGTGGCACTCG
CTCGCGCGTGTCGAAGAAGC -> GCTCGCGCGTGTCGAAGAAG
GCCTCCTCTTGTTAAAATAT -> TGCCTCCTCTTGTTAAAATA
GGTCGTATTCTCGGTTGCGG -> CGGTCGTATTCTCGGTTGCG
CGACCTGTATTGGTGGTTAA -> ACGACCTGTATTGGTGGTTA
GCCCTGGCCTTCTAGCTTGC -> CGCCCTGGCCTTCTAGCTTG
GGTCGGAGCCCCGGTGCGGT -> CGGTCGGAGCCCCGGTGCGG
GACGCATAGCTCGCGCGTGT -> CGACGCATAGCTCGCGCGTG
TACGCGAGACAGACCAATCA -> ATACGCGAGACAGACCAATC
GAATTAGGTTCTGCTGCGCT -> AGAATTAGGTTCTGCTGCGC
TCTCCAACGTGAGGAAGTCT -> TTCTCCAACGTGAGGAAGTC
AGCTAACGGTCGTATTCTCG -> GAGCTAACGGTCGTATTCTC
ATGATCCGCTCATTCGACGC -> GATGATCCGCTCATTCGACG
TTAAATCGCTCGCTAGGATT -> GTTAAATCGCTCGCTAGGAT
ACTCTCACCACTAGTTCTGA -> CACTCTCACCACTAGTTCTG
GAGGTGTCGGGATGATCCGC -> GGAGGTGTCGGGATGATCCG
GTGCCGGGCGACACCAGGTT -> AGTGCCGGGCGACACCAGGT
GTAGAAAAGCGCTCCACGAT -> TGTAGAAAAGCGCTCCACGA
AAGACTACCGACATAAGCAC -> AAAGACTACCGACATAAGCA
CATTGACTACGCAACAGTTG -> GCATTGACTACGCAACAGTT
TCTACCGCCAACACACCTGC -> TTCTACCGCCAACACACCTG
ACGAGCCGATTAGATCAGTG -> TACGAGCCGATTAGATCAGT
GGATAGGACGTTTCTTCTAG -> AGGATAGGACGTTTCTTCTA
AGGGACTAAGCTAACGTCAT -> CAGGGACTAAGCTAACGTCA
GGCACTCTCACCACTAGTTC -> CGGCACTCTCACCACTAGTT
TAGCTCGCGCGTGTCGAAGA -> ATAGCTCGCGCGTGTCGAAG
CACTCTCACCACTAGTTCTG -> GCACTCTCACCACTAGTTCT
CTTTACGAGCCGATTAGATC -> CCTTTACGAGCCGATTAGAT
ACCTTTACGAGCCGATTAGA -> TACCTTTACGAGCCGATTAG
TGGTGGTTAAATCGCTCGCT -> TTGGTGGTTAAATCGCTCGC
TTCTCGGTTGCGGCAGTGAC -> ATTCTCGGTTGCGGCAGTGA
TTCTACCGCCAACACACCTG -> CTTCTACCGCCAACACACCT
TTAGCTTACGGGCGGCACTC -> GTTAGCTTACGGGCGGCACT
GACTAAGCTAACGTCATGCC -> GGACTAAGCTAACGTCATGC
ACACCTGCATAGTTTGCCCT -> CACACCTGCATAGTTTGCCC
AGCTCGCGCGTGTCGAAGAA -> TAGCTCGCGCGTGTCGAAGA
CGACGCATAGCTCGCGCGTG -> TCGACGCATAGCTCGCGCGT
GTCGGAGCCCCGGTGCGGTG -> GGTCGGAGCCCCGGTGCGGT
GCAATACGCGAGACAGACCA -> TGCAATACGCGAGACAGACC
GTGGCACTCGCTCTTAGATG -> GGTGGCACTCGCTCTTAGAT
AAGTCTAGCGCTTCACACTA -> GAAGTCTAGCGCTTCACACT
TCTCGGTTGCGGCAGTGACG -> TTCTCGGTTGCGGCAGTGAC
GTGCCGGTAGAATTAGGTTC -> AGTGCCGGTAGAATTAGGTT
CGGAGCCCCGGTGCGGTGAG -> TCGGAGCCCCGGTGCGGTGA
GCGACACCAGGTTAGGATAG -> GGCGACACCAGGTTAGGATA
AGTCCTGATGTAGTCTGGTA -> CAGTCCTGATGTAGTCTGGT
CTACTAGGCCTCCCGGCCCC -> CCTACTAGGCCTCCCGGCCC
TAGCGCTTCACACTACAGGA -> CTAGCGCTTCACACTACAGG
TCGATGGCTTCTACCGCCAA -> CTCGATGGCTTCTACCGCCA
TTTGGGTCCTCCGTCAGATT -> ATTTGGGTCCTCCGTCAGAT
ACAGGGACTAAGCTAACGTC -> GACAGGGACTAAGCTAACGT
AGACAGTCATTTATCTCGAT -> TAGACAGTCATTTATCTCGA
GGGCGACACCAGGTTAGGAT -> CGGGCGACACCAGGTTAGGA
TTCCTGTACTTTACGCGCCC -> ATTCCTGTACTTTACGCGCC
CACACTACAGGATCTACAGT -> TCACACTACAGGATCTACAG
CCTGTTTTTCTGCTCAGACG -> TCCTGTTTTTCTGCTCAGAC
GGCGATTCTCCAACGTGAGG -> GGGCGATTCTCCAACGTGAG
ATATAAGGACCTTCCGGCAC -> AATATAAGGACCTTCCGGCA
CTCGCGTACTGAAGCGGGTG -> GCTCGCGTACTGAAGCGGGT
CCTTCTAGCTTGCGGTCCAG -> GCCTTCTAGCTTGCGGTCCA
AGGTTCTGCTGCGCTCGCGT -> TAGGTTCTGCTGCGCTCGCG
ATGCGTTAGCTTACGGGCGG -> GATGCGTTAGCTTACGGGCG
TATTGGTGGTTAAATCGCTC -> GTATTGGTGGTTAAATCGCT
TTGCGGCAGTGACGTGGGCG -> GTTGCGGCAGTGACGTGGGC
CGCCAACACACCTGCATAGT -> CCGCCAACACACCTGCATAG
ACGTTCTACACAACTTTGGC -> GACGTTCTACACAACTTTGG
TGCCGGGCGACACCAGGTTA -> GTGCCGGGCGACACCAGGTT
CTGACCCATCACCCCTGGAA -> GCTGACCCATCACCCCTGGA
CGGGCGACACCAGGTTAGGA -> CCGGGCGACACCAGGTTAGG
CAGTGACGTGGGCGATTCTC -> GCAGTGACGTGGGCGATTCT
GACCAATCATATTTGGGTCC -> AGACCAATCATATTTGGGTC
GGCGACCACTCCTTGATCTT -> AGGCGACCACTCCTTGATCT
TCCGTCAGATTGGGAGGTGT -> CTCCGTCAGATTGGGAGGTG
TCGGTTGCGGCAGTGACGTG -> CTCGGTTGCGGCAGTGACGT
CAGTCATTTATCTCGATGGC -> ACAGTCATTTATCTCGATGG
TGACGTGGGCGATTCTCCAA -> GTGACGTGGGCGATTCTCCA
GGATGATCCGCTCATTCGAC -> GGGATGATCCGCTCATTCGA
GGAAGCATATTTCGGCGCAA -> TGGAAGCATATTTCGGCGCA
CCCTATTCTGGTTTGTAGAA -> GCCCTATTCTGGTTTGTAGA
CGGGTGGCACTCGCTCTTAG -> GCGGGTGGCACTCGCTCTTA
CTTCTACCGCCAACACACCT -> GCTTCTACCGCCAACACACC
CCACTAGTTCTGAACCGGGC -> ACCACTAGTTCTGAACCGGG
GTAGAATTAGGTTCTGCTGC -> GGTAGAATTAGGTTCTGCTG
AGTTCTGAACCGGGCCTAGA -> TAGTTCTGAACCGGGCCTAG
CCCAACGTTCATTGATCTCG -> CCCCAACGTTCATTGATCTC
CAACGTTCATTGATCTCGAG -> CCAACGTTCATTGATCTCGA
CCTTCCGGCACCCCGCCTGA -> ACCTTCCGGCACCCCGCCTG
TAGATCAGTGTGTCGGTAAG -> TTAGATCAGTGTGTCGGTAA
ATAGCTCGCGCGTGTCGAAG -> CATAGCTCGCGCGTGTCGAA
TTGATTCCTGTACTTTACGC -> GTTGATTCCTGTACTTTACG
GCTCCGCGTGCCTCCTCTTG -> GGCTCCGCGTGCCTCCTCTT
TTAGGTTCTGCTGCGCTCGC -> ATTAGGTTCTGCTGCGCTCG
ATAATGCAATACGCGAGACA -> TATAATGCAATACGCGAGAC
TCTGAACCGGGCCTAGACAG -> TTCTGAACCGGGCCTAGACA
CTACCGCCAACACACCTGCA -> TCTACCGCCAACACACCTGC
TTGCGGTCCAGTTACCGGTC -> CTTGCGGTCCAGTTACCGGT
TGCGCTCGCGTACTGAAGCG -> CTGCGCTCGCGTACTGAAGC
GCATCTGAATTGACACTGCC -> AGCATCTGAATTGACACTGC
TTGGGTCCTGTTTTTCTGCT -> TTTGGGTCCTGTTTTTCTGC
ACGCGCCCTGGCCTTCTAGC -> TACGCGCCCTGGCCTTCTAG
GCGTGTCGAAGAAGCATCTG -> CGCGTGTCGAAGAAGCATCT
CCCCAACGTTCATTGATCTC -> CCCCCAACGTTCATTGATCT
CAGTGTGTCGGTAAGGGTGT -> TCAGTGTGTCGGTAAGGGTG
GAGGCAAAAAGACTACCGAC -> AGAGGCAAAAAGACTACCGA
AGAATTAGGTTCTGCTGCGC -> TAGAATTAGGTTCTGCTGCG
AGGGTGTTGACTCATTGCCC -> AAGGGTGTTGACTCATTGCC
CCCCGGTGCGGTGAGAGGCG -> GCCCCGGTGCGGTGAGAGGC
TGCGGCAGTGACGTGGGCGA -> TTGCGGCAGTGACGTGGGCG
TCGGCGCAAGAGGCAAAAAG -> TTCGGCGCAAGAGGCAAAAA
TCTGCTGCGCTCGCGTACTG -> TTCTGCTGCGCTCGCGTACT
ACAGGATCTACAGTCCTGAT -> TACAGGATCTACAGTCCTGA
CGTGTCGAAGAAGCATCTGA -> GCGTGTCGAAGAAGCATCTG
CGATTCTCCAACGTGAGGAA -> GCGATTCTCCAACGTGAGGA
TCTTAGATGGGTTCCGACGT -> CTCTTAGATGGGTTCCGACG
TAAAATATAAGGACCTTCCG -> TTAAAATATAAGGACCTTCC
ACTTTGGCGAGCATTGACTA -> AACTTTGGCGAGCATTGACT
TTGACACTGCCGCCCTAACA -> ATTGACACTGCCGCCCTAAC
TCGAAGAAGCATCTGAATTG -> GTCGAAGAAGCATCTGAATT
TGTCGGGATGATCCGCTCAT -> GTGTCGGGATGATCCGCTCA
TAACGGTCGTATTCTCGGTT -> CTAACGGTCGTATTCTCGGT
CGACCACTCCTTGATCTTCC -> GCGACCACTCCTTGATCTTC
CGGTCGGAGCCCCGGTGCGG -> CCGGTCGGAGCCCCGGTGCG
CCAACACACCTGCATAGTTT -> GCCAACACACCTGCATAGTT
GCCGCCCTAACAGGGCTCCT -> TGCCGCCCTAACAGGGCTCC
GCGGCAGTGACGTGGGCGAT -> TGCGGCAGTGACGTGGGCGA
AGCTAACGTCATGCCTTTGG -> AAGCTAACGTCATGCCTTTG
TTGGGTCCTCCGTCAGATTG -> TTTGGGTCCTCCGTCAGATT
AAAGTGCCGGTAGAATTAGG -> GAAAGTGCCGGTAGAATTAG
CACCTGCATAGTTTGCCCTA -> ACACCTGCATAGTTTGCCCT
CGTCATGCCTTTGGGTCCTG -> ACGTCATGCCTTTGGGTCCT
CAGGGACTAAGCTAACGTCA -> ACAGGGACTAAGCTAACGTC
AACTTTGGCGAGCATTGACT -> CAACTTTGGCGAGCATTGAC
AGGAAGTCTAGCGCTTCACA -> GAGGAAGTCTAGCGCTTCAC
CTAACGGTCGTATTCTCGGT -> GCTAACGGTCGTATTCTCGG
TTTCTTCTAGCGCTTGGCTC -> GTTTCTTCTAGCGCTTGGCT
TCACCCCTGGAAAGTGCCGG -> ATCACCCCTGGAAAGTGCCG
ATTGACTACGCAACAGTTGA -> CATTGACTACGCAACAGTTG
TGACACTGCCGCCCTAACAG -> TTGACACTGCCGCCCTAACA
CTGCGCTCGCGTACTGAAGC -> GCTGCGCTCGCGTACTGAAG
GATTATAATGCAATACGCGA -> GGATTATAATGCAATACGCG
GGCGACACCAGGTTAGGATA -> GGGCGACACCAGGTTAGGAT
CGCTCTTAGATGGGTTCCGA -> TCGCTCTTAGATGGGTTCCG
TTACGGGCGGCACTCTCACC -> CTTACGGGCGGCACTCTCAC
CTTTCGCTGACCCATCACCC -> ACTTTCGCTGACCCATCACC
TGTGTCGGTAAGGGTGTTGA -> GTGTGTCGGTAAGGGTGTTG
TTCTGCTGCGCTCGCGTACT -> GTTCTGCTGCGCTCGCGTAC
AAATGTCACTTTCGCTGACC -> TAAATGTCACTTTCGCTGAC
GGTTAAATCGCTCGCTAGGA -> TGGTTAAATCGCTCGCTAGG
GTCCTGTTTTTCTGCTCAGA -> GGTCCTGTTTTTCTGCTCAG
TTATAATGCAATACGCGAGA -> ATTATAATGCAATACGCGAG
AAGCGGGTGGCACTCGCTCT -> GAAGCGGGTGGCACTCGCTC
GATAGGACGTTTCTTCTAGC -> GGATAGGACGTTTCTTCTAG
CTGGAAAGTGCCGGTAGAAT -> CCTGGAAAGTGCCGGTAGAA
AGGATAGGACGTTTCTTCTA -> TAGGATAGGACGTTTCTTCT
GTGCCTCCTCTTGTTAAAAT -> CGTGCCTCCTCTTGTTAAAA
CTCGCTCTTAGATGGGTTCC -> ACTCGCTCTTAGATGGGTTC
TACTGAAGCGGGTGGCACTC -> GTACTGAAGCGGGTGGCACT
GGGTGTTGACTCATTGCCCG -> AGGGTGTTGACTCATTGCCC
TGAGGAAGTCTAGCGCTTCA -> GTGAGGAAGTCTAGCGCTTC
GTCTAGCGCTTCACACTACA -> AGTCTAGCGCTTCACACTAC
GCTGACCCATCACCCCTGGA -> CGCTGACCCATCACCCCTGG
GCCTTTGGGTCCTGTTTTTC -> TGCCTTTGGGTCCTGTTTTT
TCCGACGTTCTACACAACTT -> TTCCGACGTTCTACACAACT
TCAGACGAACGACCTGTATT -> CTCAGACGAACGACCTGTAT
AGGGCTCCTTTACCTTTACG -> CAGGGCTCCTTTACCTTTAC
GCGGCACTCTCACCACTAGT -> GGCGGCACTCTCACCACTAG
CCGGTGCGGTGAGAGGCGAC -> CCCGGTGCGGTGAGAGGCGA
CGGGCGGCACTCTCACCACT -> ACGGGCGGCACTCTCACCAC
TTTGTAGAAAAGCGCTCCAC -> GTTTGTAGAAAAGCGCTCCA
TAACGTCATGCCTTTGGGTC -> CTAACGTCATGCCTTTGGGT
GGTGTCGGGATGATCCGCTC -> AGGTGTCGGGATGATCCGCT
CCAATCATATTTGGGTCCTC -> ACCAATCATATTTGGGTCCT
CATTGCCCGCTAAATGTCAC -> TCATTGCCCGCTAAATGTCA
GTTTGCCCTATTCTGGTTTG -> AGTTTGCCCTATTCTGGTTT
CTACAGGATCTACAGTCCTG -> ACTACAGGATCTACAGTCCT
CGCGTGCCTCCTCTTGTTAA -> CCGCGTGCCTCCTCTTGTTA
GCGCTTGGCTCCGCGTGCCT -> AGCGCTTGGCTCCGCGTGCC
GTGTCGGGATGATCCGCTCA -> GGTGTCGGGATGATCCGCTC
ATCTGAATTGACACTGCCGC -> CATCTGAATTGACACTGCCG
GGTGCGGTGAGAGGCGACCA -> CGGTGCGGTGAGAGGCGACC
AAAAAGACTACCGACATAAG -> CAAAAAGACTACCGACATAA
CTGTACTTTACGCGCCCTGG -> CCTGTACTTTACGCGCCCTG
TGCCGCCCTAACAGGGCTCC -> CTGCCGCCCTAACAGGGCTC
CGAGACAGACCAATCATATT -> GCGAGACAGACCAATCATAT
TAGTTTGCCCTATTCTGGTT -> ATAGTTTGCCCTATTCTGGT
CATAGTTTGCCCTATTCTGG -> GCATAGTTTGCCCTATTCTG
TTGATCTTCCTACTAGGCCT -> CTTGATCTTCCTACTAGGCC
CTTCCGGCACCCCGCCTGAC -> CCTTCCGGCACCCCGCCTGA
CGGGATGATCCGCTCATTCG -> TCGGGATGATCCGCTCATTC
AAGCGCTCCACGATCGACGA -> AAAGCGCTCCACGATCGACG
CCATCACCCCTGGAAAGTGC -> CCCATCACCCCTGGAAAGTG
CACCCCTGGAAAGTGCCGGT -> TCACCCCTGGAAAGTGCCGG
AAAAGCGCTCCACGATCGAC -> GAAAAGCGCTCCACGATCGA
TGGGAGGTGTCGGGATGATC -> TTGGGAGGTGTCGGGATGAT
GTGGGCGATTCTCCAACGTG -> CGTGGGCGATTCTCCAACGT
ACAGACCAATCATATTTGGG -> GACAGACCAATCATATTTGG
GTTCTGAACCGGGCCTAGAC -> AGTTCTGAACCGGGCCTAGA
ATTTGGGTCCTCCGTCAGAT -> TATTTGGGTCCTCCGTCAGA
CGGTCGTATTCTCGGTTGCG -> ACGGTCGTATTCTCGGTTGC
GTTGCGGCAGTGACGTGGGC -> GGTTGCGGCAGTGACGTGGG
CCGGTCGGAGCCCCGGTGCG -> ACCGGTCGGAGCCCCGGTGC
CGCTCATTCGACGCATAGCT -> CCGCTCATTCGACGCATAGC
GGTCCTGTTTTTCTGCTCAG -> GGGTCCTGTTTTTCTGCTCA
CGTTAGCTTACGGGCGGCAC -> GCGTTAGCTTACGGGCGGCA
TTACGCGCCCTGGCCTTCTA -> TTTACGCGCCCTGGCCTTCT
GATTGGGAGGTGTCGGGATG -> AGATTGGGAGGTGTCGGGAT
CAATACGCGAGACAGACCAA -> GCAATACGCGAGACAGACCA
CGATGGCTTCTACCGCCAAC -> TCGATGGCTTCTACCGCCAA
CTAGCGCTTGGCTCCGCGTG -> TCTAGCGCTTGGCTCCGCGT
TTCTACACAACTTTGGCGAG -> GTTCTACACAACTTTGGCGA
TCGCTCGCTAGGATTATAAT -> ATCGCTCGCTAGGATTATAA
TCCGCTCATTCGACGCATAG -> ATCCGCTCATTCGACGCATA
ATTATAATGCAATACGCGAG -> GATTATAATGCAATACGCGA
ACTCCTTGATCTTCCTACTA -> CACTCCTTGATCTTCCTACT
GGTCCTCCGTCAGATTGGGA -> GGGTCCTCCGTCAGATTGGG
ATTCGACGCATAGCTCGCGC -> CATTCGACGCATAGCTCGCG
CTCATTCGACGCATAGCTCG -> GCTCATTCGACGCATAGCTC
ATCGACGACGCTCGAAGACA -> GATCGACGACGCTCGAAGAC
TATAAGGACCTTCCGGCACC -> ATATAAGGACCTTCCGGCAC
GTTAAATCGCTCGCTAGGAT -> GGTTAAATCGCTCGCTAGGA
TGAACCGGGCCTAGACAGTC -> CTGAACCGGGCCTAGACAGT
GGGACTAAGCTAACGTCATG -> AGGGACTAAGCTAACGTCAT
CAAAAAGACTACCGACATAA -> GCAAAAAGACTACCGACATA
AGTGCCGGGCGACACCAGGT -> GAGTGCCGGGCGACACCAGG
CGGAGTGCCGGGCGACACCA -> ACGGAGTGCCGGGCGACACC
TCTGGTTTGTAGAAAAGCGC -> TTCTGGTTTGTAGAAAAGCG
ATAGGACGTTTCTTCTAGCG -> GATAGGACGTTTCTTCTAGC
GCCCCGGTGCGGTGAGAGGC -> AGCCCCGGTGCGGTGAGAGG
TCGACGACGCTCGAAGACAG -> ATCGACGACGCTCGAAGACA
CCTGGCCTTCTAGCTTGCGG -> CCCTGGCCTTCTAGCTTGCG
ACGCTCGAAGACAGGGACTA -> GACGCTCGAAGACAGGGACT
GGGTGGCACTCGCTCTTAGA -> CGGGTGGCACTCGCTCTTAG
GGAAGTCTAGCGCTTCACAC -> AGGAAGTCTAGCGCTTCACA
TCACACTACAGGATCTACAG -> TTCACACTACAGGATCTACA
AGTTGATTCCTGTACTTTAC -> CAGTTGATTCCTGTACTTTA
TGTAGAAAAGCGCTCCACGA -> TTGTAGAAAAGCGCTCCACG
TCCTCTTGTTAAAATATAAG -> CTCCTCTTGTTAAAATATAA
GCGCTCGCGTACTGAAGCGG -> TGCGCTCGCGTACTGAAGCG
TTGGGAGGTGTCGGGATGAT -> ATTGGGAGGTGTCGGGATGA
CTCACCACTAGTTCTGAACC -> TCTCACCACTAGTTCTGAAC
ACGTCATGCCTTTGGGTCCT -> AACGTCATGCCTTTGGGTCC
GTCATGCCTTTGGGTCCTGT -> CGTCATGCCTTTGGGTCCTG
GAGCTAACGGTCGTATTCTC -> AGAGCTAACGGTCGTATTCT
AGTTTGCCCTATTCTGGTTT -> TAGTTTGCCCTATTCTGGTT
CCTGTACTTTACGCGCCCTG -> TCCTGTACTTTACGCGCCCT
CGGTAGAATTAGGTTCTGCT -> CCGGTAGAATTAGGTTCTGC
GCGCTTCACACTACAGGATC -> AGCGCTTCACACTACAGGAT
GTCGTATTCTCGGTTGCGGC -> GGTCGTATTCTCGGTTGCGG
TTCTAGCTTGCGGTCCAGTT -> CTTCTAGCTTGCGGTCCAGT
TGATGCGTTAGCTTACGGGC -> TTGATGCGTTAGCTTACGGG
ATGGCTTCTACCGCCAACAC -> GATGGCTTCTACCGCCAACA
GATCCGCTCATTCGACGCAT -> TGATCCGCTCATTCGACGCA
GTTCCGACGTTCTACACAAC -> GGTTCCGACGTTCTACACAA
CGCAACAGTTGATTCCTGTA -> ACGCAACAGTTGATTCCTGT
TCGTATTCTCGGTTGCGGCA -> GTCGTATTCTCGGTTGCGGC
CAGTTGATTCCTGTACTTTA -> ACAGTTGATTCCTGTACTTT
CGGTGAGAGGCGACCACTCC -> GCGGTGAGAGGCGACCACTC
TAGTCTGGTAAAAATGGAAG -> GTAGTCTGGTAAAAATGGAA
TTAGGATAGGACGTTTCTTC -> GTTAGGATAGGACGTTTCTT
ATAAGGACCTTCCGGCACCC -> TATAAGGACCTTCCGGCACC
GCGTGCCTCCTCTTGTTAAA -> CGCGTGCCTCCTCTTGTTAA
AGGCCTCCCGGCCCCCAACG -> TAGGCCTCCCGGCCCCCAAC
ACGTGAGGAAGTCTAGCGCT -> AACGTGAGGAAGTCTAGCGC
CGACACCAGGTTAGGATAGG -> GCGACACCAGGTTAGGATAG
GTTCATTGATCTCGAGAGCT -> CGTTCATTGATCTCGAGAGC
GATGATCCGCTCATTCGACG -> GGATGATCCGCTCATTCGAC
GGGCGATTCTCCAACGTGAG -> TGGGCGATTCTCCAACGTGA
TAGCTTGCGGTCCAGTTACC -> CTAGCTTGCGGTCCAGTTAC
TCCTGATGTAGTCTGGTAAA -> GTCCTGATGTAGTCTGGTAA
TATTTCGGCGCAAGAGGCAA -> ATATTTCGGCGCAAGAGGCA
ACGACCTGTATTGGTGGTTA -> AACGACCTGTATTGGTGGTT
CAGTTACCGGTCGGAGCCCC -> CCAGTTACCGGTCGGAGCCC
GTCCTGATGTAGTCTGGTAA -> AGTCCTGATGTAGTCTGGTA
AGCGCTCCACGATCGACGAC -> AAGCGCTCCACGATCGACGA
ACGGAGTGCCGGGCGACACC -> CACGGAGTGCCGGGCGACAC
TTGATCTCGAGAGCTAACGG -> ATTGATCTCGAGAGCTAACG
CCAGTTACCGGTCGGAGCCC -> TCCAGTTACCGGTCGGAGCC
CTTTACCTTTACGAGCCGAT -> CCTTTACCTTTACGAGCCGA
CAAGAGGCAAAAAGACTACC -> GCAAGAGGCAAAAAGACTAC
ATTCTGGTTTGTAGAAAAGC -> TATTCTGGTTTGTAGAAAAG
AGACCAATCATATTTGGGTC -> CAGACCAATCATATTTGGGT
CCGCCAACACACCTGCATAG -> ACCGCCAACACACCTGCATA
AAATATAAGGACCTTCCGGC -> AAAATATAAGGACCTTCCGG
CCGCTAAATGTCACTTTCGC -> CCCGCTAAATGTCACTTTCG
TCGCGCGTGTCGAAGAAGCA -> CTCGCGCGTGTCGAAGAAGC
GCCAACACACCTGCATAGTT -> CGCCAACACACCTGCATAGT
TATCTCGATGGCTTCTACCG -> TTATCTCGATGGCTTCTACC
GGTGGTTAAATCGCTCGCTA -> TGGTGGTTAAATCGCTCGCT
TAATGCAATACGCGAGACAG -> ATAATGCAATACGCGAGACA
CCCCTGGAAAGTGCCGGTAG -> ACCCCTGGAAAGTGCCGGTA
TAAGCACGGAGTGCCGGGCG -> ATAAGCACGGAGTGCCGGGC
TCGGAGCCCCGGTGCGGTGA -> GTCGGAGCCCCGGTGCGGTG
CGCTCCACGATCGACGACGC -> GCGCTCCACGATCGACGACG
TGTCGGTAAGGGTGTTGACT -> GTGTCGGTAAGGGTGTTGAC
ATTGGGAGGTGTCGGGATGA -> GATTGGGAGGTGTCGGGATG
TACGAGCCGATTAGATCAGT -> TTACGAGCCGATTAGATCAG
TATAATGCAATACGCGAGAC -> TTATAATGCAATACGCGAGA
TCCCGGCCCCCAACGTTCAT -> CTCCCGGCCCCCAACGTTCA
TGGAAAGTGCCGGTAGAATT -> CTGGAAAGTGCCGGTAGAAT
CTAGGCCTCCCGGCCCCCAA -> ACTAGGCCTCCCGGCCCCCA
GGCAGTGACGTGGGCGATTC -> CGGCAGTGACGTGGGCGATT
AAAAGACTACCGACATAAGC -> AAAAAGACTACCGACATAAG
CGCGAGACAGACCAATCATA -> ACGCGAGACAGACCAATCAT
ATCTCGATGGCTTCTACCGC -> TATCTCGATGGCTTCTACCG
GCTTGGCTCCGCGTGCCTCC -> CGCTTGGCTCCGCGTGCCTC
AGATGGGTTCCGACGTTCTA -> TAGATGGGTTCCGACGTTCT
TCCTTTACCTTTACGAGCCG -> CTCCTTTACCTTTACGAGCC
TTCACACTACAGGATCTACA -> CTTCACACTACAGGATCTAC
GATCTTCCTACTAGGCCTCC -> TGATCTTCCTACTAGGCCTC
CGCTCGAAGACAGGGACTAA -> ACGCTCGAAGACAGGGACTA
TGGCCTTCTAGCTTGCGGTC -> CTGGCCTTCTAGCTTGCGGT
TATTCTGGTTTGTAGAAAAG -> CTATTCTGGTTTGTAGAAAA
CTAGCGCTTCACACTACAGG -> TCTAGCGCTTCACACTACAG
TCCGCGTGCCTCCTCTTGTT -> CTCCGCGTGCCTCCTCTTGT
GACGTTCTACACAACTTTGG -> CGACGTTCTACACAACTTTG
CGACGCTCGAAGACAGGGAC -> ACGACGCTCGAAGACAGGGA
ACACAACTTTGGCGAGCATT -> TACACAACTTTGGCGAGCAT
TTTTCTGCTCAGACGAACGA -> TTTTTCTGCTCAGACGAACG
ACTAGTTCTGAACCGGGCCT -> CACTAGTTCTGAACCGGGCC
CCTATTCTGGTTTGTAGAAA -> CCCTATTCTGGTTTGTAGAA
CGTTCATTGATCTCGAGAGC -> ACGTTCATTGATCTCGAGAG
CCTGGAAAGTGCCGGTAGAA -> CCCTGGAAAGTGCCGGTAGA
TACGGGCGGCACTCTCACCA -> TTACGGGCGGCACTCTCACC
ATGCCTTTGGGTCCTGTTTT -> CATGCCTTTGGGTCCTGTTT
GCCCCCAACGTTCATTGATC -> GGCCCCCAACGTTCATTGAT
ATTGGTGGTTAAATCGCTCG -> TATTGGTGGTTAAATCGCTC
CAGACCAATCATATTTGGGT -> ACAGACCAATCATATTTGGG
TGGGTCCTCCGTCAGATTGG -> TTGGGTCCTCCGTCAGATTG
TTAAAATATAAGGACCTTCC -> GTTAAAATATAAGGACCTTC
GTAAGGGTGTTGACTCATTG -> GGTAAGGGTGTTGACTCATT
CGAACGACCTGTATTGGTGG -> ACGAACGACCTGTATTGGTG
TCATTTATCTCGATGGCTTC -> GTCATTTATCTCGATGGCTT
GCTCTTAGATGGGTTCCGAC -> CGCTCTTAGATGGGTTCCGA
GACACTGCCGCCCTAACAGG -> TGACACTGCCGCCCTAACAG
GTCGGGATGATCCGCTCATT -> TGTCGGGATGATCCGCTCAT
TCTTGTTAAAATATAAGGAC -> CTCTTGTTAAAATATAAGGA
TCGGTAAGGGTGTTGACTCA -> GTCGGTAAGGGTGTTGACTC
ACGATCGACGACGCTCGAAG -> CACGATCGACGACGCTCGAA
AACAGTTGATTCCTGTACTT -> CAACAGTTGATTCCTGTACT
AGGATCTACAGTCCTGATGT -> CAGGATCTACAGTCCTGATG
TCGGGATGATCCGCTCATTC -> GTCGGGATGATCCGCTCATT
TGCGTTAGCTTACGGGCGGC -> ATGCGTTAGCTTACGGGCGG
GACCACTCCTTGATCTTCCT -> CGACCACTCCTTGATCTTCC
AGCCGATTAGATCAGTGTGT -> GAGCCGATTAGATCAGTGTG
AGTCATTTATCTCGATGGCT -> CAGTCATTTATCTCGATGGC
TGAATTGACACTGCCGCCCT -> CTGAATTGACACTGCCGCCC
TTCTGGTTTGTAGAAAAGCG -> ATTCTGGTTTGTAGAAAAGC
TACCGGTCGGAGCCCCGGTG -> TTACCGGTCGGAGCCCCGGT
GTGGTTAAATCGCTCGCTAG -> GGTGGTTAAATCGCTCGCTA
TCTGCTCAGACGAACGACCT -> TTCTGCTCAGACGAACGACC
CAACGTGAGGAAGTCTAGCG -> CCAACGTGAGGAAGTCTAGC
CACGATCGACGACGCTCGAA -> CCACGATCGACGACGCTCGA
GAAGCATCTGAATTGACACT -> AGAAGCATCTGAATTGACAC
TCCTCCGTCAGATTGGGAGG -> GTCCTCCGTCAGATTGGGAG
TGACTACGCAACAGTTGATT -> TTGACTACGCAACAGTTGAT
TGCCCTATTCTGGTTTGTAG -> TTGCCCTATTCTGGTTTGTA
GTTGATTCCTGTACTTTACG -> AGTTGATTCCTGTACTTTAC
AAGCACGGAGTGCCGGGCGA -> TAAGCACGGAGTGCCGGGCG
GCAAAAAGACTACCGACATA -> GGCAAAAAGACTACCGACAT
ACAGTCCTGATGTAGTCTGG -> TACAGTCCTGATGTAGTCTG
TGCGGTGAGAGGCGACCACT -> GTGCGGTGAGAGGCGACCAC
GGCACTCGCTCTTAGATGGG -> TGGCACTCGCTCTTAGATGG
CTGGTAAAAATGGAAGCATA -> TCTGGTAAAAATGGAAGCAT
CATAAGCACGGAGTGCCGGG -> ACATAAGCACGGAGTGCCGG
GAGCCGATTAGATCAGTGTG -> CGAGCCGATTAGATCAGTGT
TTCGGCGCAAGAGGCAAAAA -> TTTCGGCGCAAGAGGCAAAA
GCCCTATTCTGGTTTGTAGA -> TGCCCTATTCTGGTTTGTAG
GTTTCTTCTAGCGCTTGGCT -> CGTTTCTTCTAGCGCTTGGC
CCGCGTGCCTCCTCTTGTTA -> TCCGCGTGCCTCCTCTTGTT
TTTGGGTCCTGTTTTTCTGC -> CTTTGGGTCCTGTTTTTCTG
GGTAAAAATGGAAGCATATT -> TGGTAAAAATGGAAGCATAT
GGGCGGCACTCTCACCACTA -> CGGGCGGCACTCTCACCACT
CGCTAAATGTCACTTTCGCT -> CCGCTAAATGTCACTTTCGC
TGCTGCGCTCGCGTACTGAA -> CTGCTGCGCTCGCGTACTGA
CTCCAACGTGAGGAAGTCTA -> TCTCCAACGTGAGGAAGTCT
CTACCGACATAAGCACGGAG -> ACTACCGACATAAGCACGGA
ATGTAGTCTGGTAAAAATGG -> GATGTAGTCTGGTAAAAATG
CTGATGTAGTCTGGTAAAAA -> CCTGATGTAGTCTGGTAAAA
TTACCTTTACGAGCCGATTA -> TTTACCTTTACGAGCCGATT
GAGAGCTAACGGTCGTATTC -> CGAGAGCTAACGGTCGTATT
AAGAGGCAAAAAGACTACCG -> CAAGAGGCAAAAAGACTACC
AAGCATCTGAATTGACACTG -> GAAGCATCTGAATTGACACT
CTCGAGAGCTAACGGTCGTA -> TCTCGAGAGCTAACGGTCGT
TCGAGAGCTAACGGTCGTAT -> CTCGAGAGCTAACGGTCGTA
CCTCCTCTTGTTAAAATATA -> GCCTCCTCTTGTTAAAATAT
CTGTTTTTCTGCTCAGACGA -> CCTGTTTTTCTGCTCAGACG
GGTTAGGATAGGACGTTTCT -> AGGTTAGGATAGGACGTTTC
GGTGAGAGGCGACCACTCCT -> CGGTGAGAGGCGACCACTCC
TTCTGCTCAGACGAACGACC -> TTTCTGCTCAGACGAACGAC
AAGGACCTTCCGGCACCCCG -> TAAGGACCTTCCGGCACCCC
CAGGATCTACAGTCCTGATG -> ACAGGATCTACAGTCCTGAT
GATCGACGACGCTCGAAGAC -> CGATCGACGACGCTCGAAGA
TACTAGGCCTCCCGGCCCCC -> CTACTAGGCCTCCCGGCCCC
GGCCTTCTAGCTTGCGGTCC -> TGGCCTTCTAGCTTGCGGTC
GTGTTGACTCATTGCCCGCT -> GGTGTTGACTCATTGCCCGC
GAGCATTGACTACGCAACAG -> CGAGCATTGACTACGCAACA
GATTAGATCAGTGTGTCGGT -> CGATTAGATCAGTGTGTCGG
TGATCCGCTCATTCGACGCA -> ATGATCCGCTCATTCGACGC
TGATCTCGAGAGCTAACGGT -> TTGATCTCGAGAGCTAACGG
GTAAAAATGGAAGCATATTT -> GGTAAAAATGGAAGCATATT
AGCATATTTCGGCGCAAGAG -> AAGCATATTTCGGCGCAAGA
TTTCTGCTCAGACGAACGAC -> TTTTCTGCTCAGACGAACGA
CGTGGGCGATTCTCCAACGT -> ACGTGGGCGATTCTCCAACG
CACACCTGCATAGTTTGCCC -> ACACACCTGCATAGTTTGCC
AAAGCGCTCCACGATCGACG -> AAAAGCGCTCCACGATCGAC
GCTCGCGTACTGAAGCGGGT -> CGCTCGCGTACTGAAGCGGG
CGGTAAGGGTGTTGACTCAT -> TCGGTAAGGGTGTTGACTCA
GTCCAGTTACCGGTCGGAGC -> GGTCCAGTTACCGGTCGGAG
CGACGACGCTCGAAGACAGG -> TCGACGACGCTCGAAGACAG
ATATTTCGGCGCAAGAGGCA -> CATATTTCGGCGCAAGAGGC
TTTACGCGCCCTGGCCTTCT -> CTTTACGCGCCCTGGCCTTC
ATAGTTTGCCCTATTCTGGT -> CATAGTTTGCCCTATTCTGG
CTCCGCGTGCCTCCTCTTGT -> GCTCCGCGTGCCTCCTCTTG
GTTTGTAGAAAAGCGCTCCA -> GGTTTGTAGAAAAGCGCTCC
GACGTGGGCGATTCTCCAAC -> TGACGTGGGCGATTCTCCAA
GATCTCGAGAGCTAACGGTC -> TGATCTCGAGAGCTAACGGT
CACCACTAGTTCTGAACCGG -> TCACCACTAGTTCTGAACCG
TCCGGCACCCCGCCTGACGA -> TTCCGGCACCCCGCCTGACG
TGTTGACTCATTGCCCGCTA -> GTGTTGACTCATTGCCCGCT
TGGCTTCTACCGCCAACACA -> ATGGCTTCTACCGCCAACAC
AACGTCATGCCTTTGGGTCC -> TAACGTCATGCCTTTGGGTC
GTGCGGTGAGAGGCGACCAC -> GGTGCGGTGAGAGGCGACCA
CTCATTGCCCGCTAAATGTC -> ACTCATTGCCCGCTAAATGT
CCAACGTGAGGAAGTCTAGC -> TCCAACGTGAGGAAGTCTAG
AGGCGACCACTCCTTGATCT -> GAGGCGACCACTCCTTGATC
TCTAGCTTGCGGTCCAGTTA -> TTCTAGCTTGCGGTCCAGTT
GACTACCGACATAAGCACGG -> AGACTACCGACATAAGCACG
CTTGGCTCCGCGTGCCTCCT -> GCTTGGCTCCGCGTGCCTCC
TGCCGGTAGAATTAGGTTCT -> GTGCCGGTAGAATTAGGTTC
ACGACGCTCGAAGACAGGGA -> GACGACGCTCGAAGACAGGG
AATTGACACTGCCGCCCTAA -> GAATTGACACTGCCGCCCTA
TCATTCGACGCATAGCTCGC -> CTCATTCGACGCATAGCTCG
AGCTTGCGGTCCAGTTACCG -> TAGCTTGCGGTCCAGTTACC
GCTTCACACTACAGGATCTA -> CGCTTCACACTACAGGATCT
AGAAGCATCTGAATTGACAC -> AAGAAGCATCTGAATTGACA
GACGACGCTCGAAGACAGGG -> CGACGACGCTCGAAGACAGG
GGTAGAATTAGGTTCTGCTG -> CGGTAGAATTAGGTTCTGCT
TCATGCCTTTGGGTCCTGTT -> GTCATGCCTTTGGGTCCTGT
GGCGGCACTCTCACCACTAG -> GGGCGGCACTCTCACCACTA
CCCGGTGCGGTGAGAGGCGA -> CCCCGGTGCGGTGAGAGGCG
TAGCTTACGGGCGGCACTCT -> TTAGCTTACGGGCGGCACTC
CTGCTGCGCTCGCGTACTGA -> TCTGCTGCGCTCGCGTACTG
CCGTCAGATTGGGAGGTGTC -> TCCGTCAGATTGGGAGGTGT
GCTCGCGCGTGTCGAAGAAG -> AGCTCGCGCGTGTCGAAGAA
GATTCTCCAACGTGAGGAAG -> CGATTCTCCAACGTGAGGAA
TTCCTACTAGGCCTCCCGGC -> CTTCCTACTAGGCCTCCCGG
TCGCGTACTGAAGCGGGTGG -> CTCGCGTACTGAAGCGGGTG
AACCGGGCCTAGACAGTCAT -> GAACCGGGCCTAGACAGTCA
CGAAGAAGCATCTGAATTGA -> TCGAAGAAGCATCTGAATTG
GCCCTAACAGGGCTCCTTTA -> CGCCCTAACAGGGCTCCTTT
GAGAGGCGACCACTCCTTGA -> TGAGAGGCGACCACTCCTTG
AATCATATTTGGGTCCTCCG -> CAATCATATTTGGGTCCTCC
GTGAGAGGCGACCACTCCTT -> GGTGAGAGGCGACCACTCCT
CTGGCCTTCTAGCTTGCGGT -> CCTGGCCTTCTAGCTTGCGG
GCCTAGACAGTCATTTATCT -> GGCCTAGACAGTCATTTATC
TCTACACAACTTTGGCGAGC -> TTCTACACAACTTTGGCGAG
AGGACGTTTCTTCTAGCGCT -> TAGGACGTTTCTTCTAGCGC
CTCCGTCAGATTGGGAGGTG -> CCTCCGTCAGATTGGGAGGT
AGTCTGGTAAAAATGGAAGC -> TAGTCTGGTAAAAATGGAAG
TAAGGACCTTCCGGCACCCC -> ATAAGGACCTTCCGGCACCC
GCGAGACAGACCAATCATAT -> CGCGAGACAGACCAATCATA
ACACTGCCGCCCTAACAGGG -> GACACTGCCGCCCTAACAGG
TCTGAATTGACACTGCCGCC -> ATCTGAATTGACACTGCCGC
CTTTGATGCGTTAGCTTACG -> CCTTTGATGCGTTAGCTTAC
CTCTTAGATGGGTTCCGACG -> GCTCTTAGATGGGTTCCGAC
GCTTGCGGTCCAGTTACCGG -> AGCTTGCGGTCCAGTTACCG
AGCATTGACTACGCAACAGT -> GAGCATTGACTACGCAACAG
ATTAGGTTCTGCTGCGCTCG -> AATTAGGTTCTGCTGCGCTC
GGTCCAGTTACCGGTCGGAG -> CGGTCCAGTTACCGGTCGGA
TCCTGTACTTTACGCGCCCT -> TTCCTGTACTTTACGCGCCC
TCCACGATCGACGACGCTCG -> CTCCACGATCGACGACGCTC
GCACTCGCTCTTAGATGGGT -> GGCACTCGCTCTTAGATGGG
ACGGTCGTATTCTCGGTTGC -> AACGGTCGTATTCTCGGTTG
CCTACTAGGCCTCCCGGCCC -> TCCTACTAGGCCTCCCGGCC
CGGCCCCCAACGTTCATTGA -> CCGGCCCCCAACGTTCATTG
AGGTGTCGGGATGATCCGCT -> GAGGTGTCGGGATGATCCGC
CAACTTTGGCGAGCATTGAC -> ACAACTTTGGCGAGCATTGA
CACTTTCGCTGACCCATCAC -> TCACTTTCGCTGACCCATCA
CGGTCCAGTTACCGGTCGGA -> GCGGTCCAGTTACCGGTCGG
AGACTACCGACATAAGCACG -> AAGACTACCGACATAAGCAC
GAAGAAGCATCTGAATTGAC -> CGAAGAAGCATCTGAATTGA
ATTCCTGTACTTTACGCGCC -> GATTCCTGTACTTTACGCGC
GTAGTCTGGTAAAAATGGAA -> TGTAGTCTGGTAAAAATGGA
TCTAGCGCTTCACACTACAG -> GTCTAGCGCTTCACACTACA
TCTCGAGAGCTAACGGTCGT -> ATCTCGAGAGCTAACGGTCG
TGCGGTCCAGTTACCGGTCG -> TTGCGGTCCAGTTACCGGTC
TCTGGTAAAAATGGAAGCAT -> GTCTGGTAAAAATGGAAGCA
GGCGCAAGAGGCAAAAAGAC -> CGGCGCAAGAGGCAAAAAGA
GGATCTACAGTCCTGATGTA -> AGGATCTACAGTCCTGATGT
CATAGCTCGCGCGTGTCGAA -> GCATAGCTCGCGCGTGTCGA
CTCCTCTTGTTAAAATATAA -> CCTCCTCTTGTTAAAATATA
TTCTAGCGCTTGGCTCCGCG -> CTTCTAGCGCTTGGCTCCGC
CACTCCTTGATCTTCCTACT -> CCACTCCTTGATCTTCCTAC
GACATAAGCACGGAGTGCCG -> CGACATAAGCACGGAGTGCC
ACTCGCTCTTAGATGGGTTC -> CACTCGCTCTTAGATGGGTT
ACACACCTGCATAGTTTGCC -> AACACACCTGCATAGTTTGC
AAGGGTGTTGACTCATTGCC -> TAAGGGTGTTGACTCATTGC
TGCTCAGACGAACGACCTGT -> CTGCTCAGACGAACGACCTG
CGCCCTAACAGGGCTCCTTT -> CCGCCCTAACAGGGCTCCTT
GCGTTAGCTTACGGGCGGCA -> TGCGTTAGCTTACGGGCGGC
TGTTAAAATATAAGGACCTT -> TTGTTAAAATATAAGGACCT
GAATTGACACTGCCGCCCTA -> TGAATTGACACTGCCGCCCT
GGATTATAATGCAATACGCG -> AGGATTATAATGCAATACGC
GATCTACAGTCCTGATGTAG -> GGATCTACAGTCCTGATGTA
GGGAGGTGTCGGGATGATCC -> TGGGAGGTGTCGGGATGATC
AACGGTCGTATTCTCGGTTG -> TAACGGTCGTATTCTCGGTT
TCTTCTAGCGCTTGGCTCCG -> TTCTTCTAGCGCTTGGCTCC
GCTGCGCTCGCGTACTGAAG -> TGCTGCGCTCGCGTACTGAA
GTTACCGGTCGGAGCCCCGG -> AGTTACCGGTCGGAGCCCCG
CGAAGACAGGGACTAAGCTA -> TCGAAGACAGGGACTAAGCT
CTGCCGCCCTAACAGGGCTC -> ACTGCCGCCCTAACAGGGCT
ATGTCACTTTCGCTGACCCA -> AATGTCACTTTCGCTGACCC
AAAAATGGAAGCATATTTCG -> TAAAAATGGAAGCATATTTC
CGTCAGATTGGGAGGTGTCG -> CCGTCAGATTGGGAGGTGTC
TGGCGAGCATTGACTACGCA -> TTGGCGAGCATTGACTACGC
TAGATGGGTTCCGACGTTCT -> TTAGATGGGTTCCGACGTTC
CGCATAGCTCGCGCGTGTCG -> ACGCATAGCTCGCGCGTGTC
TGACCCATCACCCCTGGAAA -> CTGACCCATCACCCCTGGAA
CGTTCTACACAACTTTGGCG -> ACGTTCTACACAACTTTGGC
ACGGGCGGCACTCTCACCAC -> TACGGGCGGCACTCTCACCA
CGCGTACTGAAGCGGGTGGC -> TCGCGTACTGAAGCGGGTGG
CTTTGGGTCCTGTTTTTCTG -> CCTTTGGGTCCTGTTTTTCT
CGTGAGGAAGTCTAGCGCTT -> ACGTGAGGAAGTCTAGCGCT
TCCAACGTGAGGAAGTCTAG -> CTCCAACGTGAGGAAGTCTA
ACTACCGACATAAGCACGGA -> GACTACCGACATAAGCACGG
GGCAAAAAGACTACCGACAT -> AGGCAAAAAGACTACCGACA
CTAACAGGGCTCCTTTACCT -> CCTAACAGGGCTCCTTTACC
CCTAACAGGGCTCCTTTACC -> CCCTAACAGGGCTCCTTTAC
TGTTTTTCTGCTCAGACGAA -> CTGTTTTTCTGCTCAGACGA
GGTAAGGGTGTTGACTCATT -> CGGTAAGGGTGTTGACTCAT
TTCTGAACCGGGCCTAGACA -> GTTCTGAACCGGGCCTAGAC
CTTGCGGTCCAGTTACCGGT -> GCTTGCGGTCCAGTTACCGG
GCGACCACTCCTTGATCTTC -> GGCGACCACTCCTTGATCTT
GGACCTTCCGGCACCCCGCC -> AGGACCTTCCGGCACCCCGC
ATCATATTTGGGTCCTCCGT -> AATCATATTTGGGTCCTCCG
TAGGATAGGACGTTTCTTCT -> TTAGGATAGGACGTTTCTTC
GCTTACGGGCGGCACTCTCA -> AGCTTACGGGCGGCACTCTC
CCAGGTTAGGATAGGACGTT -> ACCAGGTTAGGATAGGACGT
GACCTTCCGGCACCCCGCCT -> GGACCTTCCGGCACCCCGCC
CCAACGTTCATTGATCTCGA -> CCCAACGTTCATTGATCTCG
TACGCAACAGTTGATTCCTG -> CTACGCAACAGTTGATTCCT
ATATTTGGGTCCTCCGTCAG -> CATATTTGGGTCCTCCGTCA
ACTGCCGCCCTAACAGGGCT -> CACTGCCGCCCTAACAGGGC
CGGGCCTAGACAGTCATTTA -> CCGGGCCTAGACAGTCATTT
TGATTCCTGTACTTTACGCG -> TTGATTCCTGTACTTTACGC
AAATCGCTCGCTAGGATTAT -> TAAATCGCTCGCTAGGATTA
AGTGCCGGTAGAATTAGGTT -> AAGTGCCGGTAGAATTAGGT
AGACAGGGACTAAGCTAACG -> AAGACAGGGACTAAGCTAAC
CCCGCTAAATGTCACTTTCG -> GCCCGCTAAATGTCACTTTC
TGTATTGGTGGTTAAATCGC -> CTGTATTGGTGGTTAAATCG
GCCCGCTAAATGTCACTTTC -> TGCCCGCTAAATGTCACTTT
AGATCAGTGTGTCGGTAAGG -> TAGATCAGTGTGTCGGTAAG
ATCCGCTCATTCGACGCATA -> GATCCGCTCATTCGACGCAT
TCGCTCTTAGATGGGTTCCG -> CTCGCTCTTAGATGGGTTCC
GGCCCCCAACGTTCATTGAT -> CGGCCCCCAACGTTCATTGA
GGTTCTGCTGCGCTCGCGTA -> AGGTTCTGCTGCGCTCGCGT
GTACTTTACGCGCCCTGGCC -> TGTACTTTACGCGCCCTGGC
TACCTTTACGAGCCGATTAG -> TTACCTTTACGAGCCGATTA
GCAAGAGGCAAAAAGACTAC -> CGCAAGAGGCAAAAAGACTA
AAGAAGCATCTGAATTGACA -> GAAGAAGCATCTGAATTGAC
CGAGAGCTAACGGTCGTATT -> TCGAGAGCTAACGGTCGTAT
GACTCATTGCCCGCTAAATG -> TGACTCATTGCCCGCTAAAT
CTACACAACTTTGGCGAGCA -> TCTACACAACTTTGGCGAGC
TTTGATGCGTTAGCTTACGG -> CTTTGATGCGTTAGCTTACG
AACAGGGCTCCTTTACCTTT -> TAACAGGGCTCCTTTACCTT
CGCGTGTCGAAGAAGCATCT -> GCGCGTGTCGAAGAAGCATC
TAGGACGTTTCTTCTAGCGC -> ATAGGACGTTTCTTCTAGCG
GCCTCCCGGCCCCCAACGTT -> GGCCTCCCGGCCCCCAACGT
GGGTCCTGTTTTTCTGCTCA -> TGGGTCCTGTTTTTCTGCTC
GGAGGTGTCGGGATGATCCG -> GGGAGGTGTCGGGATGATCC
GGCGAGCATTGACTACGCAA -> TGGCGAGCATTGACTACGCA
CTCTTGTTAAAATATAAGGA -> CCTCTTGTTAAAATATAAGG
TTGTAGAAAAGCGCTCCACG -> TTTGTAGAAAAGCGCTCCAC
CACTCGCTCTTAGATGGGTT -> GCACTCGCTCTTAGATGGGT
TTTTTCTGCTCAGACGAACG -> GTTTTTCTGCTCAGACGAAC
ACCAGGTTAGGATAGGACGT -> CACCAGGTTAGGATAGGACG
GCGGTGAGAGGCGACCACTC -> TGCGGTGAGAGGCGACCACT
GCATATTTCGGCGCAAGAGG -> AGCATATTTCGGCGCAAGAG
TACCGCCAACACACCTGCAT -> CTACCGCCAACACACCTGCA
CATTTATCTCGATGGCTTCT -> TCATTTATCTCGATGGCTTC
AGACGAACGACCTGTATTGG -> CAGACGAACGACCTGTATTG
TTCCGGCACCCCGCCTGACG -> CTTCCGGCACCCCGCCTGAC
GGAAAGTGCCGGTAGAATTA -> TGGAAAGTGCCGGTAGAATT
CGGCACTCTCACCACTAGTT -> GCGGCACTCTCACCACTAGT
CCCTGGAAAGTGCCGGTAGA -> CCCCTGGAAAGTGCCGGTAG
ACCCATCACCCCTGGAAAGT -> GACCCATCACCCCTGGAAAG
TTCGCTGACCCATCACCCCT -> TTTCGCTGACCCATCACCCC
CCCTAACAGGGCTCCTTTAC -> GCCCTAACAGGGCTCCTTTA
AATTAGGTTCTGCTGCGCTC -> GAATTAGGTTCTGCTGCGCT
TTCTTCTAGCGCTTGGCTCC -> TTTCTTCTAGCGCTTGGCTC
ACAGTTGATTCCTGTACTTT -> AACAGTTGATTCCTGTACTT
GACAGACCAATCATATTTGG -> AGACAGACCAATCATATTTG
GAAGTCTAGCGCTTCACACT -> GGAAGTCTAGCGCTTCACAC
CCCTGGCCTTCTAGCTTGCG -> GCCCTGGCCTTCTAGCTTGC
CTTCCTACTAGGCCTCCCGG -> TCTTCCTACTAGGCCTCCCG
GTCAGATTGGGAGGTGTCGG -> CGTCAGATTGGGAGGTGTCG
CGGCGCAAGAGGCAAAAAGA -> TCGGCGCAAGAGGCAAAAAG
GTTAGGATAGGACGTTTCTT -> GGTTAGGATAGGACGTTTCT
TAGACAGTCATTTATCTCGA -> CTAGACAGTCATTTATCTCG
GCTAGGATTATAATGCAATA -> CGCTAGGATTATAATGCAAT
AACGACCTGTATTGGTGGTT -> GAACGACCTGTATTGGTGGT
GGGATGATCCGCTCATTCGA -> CGGGATGATCCGCTCATTCG
GATGGCTTCTACCGCCAACA -> CGATGGCTTCTACCGCCAAC
TAGCGCTTGGCTCCGCGTGC -> CTAGCGCTTGGCTCCGCGTG
CAGACGAACGACCTGTATTG -> TCAGACGAACGACCTGTATT
TGGGTTCCGACGTTCTACAC -> ATGGGTTCCGACGTTCTACA
AGTGACGTGGGCGATTCTCC -> CAGTGACGTGGGCGATTCTC
CAGGGCTCCTTTACCTTTAC -> ACAGGGCTCCTTTACCTTTA
CGCCCTGGCCTTCTAGCTTG -> GCGCCCTGGCCTTCTAGCTT
GAAGACAGGGACTAAGCTAA -> CGAAGACAGGGACTAAGCTA
TTGCCCTATTCTGGTTTGTA -> TTTGCCCTATTCTGGTTTGT
GTTGACTCATTGCCCGCTAA -> TGTTGACTCATTGCCCGCTA
AGGATTATAATGCAATACGC -> TAGGATTATAATGCAATACG
GGTGGCACTCGCTCTTAGAT -> GGGTGGCACTCGCTCTTAGA
GGTTGCGGCAGTGACGTGGG -> CGGTTGCGGCAGTGACGTGG
AGCACGGAGTGCCGGGCGAC -> AAGCACGGAGTGCCGGGCGA
GGGTTCCGACGTTCTACACA -> TGGGTTCCGACGTTCTACAC
GTCACTTTCGCTGACCCATC -> TGTCACTTTCGCTGACCCAT
AAATGGAAGCATATTTCGGC -> AAAATGGAAGCATATTTCGG
TACGCGCCCTGGCCTTCTAG -> TTACGCGCCCTGGCCTTCTA
AGAGGCAAAAAGACTACCGA -> AAGAGGCAAAAAGACTACCG
AGCATCTGAATTGACACTGC -> AAGCATCTGAATTGACACTG
ACCGCCAACACACCTGCATA -> TACCGCCAACACACCTGCAT
CTGGTTTGTAGAAAAGCGCT -> TCTGGTTTGTAGAAAAGCGC
CATCACCCCTGGAAAGTGCC -> CCATCACCCCTGGAAAGTGC
TTCTCCAACGTGAGGAAGTC -> ATTCTCCAACGTGAGGAAGT
TACAGGATCTACAGTCCTGA -> CTACAGGATCTACAGTCCTG
CATATTTCGGCGCAAGAGGC -> GCATATTTCGGCGCAAGAGG
TGGCTCCGCGTGCCTCCTCT -> TTGGCTCCGCGTGCCTCCTC
TAAGCTAACGTCATGCCTTT -> CTAAGCTAACGTCATGCCTT
TTCGACGCATAGCTCGCGCG -> ATTCGACGCATAGCTCGCGC
CCCATCACCCCTGGAAAGTG -> ACCCATCACCCCTGGAAAGT
CTTCTAGCGCTTGGCTCCGC -> TCTTCTAGCGCTTGGCTCCG
GGTGTTGACTCATTGCCCGC -> GGGTGTTGACTCATTGCCCG
ACATAAGCACGGAGTGCCGG -> GACATAAGCACGGAGTGCCG
CGCTGACCCATCACCCCTGG -> TCGCTGACCCATCACCCCTG
GACGCTCGAAGACAGGGACT -> CGACGCTCGAAGACAGGGAC
CTTACGGGCGGCACTCTCAC -> GCTTACGGGCGGCACTCTCA
AGTTACCGGTCGGAGCCCCG -> CAGTTACCGGTCGGAGCCCC
CGGTGCGGTGAGAGGCGACC -> CCGGTGCGGTGAGAGGCGAC
GTGAGGAAGTCTAGCGCTTC -> CGTGAGGAAGTCTAGCGCTT
GCTTCTACCGCCAACACACC -> GGCTTCTACCGCCAACACAC
ATTAGATCAGTGTGTCGGTA -> GATTAGATCAGTGTGTCGGT
CTTAGATGGGTTCCGACGTT -> TCTTAGATGGGTTCCGACGT
CTCCACGATCGACGACGCTC -> GCTCCACGATCGACGACGCT
GCTCATTCGACGCATAGCTC -> CGCTCATTCGACGCATAGCT
GTATTGGTGGTTAAATCGCT -> TGTATTGGTGGTTAAATCGC
CTAGTTCTGAACCGGGCCTA -> ACTAGTTCTGAACCGGGCCT
AGCTTACGGGCGGCACTCTC -> TAGCTTACGGGCGGCACTCT
ATCACCCCTGGAAAGTGCCG -> CATCACCCCTGGAAAGTGCC
CCTGCATAGTTTGCCCTATT -> ACCTGCATAGTTTGCCCTAT
CTTTACGCGCCCTGGCCTTC -> ACTTTACGCGCCCTGGCCTT
ACCGACATAAGCACGGAGTG -> TACCGACATAAGCACGGAGT
GCCTTCTAGCTTGCGGTCCA -> GGCCTTCTAGCTTGCGGTCC
ACCCCTGGAAAGTGCCGGTA -> CACCCCTGGAAAGTGCCGGT
CAACACACCTGCATAGTTTG -> CCAACACACCTGCATAGTTT
GACCCATCACCCCTGGAAAG -> TGACCCATCACCCCTGGAAA
TGACTCATTGCCCGCTAAAT -> TTGACTCATTGCCCGCTAAA
CTTCACACTACAGGATCTAC -> GCTTCACACTACAGGATCTA
ATAAGCACGGAGTGCCGGGC -> CATAAGCACGGAGTGCCGGG
GCGATTCTCCAACGTGAGGA -> GGCGATTCTCCAACGTGAGG
CATTGATCTCGAGAGCTAAC -> TCATTGATCTCGAGAGCTAA
TTTCGGCGCAAGAGGCAAAA -> ATTTCGGCGCAAGAGGCAAA
GCATAGCTCGCGCGTGTCGA -> CGCATAGCTCGCGCGTGTCG
GCGGGTGGCACTCGCTCTTA -> AGCGGGTGGCACTCGCTCTT
TCATTGCCCGCTAAATGTCA -> CTCATTGCCCGCTAAATGTC
ACTACGCAACAGTTGATTCC -> GACTACGCAACAGTTGATTC
GATCAGTGTGTCGGTAAGGG -> AGATCAGTGTGTCGGTAAGG
ACCGGGCCTAGACAGTCATT -> AACCGGGCCTAGACAGTCAT
TTGATGCGTTAGCTTACGGG -> TTTGATGCGTTAGCTTACGG
GCGCTCCACGATCGACGACG -> AGCGCTCCACGATCGACGAC
GAGTGCCGGGCGACACCAGG -> GGAGTGCCGGGCGACACCAG
CCCGGCCCCCAACGTTCATT -> TCCCGGCCCCCAACGTTCAT
TAGAATTAGGTTCTGCTGCG -> GTAGAATTAGGTTCTGCTGC
CTAGGATTATAATGCAATAC -> GCTAGGATTATAATGCAATA
ACGTTCATTGATCTCGAGAG -> AACGTTCATTGATCTCGAGA
AGCGGGTGGCACTCGCTCTT -> AAGCGGGTGGCACTCGCTCT
ATACGCGAGACAGACCAATC -> AATACGCGAGACAGACCAAT
