TGAGGCGGATCAGGTATAAT -> ATGAGGCGGATCAGGTATAA
CTCGACCGCACAGATCACAC -> CCTCGACCGCACAGATCACA
AATCGAGCTGTTAATTGTAG -> AAATCGAGCTGTTAATTGTA
GATCAGGTATAATAGACGGT -> GGATCAGGTATAATAGACGG
AGGCGGATCAGGTATAATAG -> GAGGCGGATCAGGTATAATA
CGCGCCAACCACATCCCAAC -> GCGCGCCAACCACATCCCAA
CCAACCACATCCCAACCAAG -> GCCAACCACATCCCAACCAA
AACAAATTGGCGGTCAGTGC -> AAACAAATTGGCGGTCAGTG
GGCTACGGGGCTACGCACAA -> GGGCTACGGGGCTACGCACA
AAAATGCTGCTGGTATCTGG -> AAAAATGCTGCTGGTATCTG
GTCAGTGCGCGTCCTAACGA -> GGTCAGTGCGCGTCCTAACG
AGTTAACCTACCCCTGAGGG -> GAGTTAACCTACCCCTGAGG
GACCTCGACCGCACAGATCA -> CGACCTCGACCGCACAGATC
TCGAAATCTTCCGTGGTCCT -> CTCGAAATCTTCCGTGGTCC
ATGGCTTTGAAATACCCGGG -> TATGGCTTTGAAATACCCGG
GTTAAAAAATCGAGCTGTTA -> TGTTAAAAAATCGAGCTGTT
AGAGCCATAGCGCCGCGGTG -> AAGAGCCATAGCGCCGCGGT
AAATTCAGACAGATCGAAGG -> TAAATTCAGACAGATCGAAG
CGCCAACCACATCCCAACCA -> GCGCCAACCACATCCCAACC
CCTCACGACAGCCATGTTAG -> CCCTCACGACAGCCATGTTA
ATACGTTGTAACACTGTGCC -> CATACGTTGTAACACTGTGC
AACTGTGGTTTGTATACAAT -> CAACTGTGGTTTGTATACAA
CTACCCCTGAGGGTGCCCCT -> CCTACCCCTGAGGGTGCCCC
TGCTGCTGGTATCTGGCGAC -> ATGCTGCTGGTATCTGGCGA
AACGAGTCCACCAGGGCTCA -> TAACGAGTCCACCAGGGCTC
CGCGGCCGTAACAACAAGAT -> TCGCGGCCGTAACAACAAGA
CCTCGACCGCACAGATCACA -> ACCTCGACCGCACAGATCAC
TCAGTGCGCGTCCTAACGAG -> GTCAGTGCGCGTCCTAACGA
ACAACAAGATCATTACGGAT -> AACAACAAGATCATTACGGA
CCAGGGCTCAAAATCCTATT -> ACCAGGGCTCAAAATCCTAT
TCCGTACAGGCGTCGGGCTA -> GTCCGTACAGGCGTCGGGCT
ACTTCTGGCATACGTTGTAA -> GACTTCTGGCATACGTTGTA
TTTTCGGCCCCACTCGGGGC -> CTTTTCGGCCCCACTCGGGG
CCAACATAAAAGCATCCGGA -> TCCAACATAAAAGCATCCGG
GACGTAGACGAGACCACTGC -> AGACGTAGACGAGACCACTG
ACCGCACAGATCACACACGC -> GACCGCACAGATCACACACG
GCTCTGCCTCTTGATAGGCG -> GGCTCTGCCTCTTGATAGGC
CTTTTCGGCCCCACTCGGGG -> TCTTTTCGGCCCCACTCGGG
TACGCACAATTCGTTTACGC -> CTACGCACAATTCGTTTACG
TTGGCGGTCAGTGCGCGTCC -> ATTGGCGGTCAGTGCGCGTC
GTGGCGACGCCCTCCAGGGC -> GGTGGCGACGCCCTCCAGGG
CCATAGCGCCGCGGTGTACT -> GCCATAGCGCCGCGGTGTAC
CAAGAAGTGTTAAAAAATCG -> ACAAGAAGTGTTAAAAAATC
GTATACAATCACGTTCAGCA -> TGTATACAATCACGTTCAGC
TCAGTGGCAGCAGGCTATTC -> GTCAGTGGCAGCAGGCTATT
CTACGGGGCTACGCACAATT -> GCTACGGGGCTACGCACAAT
TCTGGCATACGTTGTAACAC -> TTCTGGCATACGTTGTAACA
CAAGCAATGCCAGCGCACTA -> ACAAGCAATGCCAGCGCACT
TAGACGAGACCACTGCAAGT -> GTAGACGAGACCACTGCAAG
CCAGGATTATCTCGAAATCT -> GCCAGGATTATCTCGAAATC
GTCTTTTCGGCCCCACTCGG -> CGTCTTTTCGGCCCCACTCG
CGCACAATTCGTTTACGCCT -> ACGCACAATTCGTTTACGCC
TCCTATTTAATCCGGTCCGT -> ATCCTATTTAATCCGGTCCG
TCGGCAAGAGCCATAGCGCC -> GTCGGCAAGAGCCATAGCGC
ACCACATCCCAACCAAGCGG -> AACCACATCCCAACCAAGCG
GATGTAGACAAGAAGTGTTA -> TGATGTAGACAAGAAGTGTT
GAAGAACGTATCACCGACCT -> GGAAGAACGTATCACCGACC
CGAGTCCACCAGGGCTCAAA -> ACGAGTCCACCAGGGCTCAA
ATGGGGCTACGGGGCTACGC -> AATGGGGCTACGGGGCTACG
AAAAAATCGAGCTGTTAATT -> TAAAAAATCGAGCTGTTAAT
CGGAGATAGACGTAGACGAG -> CCGGAGATAGACGTAGACGA
GCAGACTCCGGATCCTCGCA -> TGCAGACTCCGGATCCTCGC
GGGAAATTGAGGAGTGATGT -> GGGGAAATTGAGGAGTGATG
TGGCCGGGGGAAATTGAGGA -> CTGGCCGGGGGAAATTGAGG
GAGATAGACGTAGACGAGAC -> GGAGATAGACGTAGACGAGA
TTAACCTACCCCTGAGGGTG -> GTTAACCTACCCCTGAGGGT
TCCTCGCACTCGATCGTGAT -> ATCCTCGCACTCGATCGTGA
CTAGCTGGCCGGGGGAAATT -> CCTAGCTGGCCGGGGGAAAT
GCCATGTTAGCGCTTGGTGA -> AGCCATGTTAGCGCTTGGTG
CTCGATCGTGATTGAGAAAG -> ACTCGATCGTGATTGAGAAA
AAATCTTCCGTGGTCCTCCA -> GAAATCTTCCGTGGTCCTCC
ATAGCGCCGCGGTGTACTAC -> CATAGCGCCGCGGTGTACTA
TTGGAAGACGCAATGAAGTG -> GTTGGAAGACGCAATGAAGT
GATCGTGATTGAGAAAGCGG -> CGATCGTGATTGAGAAAGCG
CCAGGGCCAGGATTATCTCG -> TCCAGGGCCAGGATTATCTC
CGGCAAGAGCCATAGCGCCG -> TCGGCAAGAGCCATAGCGCC
AAATTGAGGAGTGATGTAGA -> GAAATTGAGGAGTGATGTAG
CGGATTGGCGTCGTGTGGCA -> ACGGATTGGCGTCGTGTGGC
CAAGATCATTACGGATTGGC -> ACAAGATCATTACGGATTGG
CCGTAACAACAAGATCATTA -> GCCGTAACAACAAGATCATT
GCGACGCCCTCCAGGGCCAG -> GGCGACGCCCTCCAGGGCCA
CACAGATCACACACGCTGGC -> GCACAGATCACACACGCTGG
GGGAAGAACGTATCACCGAC -> TGGGAAGAACGTATCACCGA
CGTGTGGCACATTTCTCTAT -> TCGTGTGGCACATTTCTCTA
ACGTAGACGAGACCACTGCA -> GACGTAGACGAGACCACTGC
AGCCATAGCGCCGCGGTGTA -> GAGCCATAGCGCCGCGGTGT
GTGTGGACTAAAGCAGTTTG -> GGTGTGGACTAAAGCAGTTT
AATTGAGGAGTGATGTAGAC -> AAATTGAGGAGTGATGTAGA
ACAATCACGTTCAGCATTTC -> TACAATCACGTTCAGCATTT
GGATCCTCGCACTCGATCGT -> CGGATCCTCGCACTCGATCG
ACTACCATGAGATGTTACAA -> TACTACCATGAGATGTTACA
TGGACTAAAGCAGTTTGGAT -> GTGGACTAAAGCAGTTTGGA
GCATACGTTGTAACACTGTG -> GGCATACGTTGTAACACTGT
AAGATCATTACGGATTGGCG -> CAAGATCATTACGGATTGGC
TTCTCTATCAGCTCGGCGTC -> TTTCTCTATCAGCTCGGCGT
ATTGGCGTCGTGTGGCACAT -> GATTGGCGTCGTGTGGCACA
TGAGATGTTACAACAACGTC -> ATGAGATGTTACAACAACGT
GTGTACTACCATGAGATGTT -> GGTGTACTACCATGAGATGT
CGAAACAAATTGGCGGTCAG -> TCGAAACAAATTGGCGGTCA
TGAGGGTGCCCCTCACGACA -> CTGAGGGTGCCCCTCACGAC
AGCGCACTACTGACTTCTGG -> CAGCGCACTACTGACTTCTG
ACGCCTTCCCGCGTCTTTTC -> TACGCCTTCCCGCGTCTTTT
TGGCGGTCTGGTCGGCAAGA -> CTGGCGGTCTGGTCGGCAAG
AGCCATGTTAGCGCTTGGTG -> CAGCCATGTTAGCGCTTGGT
ATCCGGAATGGTCTATGGCT -> CATCCGGAATGGTCTATGGC
TCGAGGCGGGTCAGGACCTA -> GTCGAGGCGGGTCAGGACCT
CCTCCAGGGCCAGGATTATC -> CCCTCCAGGGCCAGGATTAT
CTAAAGCAGTTTGGATCGCA -> ACTAAAGCAGTTTGGATCGC
AGCGGTGTGGACTAAAGCAG -> AAGCGGTGTGGACTAAAGCA
TAGACGGTCCGTACAGGCGT -> ATAGACGGTCCGTACAGGCG
GTTAACCTACCCCTGAGGGT -> AGTTAACCTACCCCTGAGGG
ACATCCCAACCAAGCGGTGT -> CACATCCCAACCAAGCGGTG
GAAGTGTTAAAAAATCGAGC -> AGAAGTGTTAAAAAATCGAG
CTCGAAATCTTCCGTGGTCC -> TCTCGAAATCTTCCGTGGTC
CAACCAAGCGGTGTGGACTA -> CCAACCAAGCGGTGTGGACT
GGGTGCCCCTCACGACAGCC -> AGGGTGCCCCTCACGACAGC
CACTCGGGGCAGTAGTCAGT -> CCACTCGGGGCAGTAGTCAG
GCGGTCTGGTCGGCAAGAGC -> GGCGGTCTGGTCGGCAAGAG
GCGCCGCGGTGTACTACCAT -> AGCGCCGCGGTGTACTACCA
TAAATTCAGACAGATCGAAG -> TTAAATTCAGACAGATCGAA
TCAGGACCTACAACTGTGGT -> GTCAGGACCTACAACTGTGG
TGGTCCTCCAACATAAAAGC -> GTGGTCCTCCAACATAAAAG
TCACGTTCAGCATTTCGAAA -> ATCACGTTCAGCATTTCGAA
CCAACCAAGCGGTGTGGACT -> CCCAACCAAGCGGTGTGGAC
GTGCCCCTCACGACAGCCAT -> GGTGCCCCTCACGACAGCCA
GCACATTTCTCTATCAGCTC -> GGCACATTTCTCTATCAGCT
AGACGTAGACGAGACCACTG -> TAGACGTAGACGAGACCACT
GGTAGGAAAAATGCTGCTGG -> GGGTAGGAAAAATGCTGCTG
CACTACTGACTTCTGGCATA -> GCACTACTGACTTCTGGCAT
GTGGGAAGAACGTATCACCG -> AGTGGGAAGAACGTATCACC
TGGCGTCGTGTGGCACATTT -> TTGGCGTCGTGTGGCACATT
CTGTGGTTTGTATACAATCA -> ACTGTGGTTTGTATACAATC
CCGCACAGATCACACACGCT -> ACCGCACAGATCACACACGC
GCTACGGGGCTACGCACAAT -> GGCTACGGGGCTACGCACAA
CACTGCAAGTGAACCCACTT -> CCACTGCAAGTGAACCCACT
ACCTCGACCGCACAGATCAC -> GACCTCGACCGCACAGATCA
AACATAAAAGCATCCGGAAT -> CAACATAAAAGCATCCGGAA
TCCGGAATGGTCTATGGCTT -> ATCCGGAATGGTCTATGGCT
GTCGTGTGGCACATTTCTCT -> CGTCGTGTGGCACATTTCTC
TGATGTAGACAAGAAGTGTT -> GTGATGTAGACAAGAAGTGT
AAAGCAGTTTGGATCGCACT -> TAAAGCAGTTTGGATCGCAC
ACAAGATCATTACGGATTGG -> AACAAGATCATTACGGATTG
CACACGCTGGCGGTCTGGTC -> ACACACGCTGGCGGTCTGGT
TTATCTCGAAATCTTCCGTG -> ATTATCTCGAAATCTTCCGT
CCCCACTCGGGGCAGTAGTC -> GCCCCACTCGGGGCAGTAGT
GTAGACGAGACCACTGCAAG -> CGTAGACGAGACCACTGCAA
ACTGGCTCTGCCTCTTGATA -> GACTGGCTCTGCCTCTTGAT
CAGGATTATCTCGAAATCTT -> CCAGGATTATCTCGAAATCT
CGTCGAGGCGGGTCAGGACC -> GCGTCGAGGCGGGTCAGGAC
ACAGATCACACACGCTGGCG -> CACAGATCACACACGCTGGC
TATTCCACAAGCAATGCCAG -> CTATTCCACAAGCAATGCCA
AATTGTAGCCGACAACTGCA -> TAATTGTAGCCGACAACTGC
ACTCCGGATCCTCGCACTCG -> GACTCCGGATCCTCGCACTC
GGAGTGATGTAGACAAGAAG -> AGGAGTGATGTAGACAAGAA
CCCAACCAAGCGGTGTGGAC -> TCCCAACCAAGCGGTGTGGA
ACTGCAGACTCCGGATCCTC -> AACTGCAGACTCCGGATCCT
TTGTGAGTTGGAAGACGCAA -> CTTGTGAGTTGGAAGACGCA
GCCCCACTCGGGGCAGTAGT -> GGCCCCACTCGGGGCAGTAG
CCACTGCAAGTGAACCCACT -> ACCACTGCAAGTGAACCCAC
GCGTCGTGTGGCACATTTCT -> GGCGTCGTGTGGCACATTTC
TCTGGGCGGCCTAGCTGGCC -> CTCTGGGCGGCCTAGCTGGC
AGACAGATCGAAGGGTAGGA -> CAGACAGATCGAAGGGTAGG
CGGTCAGTGCGCGTCCTAAC -> GCGGTCAGTGCGCGTCCTAA
CGGGGCAGTAGTCAGTGGCA -> TCGGGGCAGTAGTCAGTGGC
GAAGGGTAGGAAAAATGCTG -> CGAAGGGTAGGAAAAATGCT
ACCCACTTGTGAGTTGGAAG -> AACCCACTTGTGAGTTGGAA
CAGGCGTCGGGCTACCAAGC -> ACAGGCGTCGGGCTACCAAG
ATGCTGCTGGTATCTGGCGA -> AATGCTGCTGGTATCTGGCG
ACGAGACCACTGCAAGTGAA -> GACGAGACCACTGCAAGTGA
GGAAGAACGTATCACCGACC -> GGGAAGAACGTATCACCGAC
AGACGGTCCGTACAGGCGTC -> TAGACGGTCCGTACAGGCGT
ATACCCGGGCGCGCCAACCA -> AATACCCGGGCGCGCCAACC
GCATTTCGAAACAAATTGGC -> AGCATTTCGAAACAAATTGG
GCTGGCGGTCTGGTCGGCAA -> CGCTGGCGGTCTGGTCGGCA
TTTCTCTATCAGCTCGGCGT -> ATTTCTCTATCAGCTCGGCG
CGCGTCTTTTCGGCCCCACT -> CCGCGTCTTTTCGGCCCCAC
GCAATGGGGCTACGGGGCTA -> AGCAATGGGGCTACGGGGCT
TCCTCCAACATAAAAGCATC -> GTCCTCCAACATAAAAGCAT
ACCTACAACTGTGGTTTGTA -> GACCTACAACTGTGGTTTGT
AACCAAGCGGTGTGGACTAA -> CAACCAAGCGGTGTGGACTA
CCTTCCCGCGTCTTTTCGGC -> GCCTTCCCGCGTCTTTTCGG
CCGACCTCGACCGCACAGAT -> ACCGACCTCGACCGCACAGA
CGAGCTGTTAATTGTAGCCG -> TCGAGCTGTTAATTGTAGCC
CCGGGCGCGCCAACCACATC -> CCCGGGCGCGCCAACCACAT
GCATCCGGAATGGTCTATGG -> AGCATCCGGAATGGTCTATG
AAGCAATGGGGCTACGGGGC -> CAAGCAATGGGGCTACGGGG
CGTTCAGCATTTCGAAACAA -> ACGTTCAGCATTTCGAAACA
GCGCTTGGTGATAGGTGGCG -> AGCGCTTGGTGATAGGTGGC
GACTAAAGCAGTTTGGATCG -> GGACTAAAGCAGTTTGGATC
GTCCTAACGAGTCCACCAGG -> CGTCCTAACGAGTCCACCAG
TCTCGAAATCTTCCGTGGTC -> ATCTCGAAATCTTCCGTGGT
GGAATGGTCTATGGCTTTGA -> CGGAATGGTCTATGGCTTTG
AAACAAATTGGCGGTCAGTG -> GAAACAAATTGGCGGTCAGT
CTGCAGACTCCGGATCCTCG -> ACTGCAGACTCCGGATCCTC
GCTGTTAATTGTAGCCGACA -> AGCTGTTAATTGTAGCCGAC
GATTGAGAAAGCGGAGTTAA -> TGATTGAGAAAGCGGAGTTA
GTACTACCATGAGATGTTAC -> TGTACTACCATGAGATGTTA
AGTGATGTAGACAAGAAGTG -> GAGTGATGTAGACAAGAAGT
GTTACAACAACGTCTTCCGA -> TGTTACAACAACGTCTTCCG
GCAAGAGCCATAGCGCCGCG -> GGCAAGAGCCATAGCGCCGC
GGGCGGCCTAGCTGGCCGGG -> TGGGCGGCCTAGCTGGCCGG
ACCATGAGATGTTACAACAA -> TACCATGAGATGTTACAACA
CCCGGGCGCGCCAACCACAT -> ACCCGGGCGCGCCAACCACA
GGCGGGTCAGGACCTACAAC -> AGGCGGGTCAGGACCTACAA
GTCCGTGATGAGGCGGATCA -> GGTCCGTGATGAGGCGGATC
AGTAGTCAGTGGCAGCAGGC -> CAGTAGTCAGTGGCAGCAGG
CCACATCCCAACCAAGCGGT -> ACCACATCCCAACCAAGCGG
ATGGTCTATGGCTTTGAAAT -> AATGGTCTATGGCTTTGAAA
CGTCGTGTGGCACATTTCTC -> GCGTCGTGTGGCACATTTCT
AGTGCGCGTCCTAACGAGTC -> CAGTGCGCGTCCTAACGAGT
GTCTTCCGAACTTAAATTCA -> CGTCTTCCGAACTTAAATTC
AACCTACCCCTGAGGGTGCC -> TAACCTACCCCTGAGGGTGC
GTATCTGGCGACTGGCTCTG -> GGTATCTGGCGACTGGCTCT
TTCCGAACTTAAATTCAGAC -> CTTCCGAACTTAAATTCAGA
TATAATAGACGGTCCGTACA -> GTATAATAGACGGTCCGTAC
CGTCGGGCTACCAAGCAATG -> GCGTCGGGCTACCAAGCAAT
GTGATGAGGCGGATCAGGTA -> CGTGATGAGGCGGATCAGGT
CAATCACGTTCAGCATTTCG -> ACAATCACGTTCAGCATTTC
CTATTCCACAAGCAATGCCA -> GCTATTCCACAAGCAATGCC
AGCAATGGGGCTACGGGGCT -> AAGCAATGGGGCTACGGGGC
AAGCGGTGTGGACTAAAGCA -> CAAGCGGTGTGGACTAAAGC
GTTGGAAGACGCAATGAAGT -> AGTTGGAAGACGCAATGAAG
TCTTCCGTGGTCCTCCAACA -> ATCTTCCGTGGTCCTCCAAC
TCCCGCGTCTTTTCGGCCCC -> TTCCCGCGTCTTTTCGGCCC
CTTTGAAATACCCGGGCGCG -> GCTTTGAAATACCCGGGCGC
AGGCGGGTCAGGACCTACAA -> GAGGCGGGTCAGGACCTACA
TTTAATCCGGTCCGTGATGA -> ATTTAATCCGGTCCGTGATG
GCTGGCCGGGGGAAATTGAG -> AGCTGGCCGGGGGAAATTGA
AGTCCACCAGGGCTCAAAAT -> GAGTCCACCAGGGCTCAAAA
CATAAAAGCATCCGGAATGG -> ACATAAAAGCATCCGGAATG
AGTTGGAAGACGCAATGAAG -> GAGTTGGAAGACGCAATGAA
ATGTAGACAAGAAGTGTTAA -> GATGTAGACAAGAAGTGTTA
GATCCTCGCACTCGATCGTG -> GGATCCTCGCACTCGATCGT
CGAAATCTTCCGTGGTCCTC -> TCGAAATCTTCCGTGGTCCT
CCGGGGGAAATTGAGGAGTG -> GCCGGGGGAAATTGAGGAGT
CCCACTTGTGAGTTGGAAGA -> ACCCACTTGTGAGTTGGAAG
TCGCGGCCGTAACAACAAGA -> TTCGCGGCCGTAACAACAAG
TAACAACAAGATCATTACGG -> GTAACAACAAGATCATTACG
GGCCGTAACAACAAGATCAT -> CGGCCGTAACAACAAGATCA
GCGGTCAGTGCGCGTCCTAA -> GGCGGTCAGTGCGCGTCCTA
CGACCGCACAGATCACACAC -> TCGACCGCACAGATCACACA
ACTTAAATTCAGACAGATCG -> AACTTAAATTCAGACAGATC
CTACGCACAATTCGTTTACG -> GCTACGCACAATTCGTTTAC
ACAAGAAGTGTTAAAAAATC -> GACAAGAAGTGTTAAAAAAT
TCATTACGGATTGGCGTCGT -> ATCATTACGGATTGGCGTCG
CGCCTTCCCGCGTCTTTTCG -> ACGCCTTCCCGCGTCTTTTC
AGCAGGCTATTCCACAAGCA -> CAGCAGGCTATTCCACAAGC
CGGTCCGTGATGAGGCGGAT -> CCGGTCCGTGATGAGGCGGA
TATCTGGCGACTGGCTCTGC -> GTATCTGGCGACTGGCTCTG
ATGCCAGCGCACTACTGACT -> AATGCCAGCGCACTACTGAC
CGGTCCGTACAGGCGTCGGG -> ACGGTCCGTACAGGCGTCGG
GCGTCGAGGCGGGTCAGGAC -> GGCGTCGAGGCGGGTCAGGA
ACGTTGTAACACTGTGCCAC -> TACGTTGTAACACTGTGCCA
GTGTTAAAAAATCGAGCTGT -> AGTGTTAAAAAATCGAGCTG
CTGAGGGTGCCCCTCACGAC -> CCTGAGGGTGCCCCTCACGA
TATTTAATCCGGTCCGTGAT -> CTATTTAATCCGGTCCGTGA
GAAGACGCAATGAAGTGGGA -> GGAAGACGCAATGAAGTGGG
TTAGCGCTTGGTGATAGGTG -> GTTAGCGCTTGGTGATAGGT
CGGGGGAAATTGAGGAGTGA -> CCGGGGGAAATTGAGGAGTG
AGACTCCGGATCCTCGCACT -> CAGACTCCGGATCCTCGCAC
CAACAACGTCTTCCGAACTT -> ACAACAACGTCTTCCGAACT
CAGGGCTCAAAATCCTATTT -> CCAGGGCTCAAAATCCTATT
ACGCCCTCCAGGGCCAGGAT -> GACGCCCTCCAGGGCCAGGA
TGCCAGCGCACTACTGACTT -> ATGCCAGCGCACTACTGACT
GCCAACCACATCCCAACCAA -> CGCCAACCACATCCCAACCA
ACAGGCGTCGGGCTACCAAG -> TACAGGCGTCGGGCTACCAA
ACACGCTGGCGGTCTGGTCG -> CACACGCTGGCGGTCTGGTC
TGATAGGCGTCGAGGCGGGT -> TTGATAGGCGTCGAGGCGGG
TGGCATACGTTGTAACACTG -> CTGGCATACGTTGTAACACT
GGGGCTACGGGGCTACGCAC -> TGGGGCTACGGGGCTACGCA
GGCGACGCCCTCCAGGGCCA -> TGGCGACGCCCTCCAGGGCC
CGGGCTACCAAGCAATGGGG -> TCGGGCTACCAAGCAATGGG
GCCGTAACAACAAGATCATT -> GGCCGTAACAACAAGATCAT
GCGCACTACTGACTTCTGGC -> AGCGCACTACTGACTTCTGG
TCGGCCCCACTCGGGGCAGT -> TTCGGCCCCACTCGGGGCAG
TGGCGACGCCCTCCAGGGCC -> GTGGCGACGCCCTCCAGGGC
CGCTGGCGGTCTGGTCGGCA -> ACGCTGGCGGTCTGGTCGGC
TGGCACATTTCTCTATCAGC -> GTGGCACATTTCTCTATCAG
CTCGCACTCGATCGTGATTG -> CCTCGCACTCGATCGTGATT
GGTCGGCAAGAGCCATAGCG -> TGGTCGGCAAGAGCCATAGC
ATCAGGTATAATAGACGGTC -> GATCAGGTATAATAGACGGT
TGGAAGACGCAATGAAGTGG -> TTGGAAGACGCAATGAAGTG
AAGCGGAGTTAACCTACCCC -> AAAGCGGAGTTAACCTACCC
ACAACTGTGGTTTGTATACA -> TACAACTGTGGTTTGTATAC
CAAATTGGCGGTCAGTGCGC -> ACAAATTGGCGGTCAGTGCG
GGACCTACAACTGTGGTTTG -> AGGACCTACAACTGTGGTTT
CACATTTCTCTATCAGCTCG -> GCACATTTCTCTATCAGCTC
GCAGCAGGCTATTCCACAAG -> GGCAGCAGGCTATTCCACAA
TCGATCGTGATTGAGAAAGC -> CTCGATCGTGATTGAGAAAG
TAAAAAATCGAGCTGTTAAT -> TTAAAAAATCGAGCTGTTAA
CGCCCTCCAGGGCCAGGATT -> ACGCCCTCCAGGGCCAGGAT
GACCACTGCAAGTGAACCCA -> AGACCACTGCAAGTGAACCC
GGGCTACGGGGCTACGCACA -> GGGGCTACGGGGCTACGCAC
TTTGTATACAATCACGTTCA -> GTTTGTATACAATCACGTTC
TGCCCCTCACGACAGCCATG -> GTGCCCCTCACGACAGCCAT
CCGTACAGGCGTCGGGCTAC -> TCCGTACAGGCGTCGGGCTA
GGAAGACGCAATGAAGTGGG -> TGGAAGACGCAATGAAGTGG
TTTGGATCGCACTCCGGAGA -> GTTTGGATCGCACTCCGGAG
AGACGAGACCACTGCAAGTG -> TAGACGAGACCACTGCAAGT
CGTCTCTGGGCGGCCTAGCT -> GCGTCTCTGGGCGGCCTAGC
TATACAATCACGTTCAGCAT -> GTATACAATCACGTTCAGCA
TTGGTGATAGGTGGCGACGC -> CTTGGTGATAGGTGGCGACG
TCCAGGGCCAGGATTATCTC -> CTCCAGGGCCAGGATTATCT
ACTACTGACTTCTGGCATAC -> CACTACTGACTTCTGGCATA
TGTAGCCGACAACTGCAGAC -> TTGTAGCCGACAACTGCAGA
GAGGAGTGATGTAGACAAGA -> TGAGGAGTGATGTAGACAAG
TCTATGGCTTTGAAATACCC -> GTCTATGGCTTTGAAATACC
CAGCGCACTACTGACTTCTG -> CCAGCGCACTACTGACTTCT
CGCAATGAAGTGGGAAGAAC -> ACGCAATGAAGTGGGAAGAA
GTCTCTGGGCGGCCTAGCTG -> CGTCTCTGGGCGGCCTAGCT
GCCGCGGTGTACTACCATGA -> CGCCGCGGTGTACTACCATG
CACAAGCAATGCCAGCGCAC -> CCACAAGCAATGCCAGCGCA
TCACACACGCTGGCGGTCTG -> ATCACACACGCTGGCGGTCT
ATAATAGACGGTCCGTACAG -> TATAATAGACGGTCCGTACA
TGGTATCTGGCGACTGGCTC -> CTGGTATCTGGCGACTGGCT
TGTTAAAAAATCGAGCTGTT -> GTGTTAAAAAATCGAGCTGT
CGACAGCCATGTTAGCGCTT -> ACGACAGCCATGTTAGCGCT
GTAGTCAGTGGCAGCAGGCT -> AGTAGTCAGTGGCAGCAGGC
GCGTCGGGCTACCAAGCAAT -> GGCGTCGGGCTACCAAGCAA
GGGCTACGCACAATTCGTTT -> GGGGCTACGCACAATTCGTT
CGTAACAACAAGATCATTAC -> CCGTAACAACAAGATCATTA
AACAACGTCTTCCGAACTTA -> CAACAACGTCTTCCGAACTT
AAAATCGAGCTGTTAATTGT -> AAAAATCGAGCTGTTAATTG
ACCAAGCGGTGTGGACTAAA -> AACCAAGCGGTGTGGACTAA
TCTTCCGAACTTAAATTCAG -> GTCTTCCGAACTTAAATTCA
GTCGAGGCGGGTCAGGACCT -> CGTCGAGGCGGGTCAGGACC
TGATTGAGAAAGCGGAGTTA -> GTGATTGAGAAAGCGGAGTT
CGACGCCCTCCAGGGCCAGG -> GCGACGCCCTCCAGGGCCAG
CATTTCGAAACAAATTGGCG -> GCATTTCGAAACAAATTGGC
CTTAAATTCAGACAGATCGA -> ACTTAAATTCAGACAGATCG
GCGGCCGTAACAACAAGATC -> CGCGGCCGTAACAACAAGAT
CCGTGGTCCTCCAACATAAA -> TCCGTGGTCCTCCAACATAA
AAGAAGTGTTAAAAAATCGA -> CAAGAAGTGTTAAAAAATCG
AGATCATTACGGATTGGCGT -> AAGATCATTACGGATTGGCG
GGCGGCCTAGCTGGCCGGGG -> GGGCGGCCTAGCTGGCCGGG
TTGAGGAGTGATGTAGACAA -> ATTGAGGAGTGATGTAGACA
GCGGCCTAGCTGGCCGGGGG -> GGCGGCCTAGCTGGCCGGGG
CTCAAAATCCTATTTAATCC -> GCTCAAAATCCTATTTAATC
TCCTAACGAGTCCACCAGGG -> GTCCTAACGAGTCCACCAGG
ATCCCAACCAAGCGGTGTGG -> CATCCCAACCAAGCGGTGTG
CAGTGCGCGTCCTAACGAGT -> TCAGTGCGCGTCCTAACGAG
CCGGAATGGTCTATGGCTTT -> TCCGGAATGGTCTATGGCTT
TCGTGATTGAGAAAGCGGAG -> ATCGTGATTGAGAAAGCGGA
CCACTCGGGGCAGTAGTCAG -> CCCACTCGGGGCAGTAGTCA
AATTCGTTTACGCCTTCCCG -> CAATTCGTTTACGCCTTCCC
CAGTGGCAGCAGGCTATTCC -> TCAGTGGCAGCAGGCTATTC
TCAGCTCGGCGTCTCTGGGC -> ATCAGCTCGGCGTCTCTGGG
GCCGACAACTGCAGACTCCG -> AGCCGACAACTGCAGACTCC
AAGCATCCGGAATGGTCTAT -> AAAGCATCCGGAATGGTCTA
TCGGGGCAGTAGTCAGTGGC -> CTCGGGGCAGTAGTCAGTGG
TTGAAATACCCGGGCGCGCC -> TTTGAAATACCCGGGCGCGC
TTCGGCCCCACTCGGGGCAG -> TTTCGGCCCCACTCGGGGCA
GGGTAGGAAAAATGCTGCTG -> AGGGTAGGAAAAATGCTGCT
GGCGTCGAGGCGGGTCAGGA -> AGGCGTCGAGGCGGGTCAGG
TGGCAGCAGGCTATTCCACA -> GTGGCAGCAGGCTATTCCAC
GATCATTACGGATTGGCGTC -> AGATCATTACGGATTGGCGT
TACGGGGCTACGCACAATTC -> CTACGGGGCTACGCACAATT
ACTGACTTCTGGCATACGTT -> TACTGACTTCTGGCATACGT
CTTCCGTGGTCCTCCAACAT -> TCTTCCGTGGTCCTCCAACA
CCTATTTAATCCGGTCCGTG -> TCCTATTTAATCCGGTCCGT
CGCGTCCTAACGAGTCCACC -> GCGCGTCCTAACGAGTCCAC
CGAACTTAAATTCAGACAGA -> CCGAACTTAAATTCAGACAG
GAAACAAATTGGCGGTCAGT -> CGAAACAAATTGGCGGTCAG
CATCCCAACCAAGCGGTGTG -> ACATCCCAACCAAGCGGTGT
CGCTTGGTGATAGGTGGCGA -> GCGCTTGGTGATAGGTGGCG
CAGGACCTACAACTGTGGTT -> TCAGGACCTACAACTGTGGT
AGACAAGAAGTGTTAAAAAA -> TAGACAAGAAGTGTTAAAAA
CAACTGTGGTTTGTATACAA -> ACAACTGTGGTTTGTATACA
ATGTTAGCGCTTGGTGATAG -> CATGTTAGCGCTTGGTGATA
TAGCTGGCCGGGGGAAATTG -> CTAGCTGGCCGGGGGAAATT
ACATAAAAGCATCCGGAATG -> AACATAAAAGCATCCGGAAT
GGTGGCGACGCCCTCCAGGG -> AGGTGGCGACGCCCTCCAGG
GCACTCGATCGTGATTGAGA -> CGCACTCGATCGTGATTGAG
GCTTTGAAATACCCGGGCGC -> GGCTTTGAAATACCCGGGCG
TTCCACAAGCAATGCCAGCG -> ATTCCACAAGCAATGCCAGC
ACGGTCCGTACAGGCGTCGG -> GACGGTCCGTACAGGCGTCG
ATTTCGAAACAAATTGGCGG -> CATTTCGAAACAAATTGGCG
CAACTGCAGACTCCGGATCC -> ACAACTGCAGACTCCGGATC
TCAAAATCCTATTTAATCCG -> CTCAAAATCCTATTTAATCC
ATTGAGAAAGCGGAGTTAAC -> GATTGAGAAAGCGGAGTTAA
GCAGTTTGGATCGCACTCCG -> AGCAGTTTGGATCGCACTCC
GAGGCGGGTCAGGACCTACA -> CGAGGCGGGTCAGGACCTAC
CGTCCTAACGAGTCCACCAG -> GCGTCCTAACGAGTCCACCA
TTCAGACAGATCGAAGGGTA -> ATTCAGACAGATCGAAGGGT
GCGGTGTGGACTAAAGCAGT -> AGCGGTGTGGACTAAAGCAG
GAGGGTGCCCCTCACGACAG -> TGAGGGTGCCCCTCACGACA
ATAGACGGTCCGTACAGGCG -> AATAGACGGTCCGTACAGGC
ACAACGTCTTCCGAACTTAA -> AACAACGTCTTCCGAACTTA
ACTAAAGCAGTTTGGATCGC -> GACTAAAGCAGTTTGGATCG
GGCTCTGCCTCTTGATAGGC -> TGGCTCTGCCTCTTGATAGG
GACAACTGCAGACTCCGGAT -> CGACAACTGCAGACTCCGGA
CTACCAAGCAATGGGGCTAC -> GCTACCAAGCAATGGGGCTA
ACTGCAAGTGAACCCACTTG -> CACTGCAAGTGAACCCACTT
CAGATCACACACGCTGGCGG -> ACAGATCACACACGCTGGCG
CTCTGGGCGGCCTAGCTGGC -> TCTCTGGGCGGCCTAGCTGG
GCTATTCCACAAGCAATGCC -> GGCTATTCCACAAGCAATGC
CAGCTCGGCGTCTCTGGGCG -> TCAGCTCGGCGTCTCTGGGC
TAAAAGCATCCGGAATGGTC -> ATAAAAGCATCCGGAATGGT
CGAGGCGGGTCAGGACCTAC -> TCGAGGCGGGTCAGGACCTA
AAGGGTAGGAAAAATGCTGC -> GAAGGGTAGGAAAAATGCTG
CAAGTGAACCCACTTGTGAG -> GCAAGTGAACCCACTTGTGA
TGAACCCACTTGTGAGTTGG -> GTGAACCCACTTGTGAGTTG
AATCACGTTCAGCATTTCGA -> CAATCACGTTCAGCATTTCG
GGCGGTCTGGTCGGCAAGAG -> TGGCGGTCTGGTCGGCAAGA
GCCAGGATTATCTCGAAATC -> GGCCAGGATTATCTCGAAAT
GATAGACGTAGACGAGACCA -> AGATAGACGTAGACGAGACC
AATGCTGCTGGTATCTGGCG -> AAATGCTGCTGGTATCTGGC
GGAGTTAACCTACCCCTGAG -> CGGAGTTAACCTACCCCTGA
CTTGATAGGCGTCGAGGCGG -> TCTTGATAGGCGTCGAGGCG
CAGATCGAAGGGTAGGAAAA -> ACAGATCGAAGGGTAGGAAA
CTCTGCCTCTTGATAGGCGT -> GCTCTGCCTCTTGATAGGCG
GACGCAATGAAGTGGGAAGA -> AGACGCAATGAAGTGGGAAG
CCATGAGATGTTACAACAAC -> ACCATGAGATGTTACAACAA
CACGCTGGCGGTCTGGTCGG -> ACACGCTGGCGGTCTGGTCG
AGAACGTATCACCGACCTCG -> AAGAACGTATCACCGACCTC
CATTTCTCTATCAGCTCGGC -> ACATTTCTCTATCAGCTCGG
GTCAGTGGCAGCAGGCTATT -> AGTCAGTGGCAGCAGGCTAT
CAGCATTTCGAAACAAATTG -> TCAGCATTTCGAAACAAATT
TCTCTGGGCGGCCTAGCTGG -> GTCTCTGGGCGGCCTAGCTG
TACAACAACGTCTTCCGAAC -> TTACAACAACGTCTTCCGAA
AATAGACGGTCCGTACAGGC -> TAATAGACGGTCCGTACAGG
TCCGGTCCGTGATGAGGCGG -> ATCCGGTCCGTGATGAGGCG
GGATTATCTCGAAATCTTCC -> AGGATTATCTCGAAATCTTC
TTCAGCATTTCGAAACAAAT -> GTTCAGCATTTCGAAACAAA
GGCATACGTTGTAACACTGT -> TGGCATACGTTGTAACACTG
GAAATCTTCCGTGGTCCTCC -> CGAAATCTTCCGTGGTCCTC
TACAGGCGTCGGGCTACCAA -> GTACAGGCGTCGGGCTACCA
GAAGTGGGAAGAACGTATCA -> TGAAGTGGGAAGAACGTATC
GACCGCACAGATCACACACG -> CGACCGCACAGATCACACAC
GAGATGTTACAACAACGTCT -> TGAGATGTTACAACAACGTC
TTTACGCCTTCCCGCGTCTT -> GTTTACGCCTTCCCGCGTCT
AAATACCCGGGCGCGCCAAC -> GAAATACCCGGGCGCGCCAA
CGATCGTGATTGAGAAAGCG -> TCGATCGTGATTGAGAAAGC
CTGACTTCTGGCATACGTTG -> ACTGACTTCTGGCATACGTT
CCACTTGTGAGTTGGAAGAC -> CCCACTTGTGAGTTGGAAGA
TTCGTTTACGCCTTCCCGCG -> ATTCGTTTACGCCTTCCCGC
CCACCAGGGCTCAAAATCCT -> TCCACCAGGGCTCAAAATCC
AGACGCAATGAAGTGGGAAG -> AAGACGCAATGAAGTGGGAA
CCGTGATGAGGCGGATCAGG -> TCCGTGATGAGGCGGATCAG
GTTTACGCCTTCCCGCGTCT -> CGTTTACGCCTTCCCGCGTC
AAGTGGGAAGAACGTATCAC -> GAAGTGGGAAGAACGTATCA
CATGAGATGTTACAACAACG -> CCATGAGATGTTACAACAAC
ACGGATTGGCGTCGTGTGGC -> TACGGATTGGCGTCGTGTGG
CCGCGGTGTACTACCATGAG -> GCCGCGGTGTACTACCATGA
GTTAATTGTAGCCGACAACT -> TGTTAATTGTAGCCGACAAC
GCGGTGTACTACCATGAGAT -> CGCGGTGTACTACCATGAGA
ATGAAGTGGGAAGAACGTAT -> AATGAAGTGGGAAGAACGTA
CCGGTCCGTGATGAGGCGGA -> TCCGGTCCGTGATGAGGCGG
AACGTATCACCGACCTCGAC -> GAACGTATCACCGACCTCGA
CTGGCGGTCTGGTCGGCAAG -> GCTGGCGGTCTGGTCGGCAA
ATCACACACGCTGGCGGTCT -> GATCACACACGCTGGCGGTC
TCTGCCTCTTGATAGGCGTC -> CTCTGCCTCTTGATAGGCGT
GGCTTTGAAATACCCGGGCG -> TGGCTTTGAAATACCCGGGC
ATCTTCCGTGGTCCTCCAAC -> AATCTTCCGTGGTCCTCCAA
GTCCGTACAGGCGTCGGGCT -> GGTCCGTACAGGCGTCGGGC
CTATTTAATCCGGTCCGTGA -> CCTATTTAATCCGGTCCGTG
GCCAGCGCACTACTGACTTC -> TGCCAGCGCACTACTGACTT
AGAAAGCGGAGTTAACCTAC -> GAGAAAGCGGAGTTAACCTA
CTCGGCGTCTCTGGGCGGCC -> GCTCGGCGTCTCTGGGCGGC
GTGATGTAGACAAGAAGTGT -> AGTGATGTAGACAAGAAGTG
AGGTGGCGACGCCCTCCAGG -> TAGGTGGCGACGCCCTCCAG
GGGCCAGGATTATCTCGAAA -> AGGGCCAGGATTATCTCGAA
ATCACCGACCTCGACCGCAC -> TATCACCGACCTCGACCGCA
CATAGCGCCGCGGTGTACTA -> CCATAGCGCCGCGGTGTACT
TAATCCGGTCCGTGATGAGG -> TTAATCCGGTCCGTGATGAG
TGTAGACAAGAAGTGTTAAA -> ATGTAGACAAGAAGTGTTAA
CAGACTCCGGATCCTCGCAC -> GCAGACTCCGGATCCTCGCA
GAACCCACTTGTGAGTTGGA -> TGAACCCACTTGTGAGTTGG
ACCAGGGCTCAAAATCCTAT -> CACCAGGGCTCAAAATCCTA
CACGACAGCCATGTTAGCGC -> TCACGACAGCCATGTTAGCG
AACCCACTTGTGAGTTGGAA -> GAACCCACTTGTGAGTTGGA
AGGGTGCCCCTCACGACAGC -> GAGGGTGCCCCTCACGACAG
TGACTTCTGGCATACGTTGT -> CTGACTTCTGGCATACGTTG
GGTTTGTATACAATCACGTT -> TGGTTTGTATACAATCACGT
CGTGATTGAGAAAGCGGAGT -> TCGTGATTGAGAAAGCGGAG
CTCTTGATAGGCGTCGAGGC -> CCTCTTGATAGGCGTCGAGG
ACCCGGGCGCGCCAACCACA -> TACCCGGGCGCGCCAACCAC
GAGTTAACCTACCCCTGAGG -> GGAGTTAACCTACCCCTGAG
ATGAGGCGGATCAGGTATAA -> GATGAGGCGGATCAGGTATA
ATCGAAGGGTAGGAAAAATG -> GATCGAAGGGTAGGAAAAAT
ACTGTGGTTTGTATACAATC -> AACTGTGGTTTGTATACAAT
CGTACAGGCGTCGGGCTACC -> CCGTACAGGCGTCGGGCTAC
GGCTCAAAATCCTATTTAAT -> GGGCTCAAAATCCTATTTAA
GGCGTCTCTGGGCGGCCTAG -> CGGCGTCTCTGGGCGGCCTA
GGGTCAGGACCTACAACTGT -> CGGGTCAGGACCTACAACTG
GACCTACAACTGTGGTTTGT -> GGACCTACAACTGTGGTTTG
GGGCAGTAGTCAGTGGCAGC -> GGGGCAGTAGTCAGTGGCAG
TAGACAAGAAGTGTTAAAAA -> GTAGACAAGAAGTGTTAAAA
AAGAACGTATCACCGACCTC -> GAAGAACGTATCACCGACCT
CAACAAGATCATTACGGATT -> ACAACAAGATCATTACGGAT
TAGCGCTTGGTGATAGGTGG -> TTAGCGCTTGGTGATAGGTG
GGGGCAGTAGTCAGTGGCAG -> CGGGGCAGTAGTCAGTGGCA
CTCTATCAGCTCGGCGTCTC -> TCTCTATCAGCTCGGCGTCT
TACGCCTTCCCGCGTCTTTT -> TTACGCCTTCCCGCGTCTTT
ATTATCTCGAAATCTTCCGT -> GATTATCTCGAAATCTTCCG
CCCTCACGACAGCCATGTTA -> CCCCTCACGACAGCCATGTT
TAACCTACCCCTGAGGGTGC -> TTAACCTACCCCTGAGGGTG
TCACCGACCTCGACCGCACA -> ATCACCGACCTCGACCGCAC
GCGTCCTAACGAGTCCACCA -> CGCGTCCTAACGAGTCCACC
GTAGGAAAAATGCTGCTGGT -> GGTAGGAAAAATGCTGCTGG
ATACAATCACGTTCAGCATT -> TATACAATCACGTTCAGCAT
GCTGCTGGTATCTGGCGACT -> TGCTGCTGGTATCTGGCGAC
CCGGAGATAGACGTAGACGA -> TCCGGAGATAGACGTAGACG
CTATCAGCTCGGCGTCTCTG -> TCTATCAGCTCGGCGTCTCT
TGTGGACTAAAGCAGTTTGG -> GTGTGGACTAAAGCAGTTTG
ATAGGCGTCGAGGCGGGTCA -> GATAGGCGTCGAGGCGGGTC
CGCACTCCGGAGATAGACGT -> TCGCACTCCGGAGATAGACG
GGTCCGTACAGGCGTCGGGC -> CGGTCCGTACAGGCGTCGGG
GGCTACCAAGCAATGGGGCT -> GGGCTACCAAGCAATGGGGC
AGCGCCGCGGTGTACTACCA -> TAGCGCCGCGGTGTACTACC
TAATTGTAGCCGACAACTGC -> TTAATTGTAGCCGACAACTG
ACACACGCTGGCGGTCTGGT -> CACACACGCTGGCGGTCTGG
CAGGTATAATAGACGGTCCG -> TCAGGTATAATAGACGGTCC
ATCGTGATTGAGAAAGCGGA -> GATCGTGATTGAGAAAGCGG
TAGCGCCGCGGTGTACTACC -> ATAGCGCCGCGGTGTACTAC
TCGTTTACGCCTTCCCGCGT -> TTCGTTTACGCCTTCCCGCG
GTGTGGCACATTTCTCTATC -> CGTGTGGCACATTTCTCTAT
GGGCGCGCCAACCACATCCC -> CGGGCGCGCCAACCACATCC
TGGCTTTGAAATACCCGGGC -> ATGGCTTTGAAATACCCGGG
CGTGATGAGGCGGATCAGGT -> CCGTGATGAGGCGGATCAGG
AGTGAACCCACTTGTGAGTT -> AAGTGAACCCACTTGTGAGT
TCTGGCGACTGGCTCTGCCT -> ATCTGGCGACTGGCTCTGCC
GACTTCTGGCATACGTTGTA -> TGACTTCTGGCATACGTTGT
GCAGGCTATTCCACAAGCAA -> AGCAGGCTATTCCACAAGCA
CCAGCGCACTACTGACTTCT -> GCCAGCGCACTACTGACTTC
ATCACGTTCAGCATTTCGAA -> AATCACGTTCAGCATTTCGA
AAATCGAGCTGTTAATTGTA -> AAAATCGAGCTGTTAATTGT
AAATGCTGCTGGTATCTGGC -> AAAATGCTGCTGGTATCTGG
TGCTGGTATCTGGCGACTGG -> CTGCTGGTATCTGGCGACTG
CCGACAACTGCAGACTCCGG -> GCCGACAACTGCAGACTCCG
CCAAGCGGTGTGGACTAAAG -> ACCAAGCGGTGTGGACTAAA
ATCGCACTCCGGAGATAGAC -> GATCGCACTCCGGAGATAGA
CCTCGCACTCGATCGTGATT -> TCCTCGCACTCGATCGTGAT
GGATCAGGTATAATAGACGG -> CGGATCAGGTATAATAGACG
TGGGGCTACGGGGCTACGCA -> ATGGGGCTACGGGGCTACGC
GTACAGGCGTCGGGCTACCA -> CGTACAGGCGTCGGGCTACC
GGCAGTAGTCAGTGGCAGCA -> GGGCAGTAGTCAGTGGCAGC
CGACAACTGCAGACTCCGGA -> CCGACAACTGCAGACTCCGG
TCCGTGATGAGGCGGATCAG -> GTCCGTGATGAGGCGGATCA
CAACATAAAAGCATCCGGAA -> CCAACATAAAAGCATCCGGA
TCCCAACCAAGCGGTGTGGA -> ATCCCAACCAAGCGGTGTGG
CTGGCCGGGGGAAATTGAGG -> GCTGGCCGGGGGAAATTGAG
CGTAGACGAGACCACTGCAA -> ACGTAGACGAGACCACTGCA
GCCCTCCAGGGCCAGGATTA -> CGCCCTCCAGGGCCAGGATT
AGGCTATTCCACAAGCAATG -> CAGGCTATTCCACAAGCAAT
GATCGAAGGGTAGGAAAAAT -> AGATCGAAGGGTAGGAAAAA
TTTCGGCCCCACTCGGGGCA -> TTTTCGGCCCCACTCGGGGC
AACTTAAATTCAGACAGATC -> GAACTTAAATTCAGACAGAT
ATGAGATGTTACAACAACGT -> CATGAGATGTTACAACAACG
CCTCCAACATAAAAGCATCC -> TCCTCCAACATAAAAGCATC
CCAAGCAATGGGGCTACGGG -> ACCAAGCAATGGGGCTACGG
TGCAGACTCCGGATCCTCGC -> CTGCAGACTCCGGATCCTCG
CCACAAGCAATGCCAGCGCA -> TCCACAAGCAATGCCAGCGC
TTAATTGTAGCCGACAACTG -> GTTAATTGTAGCCGACAACT
GGTCTATGGCTTTGAAATAC -> TGGTCTATGGCTTTGAAATA
AATGGTCTATGGCTTTGAAA -> GAATGGTCTATGGCTTTGAA
CTGTTAATTGTAGCCGACAA -> GCTGTTAATTGTAGCCGACA
GGTCAGTGCGCGTCCTAACG -> CGGTCAGTGCGCGTCCTAAC
GTGGTCCTCCAACATAAAAG -> CGTGGTCCTCCAACATAAAA
AAATTGGCGGTCAGTGCGCG -> CAAATTGGCGGTCAGTGCGC
CGCCGCGGTGTACTACCATG -> GCGCCGCGGTGTACTACCAT
ACGTATCACCGACCTCGACC -> AACGTATCACCGACCTCGAC
ATCCGGTCCGTGATGAGGCG -> AATCCGGTCCGTGATGAGGC
CTGGCTCTGCCTCTTGATAG -> ACTGGCTCTGCCTCTTGATA
GTGGTTTGTATACAATCACG -> TGTGGTTTGTATACAATCAC
CTGCCTCTTGATAGGCGTCG -> TCTGCCTCTTGATAGGCGTC
GGCACATTTCTCTATCAGCT -> TGGCACATTTCTCTATCAGC
GAATGGTCTATGGCTTTGAA -> GGAATGGTCTATGGCTTTGA
TCCGAACTTAAATTCAGACA -> TTCCGAACTTAAATTCAGAC
ACGTTCAGCATTTCGAAACA -> CACGTTCAGCATTTCGAAAC
CAATGAAGTGGGAAGAACGT -> GCAATGAAGTGGGAAGAACG
TGGTCGGCAAGAGCCATAGC -> CTGGTCGGCAAGAGCCATAG
AGCTGGCCGGGGGAAATTGA -> TAGCTGGCCGGGGGAAATTG
GCTCGGCGTCTCTGGGCGGC -> AGCTCGGCGTCTCTGGGCGG
CGGTGTACTACCATGAGATG -> GCGGTGTACTACCATGAGAT
TTGTAGCCGACAACTGCAGA -> ATTGTAGCCGACAACTGCAG
GGTATCTGGCGACTGGCTCT -> TGGTATCTGGCGACTGGCTC
TACCCCTGAGGGTGCCCCTC -> CTACCCCTGAGGGTGCCCCT
GACTCCGGATCCTCGCACTC -> AGACTCCGGATCCTCGCACT
ACAGCCATGTTAGCGCTTGG -> GACAGCCATGTTAGCGCTTG
ACAATTCGTTTACGCCTTCC -> CACAATTCGTTTACGCCTTC
TCTTGATAGGCGTCGAGGCG -> CTCTTGATAGGCGTCGAGGC
GCGACTGGCTCTGCCTCTTG -> GGCGACTGGCTCTGCCTCTT
AAAATCCTATTTAATCCGGT -> CAAAATCCTATTTAATCCGG
TCGCACTCCGGAGATAGACG -> ATCGCACTCCGGAGATAGAC
GATCGCACTCCGGAGATAGA -> GGATCGCACTCCGGAGATAG
TCCGGAGATAGACGTAGACG -> CTCCGGAGATAGACGTAGAC
CGCGGTGTACTACCATGAGA -> CCGCGGTGTACTACCATGAG
TGAGAAAGCGGAGTTAACCT -> TTGAGAAAGCGGAGTTAACC
ACTCGGGGCAGTAGTCAGTG -> CACTCGGGGCAGTAGTCAGT
GCAATGAAGTGGGAAGAACG -> CGCAATGAAGTGGGAAGAAC
AATTGGCGGTCAGTGCGCGT -> AAATTGGCGGTCAGTGCGCG
AGATAGACGTAGACGAGACC -> GAGATAGACGTAGACGAGAC
CCGGATCCTCGCACTCGATC -> TCCGGATCCTCGCACTCGAT
CTGCAAGTGAACCCACTTGT -> ACTGCAAGTGAACCCACTTG
GCGGGTCAGGACCTACAACT -> GGCGGGTCAGGACCTACAAC
CGGCCCCACTCGGGGCAGTA -> TCGGCCCCACTCGGGGCAGT
CGAAGGGTAGGAAAAATGCT -> TCGAAGGGTAGGAAAAATGC
GGCAGCAGGCTATTCCACAA -> TGGCAGCAGGCTATTCCACA
CGCACAGATCACACACGCTG -> CCGCACAGATCACACACGCT
CTTCTGGCATACGTTGTAAC -> ACTTCTGGCATACGTTGTAA
TGGGAAGAACGTATCACCGA -> GTGGGAAGAACGTATCACCG
ATCATTACGGATTGGCGTCG -> GATCATTACGGATTGGCGTC
AATGAAGTGGGAAGAACGTA -> CAATGAAGTGGGAAGAACGT
CTCCAACATAAAAGCATCCG -> CCTCCAACATAAAAGCATCC
TGCCTCTTGATAGGCGTCGA -> CTGCCTCTTGATAGGCGTCG
GATAGGCGTCGAGGCGGGTC -> TGATAGGCGTCGAGGCGGGT
AGGATTATCTCGAAATCTTC -> CAGGATTATCTCGAAATCTT
TGTTAGCGCTTGGTGATAGG -> ATGTTAGCGCTTGGTGATAG
GCACAGATCACACACGCTGG -> CGCACAGATCACACACGCTG
GGCAAGAGCCATAGCGCCGC -> CGGCAAGAGCCATAGCGCCG
GATGAGGCGGATCAGGTATA -> TGATGAGGCGGATCAGGTAT
ACATTTCTCTATCAGCTCGG -> CACATTTCTCTATCAGCTCG
TAAAGCAGTTTGGATCGCAC -> CTAAAGCAGTTTGGATCGCA
AGCTGTTAATTGTAGCCGAC -> GAGCTGTTAATTGTAGCCGA
CTGCTGGTATCTGGCGACTG -> GCTGCTGGTATCTGGCGACT
TTGAGAAAGCGGAGTTAACC -> ATTGAGAAAGCGGAGTTAAC
GCACTACTGACTTCTGGCAT -> CGCACTACTGACTTCTGGCA
GAACGTATCACCGACCTCGA -> AGAACGTATCACCGACCTCG
GTGATTGAGAAAGCGGAGTT -> CGTGATTGAGAAAGCGGAGT
CGTCTTTTCGGCCCCACTCG -> GCGTCTTTTCGGCCCCACTC
ATAGACGTAGACGAGACCAC -> GATAGACGTAGACGAGACCA
GGCGTCGGGCTACCAAGCAA -> AGGCGTCGGGCTACCAAGCA
GAAAAATGCTGCTGGTATCT -> GGAAAAATGCTGCTGGTATC
TTCTGGCATACGTTGTAACA -> CTTCTGGCATACGTTGTAAC
AGATCACACACGCTGGCGGT -> CAGATCACACACGCTGGCGG
CTGGTCGGCAAGAGCCATAG -> TCTGGTCGGCAAGAGCCATA
CGAGACCACTGCAAGTGAAC -> ACGAGACCACTGCAAGTGAA
GCGGAGTTAACCTACCCCTG -> AGCGGAGTTAACCTACCCCT
ACTCGATCGTGATTGAGAAA -> CACTCGATCGTGATTGAGAA
GCCGGGGGAAATTGAGGAGT -> GGCCGGGGGAAATTGAGGAG
TCGAAACAAATTGGCGGTCA -> TTCGAAACAAATTGGCGGTC
AGTTTGGATCGCACTCCGGA -> CAGTTTGGATCGCACTCCGG
ATCGAGCTGTTAATTGTAGC -> AATCGAGCTGTTAATTGTAG
GCGCGTCCTAACGAGTCCAC -> TGCGCGTCCTAACGAGTCCA
TAGACGTAGACGAGACCACT -> ATAGACGTAGACGAGACCAC
TCGAAGGGTAGGAAAAATGC -> ATCGAAGGGTAGGAAAAATG
AAGCAGTTTGGATCGCACTC -> AAAGCAGTTTGGATCGCACT
GGTGTGGACTAAAGCAGTTT -> CGGTGTGGACTAAAGCAGTT
GCACTCCGGAGATAGACGTA -> CGCACTCCGGAGATAGACGT
GTGCGCGTCCTAACGAGTCC -> AGTGCGCGTCCTAACGAGTC
CTTCCCGCGTCTTTTCGGCC -> CCTTCCCGCGTCTTTTCGGC
GGCCAGGATTATCTCGAAAT -> GGGCCAGGATTATCTCGAAA
GGCGACTGGCTCTGCCTCTT -> TGGCGACTGGCTCTGCCTCT
GATGTTACAACAACGTCTTC -> AGATGTTACAACAACGTCTT
CACACACGCTGGCGGTCTGG -> TCACACACGCTGGCGGTCTG
TCAGCATTTCGAAACAAATT -> TTCAGCATTTCGAAACAAAT
AAAAGCATCCGGAATGGTCT -> TAAAAGCATCCGGAATGGTC
AGTGTTAAAAAATCGAGCTG -> AAGTGTTAAAAAATCGAGCT
GGATTGGCGTCGTGTGGCAC -> CGGATTGGCGTCGTGTGGCA
GTCGGGCTACCAAGCAATGG -> CGTCGGGCTACCAAGCAATG
AGGGCTCAAAATCCTATTTA -> CAGGGCTCAAAATCCTATTT
TCCGTGGTCCTCCAACATAA -> TTCCGTGGTCCTCCAACATA
TACCCGGGCGCGCCAACCAC -> ATACCCGGGCGCGCCAACCA
CACTCCGGAGATAGACGTAG -> GCACTCCGGAGATAGACGTA
CTATGGCTTTGAAATACCCG -> TCTATGGCTTTGAAATACCC
CTGGGCGGCCTAGCTGGCCG -> TCTGGGCGGCCTAGCTGGCC
CCTACCCCTGAGGGTGCCCC -> ACCTACCCCTGAGGGTGCCC
GATTATCTCGAAATCTTCCG -> GGATTATCTCGAAATCTTCC
AGGTATAATAGACGGTCCGT -> CAGGTATAATAGACGGTCCG
CGGGCGCGCCAACCACATCC -> CCGGGCGCGCCAACCACATC
GTATCACCGACCTCGACCGC -> CGTATCACCGACCTCGACCG
AACTGCAGACTCCGGATCCT -> CAACTGCAGACTCCGGATCC
CCCCTGAGGGTGCCCCTCAC -> ACCCCTGAGGGTGCCCCTCA
AACAAGATCATTACGGATTG -> CAACAAGATCATTACGGATT
AACAACAAGATCATTACGGA -> TAACAACAAGATCATTACGG
TTACGGATTGGCGTCGTGTG -> ATTACGGATTGGCGTCGTGT
CCCACTCGGGGCAGTAGTCA -> CCCCACTCGGGGCAGTAGTC
AAGTGTTAAAAAATCGAGCT -> GAAGTGTTAAAAAATCGAGC
ATCTCGAAATCTTCCGTGGT -> TATCTCGAAATCTTCCGTGG
GGCTATTCCACAAGCAATGC -> AGGCTATTCCACAAGCAATG
GAGCCATAGCGCCGCGGTGT -> AGAGCCATAGCGCCGCGGTG
GCGTCTTTTCGGCCCCACTC -> CGCGTCTTTTCGGCCCCACT
CTACTGACTTCTGGCATACG -> ACTACTGACTTCTGGCATAC
TAGCCGACAACTGCAGACTC -> GTAGCCGACAACTGCAGACT
AAGAGCCATAGCGCCGCGGT -> CAAGAGCCATAGCGCCGCGG
AGAAGTGTTAAAAAATCGAG -> AAGAAGTGTTAAAAAATCGA
CCCTGAGGGTGCCCCTCACG -> CCCCTGAGGGTGCCCCTCAC
CGTATCACCGACCTCGACCG -> ACGTATCACCGACCTCGACC
AGGGCCAGGATTATCTCGAA -> CAGGGCCAGGATTATCTCGA
CCCCTCACGACAGCCATGTT -> GCCCCTCACGACAGCCATGT
GTCTGGTCGGCAAGAGCCAT -> GGTCTGGTCGGCAAGAGCCA
TGGGCGGCCTAGCTGGCCGG -> CTGGGCGGCCTAGCTGGCCG
GCAGTAGTCAGTGGCAGCAG -> GGCAGTAGTCAGTGGCAGCA
ACAAATTGGCGGTCAGTGCG -> AACAAATTGGCGGTCAGTGC
GCTTGGTGATAGGTGGCGAC -> CGCTTGGTGATAGGTGGCGA
GACAGATCGAAGGGTAGGAA -> AGACAGATCGAAGGGTAGGA
CATTACGGATTGGCGTCGTG -> TCATTACGGATTGGCGTCGT
TGGCGGTCAGTGCGCGTCCT -> TTGGCGGTCAGTGCGCGTCC
TGTGAGTTGGAAGACGCAAT -> TTGTGAGTTGGAAGACGCAA
GGTATAATAGACGGTCCGTA -> AGGTATAATAGACGGTCCGT
ACAACTGCAGACTCCGGATC -> GACAACTGCAGACTCCGGAT
CAACGTCTTCCGAACTTAAA -> ACAACGTCTTCCGAACTTAA
GGTCTGGTCGGCAAGAGCCA -> CGGTCTGGTCGGCAAGAGCC
TGTACTACCATGAGATGTTA -> GTGTACTACCATGAGATGTT
TGGATCGCACTCCGGAGATA -> TTGGATCGCACTCCGGAGAT
AATCCGGTCCGTGATGAGGC -> TAATCCGGTCCGTGATGAGG
CACCGACCTCGACCGCACAG -> TCACCGACCTCGACCGCACA
CTGGTATCTGGCGACTGGCT -> GCTGGTATCTGGCGACTGGC
TACGGATTGGCGTCGTGTGG -> TTACGGATTGGCGTCGTGTG
GCAATGCCAGCGCACTACTG -> AGCAATGCCAGCGCACTACT
ATTGGCGGTCAGTGCGCGTC -> AATTGGCGGTCAGTGCGCGT
TCGGGCTACCAAGCAATGGG -> GTCGGGCTACCAAGCAATGG
AATACCCGGGCGCGCCAACC -> AAATACCCGGGCGCGCCAAC
CAATGGGGCTACGGGGCTAC -> GCAATGGGGCTACGGGGCTA
CAAGAGCCATAGCGCCGCGG -> GCAAGAGCCATAGCGCCGCG
AGCATCCGGAATGGTCTATG -> AAGCATCCGGAATGGTCTAT
ACCTACCCCTGAGGGTGCCC -> AACCTACCCCTGAGGGTGCC
TGAGTTGGAAGACGCAATGA -> GTGAGTTGGAAGACGCAATG
CACTTGTGAGTTGGAAGACG -> CCACTTGTGAGTTGGAAGAC
GGGCTCAAAATCCTATTTAA -> AGGGCTCAAAATCCTATTTA
CAGGCTATTCCACAAGCAAT -> GCAGGCTATTCCACAAGCAA
CAACCACATCCCAACCAAGC -> CCAACCACATCCCAACCAAG
CACGTTCAGCATTTCGAAAC -> TCACGTTCAGCATTTCGAAA
GGCCCCACTCGGGGCAGTAG -> CGGCCCCACTCGGGGCAGTA
CAAGCGGTGTGGACTAAAGC -> CCAAGCGGTGTGGACTAAAG
TACGTTGTAACACTGTGCCA -> ATACGTTGTAACACTGTGCC
TACCAAGCAATGGGGCTACG -> CTACCAAGCAATGGGGCTAC
AGATGTTACAACAACGTCTT -> GAGATGTTACAACAACGTCT
CCTAACGAGTCCACCAGGGC -> TCCTAACGAGTCCACCAGGG
GAAATTGAGGAGTGATGTAG -> GGAAATTGAGGAGTGATGTA
TGGTTTGTATACAATCACGT -> GTGGTTTGTATACAATCACG
TCACGACAGCCATGTTAGCG -> CTCACGACAGCCATGTTAGC
ATTCCACAAGCAATGCCAGC -> TATTCCACAAGCAATGCCAG
GGGCTACCAAGCAATGGGGC -> CGGGCTACCAAGCAATGGGG
TCGGCGTCTCTGGGCGGCCT -> CTCGGCGTCTCTGGGCGGCC
CCTAGCTGGCCGGGGGAAAT -> GCCTAGCTGGCCGGGGGAAA
TCTTTTCGGCCCCACTCGGG -> GTCTTTTCGGCCCCACTCGG
ACCCCTGAGGGTGCCCCTCA -> TACCCCTGAGGGTGCCCCTC
CTTCCGAACTTAAATTCAGA -> TCTTCCGAACTTAAATTCAG
GTTTGGATCGCACTCCGGAG -> AGTTTGGATCGCACTCCGGA
CAGCCATGTTAGCGCTTGGT -> ACAGCCATGTTAGCGCTTGG
AGCAGTTTGGATCGCACTCC -> AAGCAGTTTGGATCGCACTC
CATACGTTGTAACACTGTGC -> GCATACGTTGTAACACTGTG
ATCTGGCGACTGGCTCTGCC -> TATCTGGCGACTGGCTCTGC
AAAGCGGAGTTAACCTACCC -> GAAAGCGGAGTTAACCTACC
AGACCACTGCAAGTGAACCC -> GAGACCACTGCAAGTGAACC
GGAGATAGACGTAGACGAGA -> CGGAGATAGACGTAGACGAG
GCACAATTCGTTTACGCCTT -> CGCACAATTCGTTTACGCCT
ACAGATCGAAGGGTAGGAAA -> GACAGATCGAAGGGTAGGAA
GAGGCGGATCAGGTATAATA -> TGAGGCGGATCAGGTATAAT
ATCCTCGCACTCGATCGTGA -> GATCCTCGCACTCGATCGTG
GATCACACACGCTGGCGGTC -> AGATCACACACGCTGGCGGT
ATTTAATCCGGTCCGTGATG -> TATTTAATCCGGTCCGTGAT
GAGAAAGCGGAGTTAACCTA -> TGAGAAAGCGGAGTTAACCT
GAGTCCACCAGGGCTCAAAA -> CGAGTCCACCAGGGCTCAAA
CGTCTTCCGAACTTAAATTC -> ACGTCTTCCGAACTTAAATT
CGGCGTCTCTGGGCGGCCTA -> TCGGCGTCTCTGGGCGGCCT
CATGTTAGCGCTTGGTGATA -> CCATGTTAGCGCTTGGTGAT
CTGGCATACGTTGTAACACT -> TCTGGCATACGTTGTAACAC
CAGTTTGGATCGCACTCCGG -> GCAGTTTGGATCGCACTCCG
CTACCATGAGATGTTACAAC -> ACTACCATGAGATGTTACAA
TGTTACAACAACGTCTTCCG -> ATGTTACAACAACGTCTTCC
ATTACGGATTGGCGTCGTGT -> CATTACGGATTGGCGTCGTG
CTAACGAGTCCACCAGGGCT -> CCTAACGAGTCCACCAGGGC
CGGCCTAGCTGGCCGGGGGA -> GCGGCCTAGCTGGCCGGGGG
GCTCAAAATCCTATTTAATC -> GGCTCAAAATCCTATTTAAT
CTCCAGGGCCAGGATTATCT -> CCTCCAGGGCCAGGATTATC
GAAATACCCGGGCGCGCCAA -> TGAAATACCCGGGCGCGCCA
GTTTGTATACAATCACGTTC -> GGTTTGTATACAATCACGTT
CCTCTTGATAGGCGTCGAGG -> GCCTCTTGATAGGCGTCGAG
TTGTATACAATCACGTTCAG -> TTTGTATACAATCACGTTCA
CCGCGTCTTTTCGGCCCCAC -> CCCGCGTCTTTTCGGCCCCA
GCTACCAAGCAATGGGGCTA -> GGCTACCAAGCAATGGGGCT
CGCACTACTGACTTCTGGCA -> GCGCACTACTGACTTCTGGC
AGCGCTTGGTGATAGGTGGC -> TAGCGCTTGGTGATAGGTGG
AATTCAGACAGATCGAAGGG -> AAATTCAGACAGATCGAAGG
AAGCAATGCCAGCGCACTAC -> CAAGCAATGCCAGCGCACTA
TCCAACATAAAAGCATCCGG -> CTCCAACATAAAAGCATCCG
GAGTTGGAAGACGCAATGAA -> TGAGTTGGAAGACGCAATGA
TTTCGAAACAAATTGGCGGT -> ATTTCGAAACAAATTGGCGG
ATCAGCTCGGCGTCTCTGGG -> TATCAGCTCGGCGTCTCTGG
TTGGATCGCACTCCGGAGAT -> TTTGGATCGCACTCCGGAGA
AACGTCTTCCGAACTTAAAT -> CAACGTCTTCCGAACTTAAA
GCGGATCAGGTATAATAGAC -> GGCGGATCAGGTATAATAGA
GGCGTCGTGTGGCACATTTC -> TGGCGTCGTGTGGCACATTT
GTAGACAAGAAGTGTTAAAA -> TGTAGACAAGAAGTGTTAAA
GGGGAAATTGAGGAGTGATG -> GGGGGAAATTGAGGAGTGAT
GGTCCGTGATGAGGCGGATC -> CGGTCCGTGATGAGGCGGAT
GACGGTCCGTACAGGCGTCG -> AGACGGTCCGTACAGGCGTC
GGGGGAAATTGAGGAGTGAT -> CGGGGGAAATTGAGGAGTGA
CAGACAGATCGAAGGGTAGG -> TCAGACAGATCGAAGGGTAG
TACAATCACGTTCAGCATTT -> ATACAATCACGTTCAGCATT
AGGAAAAATGCTGCTGGTAT -> TAGGAAAAATGCTGCTGGTA
AGCAATGCCAGCGCACTACT -> AAGCAATGCCAGCGCACTAC
CCTGAGGGTGCCCCTCACGA -> CCCTGAGGGTGCCCCTCACG
GGCTACGCACAATTCGTTTA -> GGGCTACGCACAATTCGTTT
CTCCGGAGATAGACGTAGAC -> ACTCCGGAGATAGACGTAGA
GTCCTCCAACATAAAAGCAT -> GGTCCTCCAACATAAAAGCA
ATTGTAGCCGACAACTGCAG -> AATTGTAGCCGACAACTGCA
ACCACTGCAAGTGAACCCAC -> GACCACTGCAAGTGAACCCA
TTTGAAATACCCGGGCGCGC -> CTTTGAAATACCCGGGCGCG
GACAAGAAGTGTTAAAAAAT -> AGACAAGAAGTGTTAAAAAA
GGTGCCCCTCACGACAGCCA -> GGGTGCCCCTCACGACAGCC
ATTCAGACAGATCGAAGGGT -> AATTCAGACAGATCGAAGGG
TGGCGACTGGCTCTGCCTCT -> CTGGCGACTGGCTCTGCCTC
TGAAATACCCGGGCGCGCCA -> TTGAAATACCCGGGCGCGCC
ACGCAATGAAGTGGGAAGAA -> GACGCAATGAAGTGGGAAGA
TAGGTGGCGACGCCCTCCAG -> ATAGGTGGCGACGCCCTCCA
GTAACAACAAGATCATTACG -> CGTAACAACAAGATCATTAC
TGATAGGTGGCGACGCCCTC -> GTGATAGGTGGCGACGCCCT
TGATGAGGCGGATCAGGTAT -> GTGATGAGGCGGATCAGGTA
TGGTCTATGGCTTTGAAATA -> ATGGTCTATGGCTTTGAAAT
CCCTCCAGGGCCAGGATTAT -> GCCCTCCAGGGCCAGGATTA
GCCTCTTGATAGGCGTCGAG -> TGCCTCTTGATAGGCGTCGA
TGTGGCACATTTCTCTATCA -> GTGTGGCACATTTCTCTATC
AGCATTTCGAAACAAATTGG -> CAGCATTTCGAAACAAATTG
TTCGAAACAAATTGGCGGTC -> TTTCGAAACAAATTGGCGGT
GCCTAGCTGGCCGGGGGAAA -> GGCCTAGCTGGCCGGGGGAA
GCAAGTGAACCCACTTGTGA -> TGCAAGTGAACCCACTTGTG
TTGATAGGCGTCGAGGCGGG -> CTTGATAGGCGTCGAGGCGG
GACAGCCATGTTAGCGCTTG -> CGACAGCCATGTTAGCGCTT
GGCGGTCAGTGCGCGTCCTA -> TGGCGGTCAGTGCGCGTCCT
GATAGGTGGCGACGCCCTCC -> TGATAGGTGGCGACGCCCTC
GTCAGGACCTACAACTGTGG -> GGTCAGGACCTACAACTGTG
ATTGAGGAGTGATGTAGACA -> AATTGAGGAGTGATGTAGAC
CTCCGGATCCTCGCACTCGA -> ACTCCGGATCCTCGCACTCG
TACAACTGTGGTTTGTATAC -> CTACAACTGTGGTTTGTATA
CGGCCGTAACAACAAGATCA -> GCGGCCGTAACAACAAGATC
GAAAGCGGAGTTAACCTACC -> AGAAAGCGGAGTTAACCTAC
TTACAACAACGTCTTCCGAA -> GTTACAACAACGTCTTCCGA
TTAATCCGGTCCGTGATGAG -> TTTAATCCGGTCCGTGATGA
TGAAGTGGGAAGAACGTATC -> ATGAAGTGGGAAGAACGTAT
AAAGCATCCGGAATGGTCTA -> AAAAGCATCCGGAATGGTCT
GACTGGCTCTGCCTCTTGAT -> CGACTGGCTCTGCCTCTTGA
AAATCCTATTTAATCCGGTC -> AAAATCCTATTTAATCCGGT
GACGCCCTCCAGGGCCAGGA -> CGACGCCCTCCAGGGCCAGG
GCTGGTATCTGGCGACTGGC -> TGCTGGTATCTGGCGACTGG
TCTATCAGCTCGGCGTCTCT -> CTCTATCAGCTCGGCGTCTC
CACAATTCGTTTACGCCTTC -> GCACAATTCGTTTACGCCTT
CAGTAGTCAGTGGCAGCAGG -> GCAGTAGTCAGTGGCAGCAG
ATCCTATTTAATCCGGTCCG -> AATCCTATTTAATCCGGTCC
ACCGACCTCGACCGCACAGA -> CACCGACCTCGACCGCACAG
TCAGGTATAATAGACGGTCC -> ATCAGGTATAATAGACGGTC
GTCCACCAGGGCTCAAAATC -> AGTCCACCAGGGCTCAAAAT
AGGCGTCGAGGCGGGTCAGG -> TAGGCGTCGAGGCGGGTCAG
CGGGGCTACGCACAATTCGT -> ACGGGGCTACGCACAATTCG
ACGGGGCTACGCACAATTCG -> TACGGGGCTACGCACAATTC
TCGAGCTGTTAATTGTAGCC -> ATCGAGCTGTTAATTGTAGC
AGGACCTACAACTGTGGTTT -> CAGGACCTACAACTGTGGTT
CTGGCGACTGGCTCTGCCTC -> TCTGGCGACTGGCTCTGCCT
TGGTGATAGGTGGCGACGCC -> TTGGTGATAGGTGGCGACGC
TTAAAAAATCGAGCTGTTAA -> GTTAAAAAATCGAGCTGTTA
ACGTCTTCCGAACTTAAATT -> AACGTCTTCCGAACTTAAAT
GGGGCTACGCACAATTCGTT -> CGGGGCTACGCACAATTCGT
GGAAAAATGCTGCTGGTATC -> AGGAAAAATGCTGCTGGTAT
AATCCTATTTAATCCGGTCC -> AAATCCTATTTAATCCGGTC
TACTGACTTCTGGCATACGT -> CTACTGACTTCTGGCATACG
CCTACAACTGTGGTTTGTAT -> ACCTACAACTGTGGTTTGTA
AGTGGCAGCAGGCTATTCCA -> CAGTGGCAGCAGGCTATTCC
GCCTTCCCGCGTCTTTTCGG -> CGCCTTCCCGCGTCTTTTCG
GGCCGGGGGAAATTGAGGAG -> TGGCCGGGGGAAATTGAGGA
GCCATAGCGCCGCGGTGTAC -> AGCCATAGCGCCGCGGTGTA
GTGGCAGCAGGCTATTCCAC -> AGTGGCAGCAGGCTATTCCA
GCGTCTCTGGGCGGCCTAGC -> GGCGTCTCTGGGCGGCCTAG
ATAGGTGGCGACGCCCTCCA -> GATAGGTGGCGACGCCCTCC
CGGGTCAGGACCTACAACTG -> GCGGGTCAGGACCTACAACT
GAACTTAAATTCAGACAGAT -> CGAACTTAAATTCAGACAGA
TACCATGAGATGTTACAACA -> CTACCATGAGATGTTACAAC
AAGTGAACCCACTTGTGAGT -> CAAGTGAACCCACTTGTGAG
TACTACCATGAGATGTTACA -> GTACTACCATGAGATGTTAC
CTACAACTGTGGTTTGTATA -> CCTACAACTGTGGTTTGTAT
GTGGCACATTTCTCTATCAG -> TGTGGCACATTTCTCTATCA
GGTGATAGGTGGCGACGCCC -> TGGTGATAGGTGGCGACGCC
TAATAGACGGTCCGTACAGG -> ATAATAGACGGTCCGTACAG
GTTCAGCATTTCGAAACAAA -> CGTTCAGCATTTCGAAACAA
CGACCTCGACCGCACAGATC -> CCGACCTCGACCGCACAGAT
TGTTAATTGTAGCCGACAAC -> CTGTTAATTGTAGCCGACAA
TTCCCGCGTCTTTTCGGCCC -> CTTCCCGCGTCTTTTCGGCC
AGGGTAGGAAAAATGCTGCT -> AAGGGTAGGAAAAATGCTGC
AATGGGGCTACGGGGCTACG -> CAATGGGGCTACGGGGCTAC
GGTGTACTACCATGAGATGT -> CGGTGTACTACCATGAGATG
CGGTGTGGACTAAAGCAGTT -> GCGGTGTGGACTAAAGCAGT
CTTGTGAGTTGGAAGACGCA -> ACTTGTGAGTTGGAAGACGC
GATTGGCGTCGTGTGGCACA -> GGATTGGCGTCGTGTGGCAC
ACGACAGCCATGTTAGCGCT -> CACGACAGCCATGTTAGCGC
AAAAATCGAGCTGTTAATTG -> AAAAAATCGAGCTGTTAATT
GAGTGATGTAGACAAGAAGT -> GGAGTGATGTAGACAAGAAG
AGGCGTCGGGCTACCAAGCA -> CAGGCGTCGGGCTACCAAGC
CTCGGGGCAGTAGTCAGTGG -> ACTCGGGGCAGTAGTCAGTG
CGGATCAGGTATAATAGACG -> GCGGATCAGGTATAATAGAC
CTCACGACAGCCATGTTAGC -> CCTCACGACAGCCATGTTAG
TATCTCGAAATCTTCCGTGG -> TTATCTCGAAATCTTCCGTG
GAGCTGTTAATTGTAGCCGA -> CGAGCTGTTAATTGTAGCCG
CTTGGTGATAGGTGGCGACG -> GCTTGGTGATAGGTGGCGAC
CGACTGGCTCTGCCTCTTGA -> GCGACTGGCTCTGCCTCTTG
ATTCGTTTACGCCTTCCCGC -> AATTCGTTTACGCCTTCCCG
CGGTCTGGTCGGCAAGAGCC -> GCGGTCTGGTCGGCAAGAGC
GGCGGATCAGGTATAATAGA -> AGGCGGATCAGGTATAATAG
GTCGGCAAGAGCCATAGCGC -> GGTCGGCAAGAGCCATAGCG
ACAACAACGTCTTCCGAACT -> TACAACAACGTCTTCCGAAC
CAATTCGTTTACGCCTTCCC -> ACAATTCGTTTACGCCTTCC
TAGTCAGTGGCAGCAGGCTA -> GTAGTCAGTGGCAGCAGGCT
TGTATACAATCACGTTCAGC -> TTGTATACAATCACGTTCAG
TATCACCGACCTCGACCGCA -> GTATCACCGACCTCGACCGC
GTGAACCCACTTGTGAGTTG -> AGTGAACCCACTTGTGAGTT
ACGCACAATTCGTTTACGCC -> TACGCACAATTCGTTTACGC
GGATCGCACTCCGGAGATAG -> TGGATCGCACTCCGGAGATA
TATGGCTTTGAAATACCCGG -> CTATGGCTTTGAAATACCCG
TGCGCGTCCTAACGAGTCCA -> GTGCGCGTCCTAACGAGTCC
TCCGGATCCTCGCACTCGAT -> CTCCGGATCCTCGCACTCGA
ACGAGTCCACCAGGGCTCAA -> AACGAGTCCACCAGGGCTCA
AACCACATCCCAACCAAGCG -> CAACCACATCCCAACCAAGC
TGTGGTTTGTATACAATCAC -> CTGTGGTTTGTATACAATCA
ACGCTGGCGGTCTGGTCGGC -> CACGCTGGCGGTCTGGTCGG
GGTCAGGACCTACAACTGTG -> GGGTCAGGACCTACAACTGT
TCGCACTCGATCGTGATTGA -> CTCGCACTCGATCGTGATTG
ATTTCTCTATCAGCTCGGCG -> CATTTCTCTATCAGCTCGGC
ACCAAGCAATGGGGCTACGG -> TACCAAGCAATGGGGCTACG
TCGTGTGGCACATTTCTCTA -> GTCGTGTGGCACATTTCTCT
ACAAGCAATGCCAGCGCACT -> CACAAGCAATGCCAGCGCAC
GACGAGACCACTGCAAGTGA -> AGACGAGACCACTGCAAGTG
TAGGCGTCGAGGCGGGTCAG -> ATAGGCGTCGAGGCGGGTCA
CGCACTCGATCGTGATTGAG -> TCGCACTCGATCGTGATTGA
TATCAGCTCGGCGTCTCTGG -> CTATCAGCTCGGCGTCTCTG
ACTTGTGAGTTGGAAGACGC -> CACTTGTGAGTTGGAAGACG
CAAGCAATGGGGCTACGGGG -> CCAAGCAATGGGGCTACGGG
AGCCGACAACTGCAGACTCC -> TAGCCGACAACTGCAGACTC
ATAAAAGCATCCGGAATGGT -> CATAAAAGCATCCGGAATGG
AGTGGGAAGAACGTATCACC -> AAGTGGGAAGAACGTATCAC
TGAGGAGTGATGTAGACAAG -> TTGAGGAGTGATGTAGACAA
TAGGAAAAATGCTGCTGGTA -> GTAGGAAAAATGCTGCTGGT
TCTGGTCGGCAAGAGCCATA -> GTCTGGTCGGCAAGAGCCAT
GTTAGCGCTTGGTGATAGGT -> TGTTAGCGCTTGGTGATAGG
TTGGCGTCGTGTGGCACATT -> ATTGGCGTCGTGTGGCACAT
GGACTAAAGCAGTTTGGATC -> TGGACTAAAGCAGTTTGGAT
CATCCGGAATGGTCTATGGC -> GCATCCGGAATGGTCTATGG
GGTCCTCCAACATAAAAGCA -> TGGTCCTCCAACATAAAAGC
CACTCGATCGTGATTGAGAA -> GCACTCGATCGTGATTGAGA
TTACGCCTTCCCGCGTCTTT -> TTTACGCCTTCCCGCGTCTT
AATGCCAGCGCACTACTGAC -> CAATGCCAGCGCACTACTGA
CACCAGGGCTCAAAATCCTA -> CCACCAGGGCTCAAAATCCT
AATCTTCCGTGGTCCTCCAA -> AAATCTTCCGTGGTCCTCCA
TCGACCGCACAGATCACACA -> CTCGACCGCACAGATCACAC
CGGAATGGTCTATGGCTTTG -> CCGGAATGGTCTATGGCTTT
GCGCGCCAACCACATCCCAA -> GGCGCGCCAACCACATCCCA
CGTTGTAACACTGTGCCACA -> ACGTTGTAACACTGTGCCAC
AAGACGCAATGAAGTGGGAA -> GAAGACGCAATGAAGTGGGA
TGGCTCTGCCTCTTGATAGG -> CTGGCTCTGCCTCTTGATAG
CAGGGCCAGGATTATCTCGA -> CCAGGGCCAGGATTATCTCG
CCCGCGTCTTTTCGGCCCCA -> TCCCGCGTCTTTTCGGCCCC
TCAGACAGATCGAAGGGTAG -> TTCAGACAGATCGAAGGGTA
TCCACAAGCAATGCCAGCGC -> TTCCACAAGCAATGCCAGCG
AGCGGAGTTAACCTACCCCT -> AAGCGGAGTTAACCTACCCC
CCGAACTTAAATTCAGACAG -> TCCGAACTTAAATTCAGACA
TGCAAGTGAACCCACTTGTG -> CTGCAAGTGAACCCACTTGT
CGTGGTCCTCCAACATAAAA -> CCGTGGTCCTCCAACATAAA
TAACGAGTCCACCAGGGCTC -> CTAACGAGTCCACCAGGGCT
GTGATAGGTGGCGACGCCCT -> GGTGATAGGTGGCGACGCCC
ATGTTACAACAACGTCTTCC -> GATGTTACAACAACGTCTTC
GTATAATAGACGGTCCGTAC -> GGTATAATAGACGGTCCGTA
TCTCTATCAGCTCGGCGTCT -> TTCTCTATCAGCTCGGCGTC
ACTCCGGAGATAGACGTAGA -> CACTCCGGAGATAGACGTAG
AGATCGAAGGGTAGGAAAAA -> CAGATCGAAGGGTAGGAAAA
AGTCAGTGGCAGCAGGCTAT -> TAGTCAGTGGCAGCAGGCTA
TTCCGTGGTCCTCCAACATA -> CTTCCGTGGTCCTCCAACAT
GGCGCGCCAACCACATCCCA -> GGGCGCGCCAACCACATCCC
TTAAATTCAGACAGATCGAA -> CTTAAATTCAGACAGATCGA
GTAGCCGACAACTGCAGACT -> TGTAGCCGACAACTGCAGAC
GGCCTAGCTGGCCGGGGGAA -> CGGCCTAGCTGGCCGGGGGA
CGGATCCTCGCACTCGATCG -> CCGGATCCTCGCACTCGATC
GTGAGTTGGAAGACGCAATG -> TGTGAGTTGGAAGACGCAAT
GCGCCAACCACATCCCAACC -> CGCGCCAACCACATCCCAAC
TCCACCAGGGCTCAAAATCC -> GTCCACCAGGGCTCAAAATC
CCATGTTAGCGCTTGGTGAT -> GCCATGTTAGCGCTTGGTGA
CGGAGTTAACCTACCCCTGA -> GCGGAGTTAACCTACCCCTG
GGAAATTGAGGAGTGATGTA -> GGGAAATTGAGGAGTGATGT
GTGGACTAAAGCAGTTTGGA -> TGTGGACTAAAGCAGTTTGG
GTCTATGGCTTTGAAATACC -> GGTCTATGGCTTTGAAATAC
CAGCAGGCTATTCCACAAGC -> GCAGCAGGCTATTCCACAAG
GCTACGCACAATTCGTTTAC -> GGCTACGCACAATTCGTTTA
GAGACCACTGCAAGTGAACC -> CGAGACCACTGCAAGTGAAC
GCCCCTCACGACAGCCATGT -> TGCCCCTCACGACAGCCATG
AGGAGTGATGTAGACAAGAA -> GAGGAGTGATGTAGACAAGA
CACATCCCAACCAAGCGGTG -> CCACATCCCAACCAAGCGGT
AGCTCGGCGTCTCTGGGCGG -> CAGCTCGGCGTCTCTGGGCG
CAATGCCAGCGCACTACTGA -> GCAATGCCAGCGCACTACTG
AAAAATGCTGCTGGTATCTG -> GAAAAATGCTGCTGGTATCT
CAAAATCCTATTTAATCCGG -> TCAAAATCCTATTTAATCCG
CGTTTACGCCTTCCCGCGTC -> TCGTTTACGCCTTCCCGCGT
