AGTCTGGGTTTGAGGCATG -> GTCTGGGTTTGAGGCATGA
AAACGCATTATGAACCCTG -> AACGCATTATGAACCCTGT
TAATATGAGTTGCTTTGGG -> AATATGAGTTGCTTTGGGT
ATACCTCGATACTCGGCTT -> TACCTCGATACTCGGCTTG
TAAAGAAACATCCTAGAAT -> AAAGAAACATCCTAGAATA
TCAAATAGCGCAATGAGCC -> CAAATAGCGCAATGAGCCT
AGAAAGACCTAGACCAATC -> GAAAGACCTAGACCAATCT
AGTAGAAATTTTGGTCGTG -> GTAGAAATTTTGGTCGTGA
AACTATTCTAAAGAAGCCC -> ACTATTCTAAAGAAGCCCC
GGAACAAGTAGCGTCTTAC -> GAACAAGTAGCGTCTTACG
ATGGGGTTGGTAACTATTC -> TGGGGTTGGTAACTATTCT
CCCTGTTTACACAGCTTGA -> CCTGTTTACACAGCTTGAT
ATCTTTTGGGTTCGTGTAT -> TCTTTTGGGTTCGTGTATT
AGAGCTCAGGTGACTACCA -> GAGCTCAGGTGACTACCAG
GGTCATTGCCCCTAAGTGG -> GTCATTGCCCCTAAGTGGC
CCGGCCCTGGTCTAGTTTA -> CGGCCCTGGTCTAGTTTAA
CAAATATAGGCCCTGTTTA -> AAATATAGGCCCTGTTTAA
ACGTTGGAAGAAAGACCTA -> CGTTGGAAGAAAGACCTAG
TCAAAACCCGACGGAATGG -> CAAAACCCGACGGAATGGA
TAGGCCACGCGACCACAGG -> AGGCCACGCGACCACAGGC
AATGGACACACGTGCACGA -> ATGGACACACGTGCACGAC
ATTCGCGATATCGACACCA -> TTCGCGATATCGACACCAC
GGACTCACCACCCATGGAG -> GACTCACCACCCATGGAGA
GAAGAGATAAGATGTTAAT -> AAGAGATAAGATGTTAATT
GTGTATTCTCATAGGCATC -> TGTATTCTCATAGGCATCT
TCCCGCAGGTCAAATAGCG -> CCCGCAGGTCAAATAGCGC
GTCGTTACCCCCTTCAGGC -> TCGTTACCCCCTTCAGGCC
AAGACCCACGAGAATACCT -> AGACCCACGAGAATACCTC
GTTTCGCTGACAGGATTAG -> TTTCGCTGACAGGATTAGT
TCAATCTTCTGTTCTGACG -> CAATCTTCTGTTCTGACGG
TCCAGTAGAAATTTTGGTC -> CCAGTAGAAATTTTGGTCG
CTTATGCCGGCCCGGACAA -> TTATGCCGGCCCGGACAAT
GTCATGAAGACCCACGAGA -> TCATGAAGACCCACGAGAA
GTTTAAGAGGACTCACCAC -> TTTAAGAGGACTCACCACC
ACGCGACCACAGGCGGAAC -> CGCGACCACAGGCGGAACA
TAGACATACGAGCGGAGTT -> AGACATACGAGCGGAGTTG
GCAAAATCTTAATCCACAG -> CAAAATCTTAATCCACAGT
AAGAAGTTTCCTAGACAGT -> AGAAGTTTCCTAGACAGTG
CCATTTTTGGTTAGGTTCG -> CATTTTTGGTTAGGTTCGG
AATGGACTTCACTTAGTAT -> ATGGACTTCACTTAGTATC
CGGCCCTGGTCTAGTTTAA -> GGCCCTGGTCTAGTTTAAC
GGCACTACACAATCTTTTG -> GCACTACACAATCTTTTGG
ATAGGGACTTAATTCCGGC -> TAGGGACTTAATTCCGGCC
CACTTACGCACATTCGTGC -> ACTTACGCACATTCGTGCC
TGGATTTGATAAACGCATC -> GGATTTGATAAACGCATCT
TTGCATGGGGTTGGTAACT -> TGCATGGGGTTGGTAACTA
TGTCCAGTAGAAATTTTGG -> GTCCAGTAGAAATTTTGGT
GCACTTACTCACTGTGCGA -> CACTTACTCACTGTGCGAA
GAATGGACACACGTGAGGG -> AATGGACACACGTGAGGGC
GACTCACAACACTACCTAG -> ACTCACAACACTACCTAGA
TCGCGATATCGACACCACG -> CGCGATATCGACACCACGA
AATTCTTCCGGGGTCTTAA -> ATTCTTCCGGGGTCTTAAA
CAGCTTGATCCTAGCGCCG -> AGCTTGATCCTAGCGCCGT
AAAGACCTAGACCAATCTA -> AAGACCTAGACCAATCTAG
GGGTCGCACATCGACTCAC -> GGTCGCACATCGACTCACA
TATCTAGAAACCCGACCTA -> ATCTAGAAACCCGACCTAC
TATCCCGAGTGGAGGTAAA -> ATCCCGAGTGGAGGTAAAC
ACGCCTCCCGCAGGTCAAA -> CGCCTCCCGCAGGTCAAAT
CTTCCGAACAAAATGCCAA -> TTCCGAACAAAATGCCAAG
GGTTGCGCAACACTGAAGG -> GTTGCGCAACACTGAAGGT
CGGCCCCCACCCATGGGTC -> GGCCCCCACCCATGGGTCA
GAATGGACACACGTGTTAA -> AATGGACACACGTGTTAAT
AATCTTTTGGGTTCGTGTA -> ATCTTTTGGGTTCGTGTAT
GCGGATATGGTTGCGCAAC -> CGGATATGGTTGCGCAACA
CAATCTTTTGGGTTCGTGT -> AATCTTTTGGGTTCGTGTA
CCATTATGCTGTAGCTCGT -> CATTATGCTGTAGCTCGTT
GGACTTCACTTAGTATCTA -> GACTTCACTTAGTATCTAT
AGCCTCAAGAAGTTTCCTA -> GCCTCAAGAAGTTTCCTAG
CGATATCGACACCACGAGG -> GATATCGACACCACGAGGT
TTTTGGTTAGGTTCGGCCC -> TTTGGTTAGGTTCGGCCCC
GTAGTCTGGGTTTGAGGCA -> TAGTCTGGGTTTGAGGCAT
CACCACGAGGTGGTTATCA -> ACCACGAGGTGGTTATCAC
TACTCATTGAACGTAGACG -> ACTCATTGAACGTAGACGT
GGTCTAGTTTAACCGATGA -> GTCTAGTTTAACCGATGAT
GAAAAGTCGGTAGTTCTGG -> AAAAGTCGGTAGTTCTGGT
TTTCCTAGACAGTGGATTT -> TTCCTAGACAGTGGATTTG
ATGGACACACGTGCACGAC -> TGGACACACGTGCACGACC
ATCAAAACCCGACGGAATG -> TCAAAACCCGACGGAATGG
CTAGAAACCCGACCTACTT -> TAGAAACCCGACCTACTTA
ACACACGTGCACGACCTTA -> CACACGTGCACGACCTTAG
CGTTCGAGTATGACTTATG -> GTTCGAGTATGACTTATGG
CCAGGAAGGCGATCGTGTG -> CAGGAAGGCGATCGTGTGT
ACTAGGCCACGCGACCACA -> CTAGGCCACGCGACCACAG
AGATCGATCTTTTTACAAA -> GATCGATCTTTTTACAAAA
CGCCTTATCCTGGCCCTCC -> GCCTTATCCTGGCCCTCCC
TGACGGAATGGACACACGT -> GACGGAATGGACACACGTG,GACGGAATGGACACACGTG
ATATCCCATGAAAGTGCCA -> TATCCCATGAAAGTGCCAA
AATACACGCCGCGCGTGTA -> ATACACGCCGCGCGTGTAA
GCAGACCCTGCACTTACTC -> CAGACCCTGCACTTACTCA
TAAATAGGGACTTAATTCC -> AAATAGGGACTTAATTCCG
TGATTTAGCAGGTGGTGTC -> GATTTAGCAGGTGGTGTCC
TTCTTCCGGGGTCTTAAAT -> TCTTCCGGGGTCTTAAATA
GTCTTAAATACACGCCGCG -> TCTTAAATACACGCCGCGC
GAATTGGTCTTCTGGTCCT -> AATTGGTCTTCTGGTCCTA
GAGCGGAGTTGCATGGGGT -> AGCGGAGTTGCATGGGGTT
TGGGTCGCACATCGACTCA -> GGGTCGCACATCGACTCAC
TCCTGAGTCTCCCACTTAC -> CCTGAGTCTCCCACTTACG
CCTCGTCAGAATCCGCCGG -> CTCGTCAGAATCCGCCGGC
CTTAATGATCTTAATCCAC -> TTAATGATCTTAATCCACA
TAATTCCGGCCCTGGTCTA -> AATTCCGGCCCTGGTCTAG
TCATCCTCTGACGGAATGG -> CATCCTCTGACGGAATGGA
GCGACCGCTTCCACGATCC -> CGACCGCTTCCACGATCCC
TGAGAGTATCTAGAAACCC -> GAGAGTATCTAGAAACCCG
CTCAGGTGACTACCAGGCG -> TCAGGTGACTACCAGGCGG
GGCCGCGGAAGAGATAAGA -> GCCGCGGAAGAGATAAGAT
CTGGTTGAGTACCTATGAA -> TGGTTGAGTACCTATGAAG
CGGTAGTTCTGGTTGAGTA -> GGTAGTTCTGGTTGAGTAC
GAACGTTACCGCCAGGGTA -> AACGTTACCGCCAGGGTAG
ACGTGATTTAGCAGGTGGT -> CGTGATTTAGCAGGTGGTG
CGTGATTACTAAGTTGAGA -> GTGATTACTAAGTTGAGAG
TGGATCCAACTGCGCCTTT -> GGATCCAACTGCGCCTTTG
AAGGTCTGAATTAGTCTTT -> AGGTCTGAATTAGTCTTTC
TGGACACACGTGTTAATAT -> GGACACACGTGTTAATATG
TAGTAGTAAGCCCTTGTAT -> AGTAGTAAGCCCTTGTATG
TTGATAAACGCATCTTAAT -> TGATAAACGCATCTTAATC
GCACATCGACTCACAACAC -> CACATCGACTCACAACACT
GGGCGGCTTACAGAGCGCG -> GGCGGCTTACAGAGCGCGT
GGACTTAATTCCGGCCCTG -> GACTTAATTCCGGCCCTGG
CCTTACTCATTGAACGTAG -> CTTACTCATTGAACGTAGA
TGGGTTTGGATCCAACTGC -> GGGTTTGGATCCAACTGCG
ATAACTCGGGCACTAGGAT -> TAACTCGGGCACTAGGATT
GTCGGTAGTTCTGGTTGAG -> TCGGTAGTTCTGGTTGAGT
ACCCTGCACTTACTCACTG -> CCCTGCACTTACTCACTGT
TTTATCAGTCCGGTAGAGT -> TTATCAGTCCGGTAGAGTA
GCCAATCTTTACTCGATAT -> CCAATCTTTACTCGATATC
CCTCAAGAAGTTTCCTAGA -> CTCAAGAAGTTTCCTAGAC
CCTGGATAAGATTTATATC -> CTGGATAAGATTTATATCC
TTGAACGTAGACGTTTGTT -> TGAACGTAGACGTTTGTTT
GAAGGCGATCGTGTGTATT -> AAGGCGATCGTGTGTATTT
AAGTTTCCTAGACAGTGGA -> AGTTTCCTAGACAGTGGAT
TGATAAACGCATCTTAATC -> GATAAACGCATCTTAATCC
TCGTCTGGGGGCGTGCCTA -> CGTCTGGGGGCGTGCCTAG
CAGGTCAAATAGCGCAATG -> AGGTCAAATAGCGCAATGA
TGAAGGTCTGAATTAGTCT -> GAAGGTCTGAATTAGTCTT
AGGTCAAATAGCGCAATGA -> GGTCAAATAGCGCAATGAG
CGCCTTTGGAAATCGCAAC -> GCCTTTGGAAATCGCAACT
CCTATTTACACAGGTTGTG -> CTATTTACACAGGTTGTGG
ATAAAGTTTATGGCTGGCA -> TAAAGTTTATGGCTGGCAG
GTTGAGAGTATCTAGAAAC -> TTGAGAGTATCTAGAAACC
AATAGGGACTTAATTCCGG -> ATAGGGACTTAATTCCGGC
ATGAACCCTGTTTACACAG -> TGAACCCTGTTTACACAGC
GGCAGACCCTGCACTTACT -> GCAGACCCTGCACTTACTC
CTGGATAGAATTACAGCCG -> TGGATAGAATTACAGCCGT
AGTTAAGCAGGTCGGAGTC -> GTTAAGCAGGTCGGAGTCA
TAAGTGGCCATGCCTTACT -> AAGTGGCCATGCCTTACTC
GAGTTAAGCAGGTCGGAGT -> AGTTAAGCAGGTCGGAGTC
AATTTTGGTCGTGATTACT -> ATTTTGGTCGTGATTACTA
ATCCTCTGACGGAATGGAC -> TCCTCTGACGGAATGGACA
CGGAGTTGCATGGGGTTGG -> GGAGTTGCATGGGGTTGGT
AACGTTACCGCCAGGGTAG -> ACGTTACCGCCAGGGTAGC
GAAGAGCTCAGGTGACTAC -> AAGAGCTCAGGTGACTACC
CAGTCCGGTAGAGTACGGC -> AGTCCGGTAGAGTACGGCA
CGCAAAATCTTAATCCACA -> GCAAAATCTTAATCCACAG
TTCGTGCCACGATCGTCTG -> TCGTGCCACGATCGTCTGG
CGAGTATGACTTATGGCTC -> GAGTATGACTTATGGCTCT
TATTCACTATCTTAATCCA -> ATTCACTATCTTAATCCAC
ACGGAATGGACACACGTGC -> CGGAATGGACACACGTGCA
TAGTTTAACCGATGATGAA -> AGTTTAACCGATGATGAAC
TCGCAGTTAGAGCAACTGC -> CGCAGTTAGAGCAACTGCG
CGTCGCAGTTAGAGCAACT -> GTCGCAGTTAGAGCAACTG
GCGTGGAGGATGCAACATA -> CGTGGAGGATGCAACATAT
GATTTGATAAACGCATCTT -> ATTTGATAAACGCATCTTA
TTTAGATCGATCTTTTTAC -> TTAGATCGATCTTTTTACA
TCCGCCGGCGTTAGGACAG -> CCGCCGGCGTTAGGACAGG
GTGGAGGTAAACGGGTCCG -> TGGAGGTAAACGGGTCCGG
TAAGCCGACGGAATGGACA -> AAGCCGACGGAATGGACAC
CGATAAAAGTCCTACTCGA -> GATAAAAGTCCTACTCGAT
TCTTAATCCACAGTCAAGG -> CTTAATCCACAGTCAAGGT
CGTCAGAATCCGCCGGCGT -> GTCAGAATCCGCCGGCGTT
TGGGTTTGAGGCATGACAA -> GGGTTTGAGGCATGACAAA
GAGTACGGCATGGCAAGCC -> AGTACGGCATGGCAAGCCG
TATAGGCCCTGTTTAAGAG -> ATAGGCCCTGTTTAAGAGG
CCCATTAAAAACAACGGCA -> CCATTAAAAACAACGGCAC
GCTTCCACGATCCCTGGCA -> CTTCCACGATCCCTGGCAC
CAAAACTTAGTGGCGTATT -> AAAACTTAGTGGCGTATTG
ACTTATGGCTCTAAAGAAA -> CTTATGGCTCTAAAGAAAC
GGAGACTGATGAAGCGTTG -> GAGACTGATGAAGCGTTGG
ACTATGAGTTAAGCAGGTC -> CTATGAGTTAAGCAGGTCG
TCGGCTTGTCTCCTGGATA -> CGGCTTGTCTCCTGGATAA
ATGAAAGTGCCAATCTTTA -> TGAAAGTGCCAATCTTTAC
GAATGGACACACGTGCACG -> AATGGACACACGTGCACGA
CACAGGCGGAACAAGTAGC -> ACAGGCGGAACAAGTAGCG
AGACTGATGAAGCGTTGGT -> GACTGATGAAGCGTTGGTA
GAGGCGTTTCGCTGACAGG -> AGGCGTTTCGCTGACAGGA
ACTGAAGGTCTGAATTAGT -> CTGAAGGTCTGAATTAGTC
CGACCACAGGCGGAACAAG -> GACCACAGGCGGAACAAGT
AGACCCTGCACTTACTCAC -> GACCCTGCACTTACTCACT
CGTTGGAAGAAAGACCTAG -> GTTGGAAGAAAGACCTAGA
CACTATCTTAATCCACAGT -> ACTATCTTAATCCACAGTC
ATCCAACTGCGCCTTTGGA -> TCCAACTGCGCCTTTGGAA
AATCCACAGTCAAAACTAT -> ATCCACAGTCAAAACTATA
ATTTAGCAGGTGGTGTCCC -> TTTAGCAGGTGGTGTCCCT
CACGTGAGGGCCCCCTATC -> ACGTGAGGGCCCCCTATCC
CACGTGATTTAGCAGGTGG -> ACGTGATTTAGCAGGTGGT
CAACGGCACAGTCATGAAG -> AACGGCACAGTCATGAAGA
AGTCGGTAGTTCTGGTTGA -> GTCGGTAGTTCTGGTTGAG
TTGAGGCATGACAAATTAT -> TGAGGCATGACAAATTATC
CGTCCTGGTCGATACATTA -> GTCCTGGTCGATACATTAA
TCGCACATCGACTCACAAC -> CGCACATCGACTCACAACA
AGTATCTATTCACTATCTT -> GTATCTATTCACTATCTTA
TAGGATTTTATCGATGCCA -> AGGATTTTATCGATGCCAC
CTCGTTCGAGTATGACTTA -> TCGTTCGAGTATGACTTAT
TACGAGCGGAGTTGCATGG -> ACGAGCGGAGTTGCATGGG
ACAACGTGAGCCCATTAAA -> CAACGTGAGCCCATTAAAA
TTGATCCTAGCGCCGTCCG -> TGATCCTAGCGCCGTCCGA
CTAGACCAATCTAGTTGAA -> TAGACCAATCTAGTTGAAT
TCAGGCCACTCCTATTTAC -> CAGGCCACTCCTATTTACA
TTTTATCAGTCCGGTAGAG -> TTTATCAGTCCGGTAGAGT
TCGAGTGAGGCGTTTCGCT -> CGAGTGAGGCGTTTCGCTG
TAGCAGGTGGTGTCCCTCC -> AGCAGGTGGTGTCCCTCCT
AGCCCATTAAAAACAACGG -> GCCCATTAAAAACAACGGC
AACTATAAGCCGACGGAAT -> ACTATAAGCCGACGGAATG
CCCCCTTCAGGCCACTCCT -> CCCCTTCAGGCCACTCCTA
CCCCTTCAGGCCACTCCTA -> CCCTTCAGGCCACTCCTAT
TCAGTCCGGTAGAGTACGG -> CAGTCCGGTAGAGTACGGC
GGTGACTACCAGGCGGATA -> GTGACTACCAGGCGGATAT
GCTGAATTTAGATCGATCT -> CTGAATTTAGATCGATCTT
GGCCCCCACCCATGGGTCA -> GCCCCCACCCATGGGTCAT
GTAGCTCGTTCGAGTATGA -> TAGCTCGTTCGAGTATGAC
TCCGGGGTCTTAAATACAC -> CCGGGGTCTTAAATACACG
AAGTGGCCATGCCTTACTC -> AGTGGCCATGCCTTACTCA
CACAGTCAAGGTCATCCTC -> ACAGTCAAGGTCATCCTCT
AACTGCCCTTACAAATATA -> ACTGCCCTTACAAATATAG
CCATTAAAAACAACGGCAC -> CATTAAAAACAACGGCACA
TAAGAGGACTCACCACCCA -> AAGAGGACTCACCACCCAT
GGGTGCTGATGCCCATACT -> GGTGCTGATGCCCATACTC
ACTATAAGCCGACGGAATG -> CTATAAGCCGACGGAATGG
ATCCACAGTCAAAACTATA -> TCCACAGTCAAAACTATAA
AGATTTATATCCCATGAAA -> GATTTATATCCCATGAAAG
TGCTGCGACCGCTTCCACG -> GCTGCGACCGCTTCCACGA
TACCTATGAAGAGCTCAGG -> ACCTATGAAGAGCTCAGGT
AAACAACGGCACAGTCATG -> AACAACGGCACAGTCATGA
ACATGATCACCCAAGAAAA -> CATGATCACCCAAGAAAAG
TAGTACCATTATGCTGTAG -> AGTACCATTATGCTGTAGC
TCCACGATCCCTGGCACTA -> CCACGATCCCTGGCACTAA
TCCCGAGTGGAGGTAAACG -> CCCGAGTGGAGGTAAACGG
TGATCTTAATCCACAGTCA -> GATCTTAATCCACAGTCAA
GTTCGTGTATTCTCATAGG -> TTCGTGTATTCTCATAGGC
AGTGAGGCGTTTCGCTGAC -> GTGAGGCGTTTCGCTGACA
CTTTTGGGTTCGTGTATTC -> TTTTGGGTTCGTGTATTCT
GCCCCTAAGTGGCCATGCC -> CCCCTAAGTGGCCATGCCT
CATTATGCTGTAGCTCGTT -> ATTATGCTGTAGCTCGTTC
AAAATGCCAAGTCGAGTAT -> AAATGCCAAGTCGAGTATA
GCCATGCCTTACTCATTGA -> CCATGCCTTACTCATTGAA
CATTATGAACCCTGTTTAC -> ATTATGAACCCTGTTTACA
CTCACTGTGCGAAACAAGG -> TCACTGTGCGAAACAAGGA
GCGACCACAGGCGGAACAA -> CGACCACAGGCGGAACAAG
GAATAATTCTTCCGGGGTC -> AATAATTCTTCCGGGGTCT
TAGTTCTGGTTGAGTACCT -> AGTTCTGGTTGAGTACCTA
GTAGCGAGGATATATCGGT -> TAGCGAGGATATATCGGTC
GTCCTGGTCGATACATTAA -> TCCTGGTCGATACATTAAA
TTGTTTAGACATACGAGCG -> TGTTTAGACATACGAGCGG
GGCCATTCGCGATATCGAC -> GCCATTCGCGATATCGACA
AAAGAAACATCCTAGAATA -> AAGAAACATCCTAGAATAC
AGTATCTAGAAACCCGACC -> GTATCTAGAAACCCGACCT
TTGGTCGTGATTACTAAGT -> TGGTCGTGATTACTAAGTT
CGAAACAAGGACGCCTCCC -> GAAACAAGGACGCCTCCCG
CCCGAGTGGAGGTAAACGG -> CCGAGTGGAGGTAAACGGG
CGTTTGTTTAGACATACGA -> GTTTGTTTAGACATACGAG
ATGGTTGCGCAACACTGAA -> TGGTTGCGCAACACTGAAG
CCCGCAGGTCAAATAGCGC -> CCGCAGGTCAAATAGCGCA
ACTCGATAACTCGGGCACT -> CTCGATAACTCGGGCACTA
CTAAAGAAGCCCCCAAGCG -> TAAAGAAGCCCCCAAGCGC
CATGGGGTTGGTAACTATT -> ATGGGGTTGGTAACTATTC
ACCCTGTTTACACAGCTTG -> CCCTGTTTACACAGCTTGA
GAAGAAAGACCTAGACCAA -> AAGAAAGACCTAGACCAAT
TAACCGATGATGAACTGAG -> AACCGATGATGAACTGAGC
ATGGCTCTAAAGAAACATC -> TGGCTCTAAAGAAACATCC
AGAGTATCTAGAAACCCGA -> GAGTATCTAGAAACCCGAC
GGTAGAGTACGGCATGGCA -> GTAGAGTACGGCATGGCAA
GACACCACGAGGTGGTTAT -> ACACCACGAGGTGGTTATC
CCTCCCCAGGAAGGCGATC -> CTCCCCAGGAAGGCGATCG
TCAGGTGACTACCAGGCGG -> CAGGTGACTACCAGGCGGA
ATACTCGAGTGAGGCGTTT -> TACTCGAGTGAGGCGTTTC
ATAACATTCTACTAATCTG -> TAACATTCTACTAATCTGG
CGCGCGGCACTACACAATC -> GCGCGGCACTACACAATCT
GTCAAATAGCGCAATGAGC -> TCAAATAGCGCAATGAGCC
GGCTTGTCTCCTGGATAAG -> GCTTGTCTCCTGGATAAGA
CGACTCACAACACTACCTA -> GACTCACAACACTACCTAG
CAAGAAAAGTCGGTAGTTC -> AAGAAAAGTCGGTAGTTCT
AGGATTAGTAGTAAGCCCT -> GGATTAGTAGTAAGCCCTT
CTTGTATGTATCGTCCTGG -> TTGTATGTATCGTCCTGGT
TACAACGTGAGCCCATTAA -> ACAACGTGAGCCCATTAAA
GAAATCGCAACTGCCCTTA -> AAATCGCAACTGCCCTTAC
CCCTCCGGCCATTCGCGAT -> CCTCCGGCCATTCGCGATA
AGTACAACGTGAGCCCATT -> GTACAACGTGAGCCCATTA
ATTATCCCGAGTGGAGGTA -> TTATCCCGAGTGGAGGTAA
TCGTTACCCCCTTCAGGCC -> CGTTACCCCCTTCAGGCCA
CACAGGTTGTGGGCCGCGG -> ACAGGTTGTGGGCCGCGGA
ACTCACTGTGCGAAACAAG -> CTCACTGTGCGAAACAAGG
AATCCACAGTCAAGGTCAT -> ATCCACAGTCAAGGTCATC
GCTTACAGAGCGCGTTGCT -> CTTACAGAGCGCGTTGCTC
GCAACATATATCGTTGGAA -> CAACATATATCGTTGGAAT
TCCTGGATAAGATTTATAT -> CCTGGATAAGATTTATATC
CGGCACAGTCATGAAGACC -> GGCACAGTCATGAAGACCC
TAAGATTTATATCCCATGA -> AAGATTTATATCCCATGAA
TAGACGTTTGTTTAGACAT -> AGACGTTTGTTTAGACATA
CGATCGTCTGGGGGCGTGC -> GATCGTCTGGGGGCGTGCC
CTCATAGGCATCTCTTAAT -> TCATAGGCATCTCTTAATG
TATGAGTTAAGCAGGTCGG -> ATGAGTTAAGCAGGTCGGA
ATTACTAAGTTGAGAGTAT -> TTACTAAGTTGAGAGTATC
TTTGGATCCAACTGCGCCT -> TTGGATCCAACTGCGCCTT
AGTGCCAATCTTTACTCGA -> GTGCCAATCTTTACTCGAT
TGTAGCTCGTTCGAGTATG -> GTAGCTCGTTCGAGTATGA
AGTTGCTTTGGGTCGCACA -> GTTGCTTTGGGTCGCACAT
CCGAGTGGAGGTAAACGGG -> CGAGTGGAGGTAAACGGGT
GCGGCTTACAGAGCGCGTT -> CGGCTTACAGAGCGCGTTG
ATTTTTGGTTAGGTTCGGC -> TTTTTGGTTAGGTTCGGCC
ACAGCCGTGTTATAACTCC -> CAGCCGTGTTATAACTCCA
CCCCCTATCCTGAGTCTCC -> CCCCTATCCTGAGTCTCCC
TGGTAACTATTCTAAAGAA -> GGTAACTATTCTAAAGAAG
AGTGGCCATGCCTTACTCA -> GTGGCCATGCCTTACTCAT
AAGCGTTGGTAGACCCTCC -> AGCGTTGGTAGACCCTCCG
GACGTTTGTTTAGACATAC -> ACGTTTGTTTAGACATACG
GTTTGGATCCAACTGCGCC -> TTTGGATCCAACTGCGCCT
CTATTTACACAGGTTGTGG -> TATTTACACAGGTTGTGGG
AAACCCGACGGAATGGACA -> AACCCGACGGAATGGACAC
TGAAGAGCTCAGGTGACTA -> GAAGAGCTCAGGTGACTAC
TTTTTACAAAACTTAGTGG -> TTTTACAAAACTTAGTGGC
GTGCCAATCTTTACTCGAT -> TGCCAATCTTTACTCGATA
CGTTGCTCAGCGCAAAATC -> GTTGCTCAGCGCAAAATCT
GTTGGAAGAAAGACCTAGA -> TTGGAAGAAAGACCTAGAC
CACGACCTTAGGGCCATTT -> ACGACCTTAGGGCCATTTT
TCGGAGTCACTAATGGGGT -> CGGAGTCACTAATGGGGTG
GAAGGTCTGAATTAGTCTT -> AAGGTCTGAATTAGTCTTT
CAAGAAGTTTCCTAGACAG -> AAGAAGTTTCCTAGACAGT
CACGATCGTCTGGGGGCGT -> ACGATCGTCTGGGGGCGTG
TCGATACATTAAATAGGGA -> CGATACATTAAATAGGGAC
GAGTACCTATGAAGAGCTC -> AGTACCTATGAAGAGCTCA
AATGATCTTAATCCACAGT -> ATGATCTTAATCCACAGTC
TGCACGACCTTAGGGCCAT -> GCACGACCTTAGGGCCATT
GCAACTGCCCTTACAAATA -> CAACTGCCCTTACAAATAT
GACATACGAGCGGAGTTGC -> ACATACGAGCGGAGTTGCA
ATTCTCATAGGCATCTCTT -> TTCTCATAGGCATCTCTTA
CACGAGGTGGTTATCACTA -> ACGAGGTGGTTATCACTAG
CCACTTACGCACATTCGTG -> CACTTACGCACATTCGTGC
GAAACATCCTAGAATACTC -> AAACATCCTAGAATACTCG
CAACTGCGTGGAGGATGCA -> AACTGCGTGGAGGATGCAA
CGCCGCGCGTGTAAACGCA -> GCCGCGCGTGTAAACGCAT
CAGGGTAGCGAGGATATAT -> AGGGTAGCGAGGATATATC
TTAAATAGGGACTTAATTC -> TAAATAGGGACTTAATTCC
CGCAATGAGCCTAGTAAGT -> GCAATGAGCCTAGTAAGTA
GAATACCTCGATACTCGGC -> AATACCTCGATACTCGGCT
TGTGGGCCGCGGAAGAGAT -> GTGGGCCGCGGAAGAGATA
TAAATACACGCCGCGCGTG -> AAATACACGCCGCGCGTGT
GTATTGCTGCGACCGCTTC -> TATTGCTGCGACCGCTTCC
ACCATTATGCTGTAGCTCG -> CCATTATGCTGTAGCTCGT
ACACAGGTTGTGGGCCGCG -> CACAGGTTGTGGGCCGCGG
TTGGTTAGGTTCGGCCCCC -> TGGTTAGGTTCGGCCCCCA
CTCCCCAGGAAGGCGATCG -> TCCCCAGGAAGGCGATCGT
GTCATTGCCCCTAAGTGGC -> TCATTGCCCCTAAGTGGCC
AGGACAGGCGACATGATCA -> GGACAGGCGACATGATCAC
AGACAGTGGATTTGATAAA -> GACAGTGGATTTGATAAAC
ATATCGTTGGAATAATTCT -> TATCGTTGGAATAATTCTT
TAGAGTACGGCATGGCAAG -> AGAGTACGGCATGGCAAGC
CACCACCCATGGAGACTGA -> ACCACCCATGGAGACTGAT
GTTTATGGCTGGCAGACCC -> TTTATGGCTGGCAGACCCT
ATAGAATTACAGCCGTGTT -> TAGAATTACAGCCGTGTTA
AGGACTCACCACCCATGGA -> GGACTCACCACCCATGGAG
TTCTGGGTTTGGATCCAAC -> TCTGGGTTTGGATCCAACT
CTGCACTTACTCACTGTGC -> TGCACTTACTCACTGTGCG
CATGATCACCCAAGAAAAG -> ATGATCACCCAAGAAAAGT
CAGAATCCGCCGGCGTTAG -> AGAATCCGCCGGCGTTAGG
GCTGATGCCCATACTCGAG -> CTGATGCCCATACTCGAGT
GGCACAGTCATGAAGACCC -> GCACAGTCATGAAGACCCA
AGTGGATTTGATAAACGCA -> GTGGATTTGATAAACGCAT
ATCTATTCACTATCTTAAT -> TCTATTCACTATCTTAATC
ATCGCAACTGCCCTTACAA -> TCGCAACTGCCCTTACAAA
TAGTAAGCCCTTGTATGTA -> AGTAAGCCCTTGTATGTAT
AAAGTTTATGGCTGGCAGA -> AAGTTTATGGCTGGCAGAC
GTGCCAGTCCTCGTCAGAA -> TGCCAGTCCTCGTCAGAAT
GATGTTAATTCCGCGTTTT -> ATGTTAATTCCGCGTTTTA
ATACATTAAATAGGGACTT -> TACATTAAATAGGGACTTA
CTCCTATTTACACAGGTTG -> TCCTATTTACACAGGTTGT
TGCCTAGTATGTAGTACCA -> GCCTAGTATGTAGTACCAT
AGTAAGTAGTACAACGTGA -> GTAAGTAGTACAACGTGAG
ATGCCGGCCCGGACAATAA -> TGCCGGCCCGGACAATAAC
GAAACAAGGACGCCTCCCG -> AAACAAGGACGCCTCCCGC
TGATCACCCAAGAAAAGTC -> GATCACCCAAGAAAAGTCG
TGTATTTAGCCTCAAGAAG -> GTATTTAGCCTCAAGAAGT
ATGAGAACGTTACCGCCAG -> TGAGAACGTTACCGCCAGG
ACAACGGCACAGTCATGAA -> CAACGGCACAGTCATGAAG
TACTCGGCTTGTCTCCTGG -> ACTCGGCTTGTCTCCTGGA
CTGATGCCCATACTCGAGT -> TGATGCCCATACTCGAGTG
CATACGAGCGGAGTTGCAT -> ATACGAGCGGAGTTGCATG
GTGTGTATTTAGCCTCAAG -> TGTGTATTTAGCCTCAAGA
CACCCAAGAAAAGTCGGTA -> ACCCAAGAAAAGTCGGTAG
CGATACATTAAATAGGGAC -> GATACATTAAATAGGGACT
TTCTGGTCCTAGGAATAAA -> TCTGGTCCTAGGAATAAAG
GAAATTTTGGTCGTGATTA -> AAATTTTGGTCGTGATTAC
TCCCATGAAAGTGCCAATC -> CCCATGAAAGTGCCAATCT
TACAGCCGTGTTATAACTC -> ACAGCCGTGTTATAACTCC
GGCGTTAGGACAGGCGACA -> GCGTTAGGACAGGCGACAT
TTGGGTTCGTGTATTCTCA -> TGGGTTCGTGTATTCTCAT
GCTGTAGCTCGTTCGAGTA -> CTGTAGCTCGTTCGAGTAT
CCGCGTTTTATCAGTCCGG -> CGCGTTTTATCAGTCCGGT
TTCTGTTCTGACGGAATGG -> TCTGTTCTGACGGAATGGA
ACTTCACTTAGTATCTATT -> CTTCACTTAGTATCTATTC
ACTTAGTATCTATTCACTA -> CTTAGTATCTATTCACTAT
ACGTGAGCCCATTAAAAAC -> CGTGAGCCCATTAAAAACA
TGCGTCGCAGTTAGAGCAA -> GCGTCGCAGTTAGAGCAAC
GTGAGCCCATTAAAAACAA -> TGAGCCCATTAAAAACAAC
GGTCATCCTCTGACGGAAT -> GTCATCCTCTGACGGAATG
TCCTAGCGCCGTCCGACTG -> CCTAGCGCCGTCCGACTGG
GGGGGCGTGCCTAGTATGT -> GGGGCGTGCCTAGTATGTA
TTGGTCTTCTGGTCCTAGG -> TGGTCTTCTGGTCCTAGGA
GTCCGGTAGAGTACGGCAT -> TCCGGTAGAGTACGGCATG
GAACTGAGCGCGCGGCACT -> AACTGAGCGCGCGGCACTA
AAAACAACGGCACAGTCAT -> AAACAACGGCACAGTCATG
GGTCGATACATTAAATAGG -> GTCGATACATTAAATAGGG
GGCGTGCCTAGTATGTAGT -> GCGTGCCTAGTATGTAGTA
AGGCCACGCGACCACAGGC -> GGCCACGCGACCACAGGCG
TAGGCATCTCTTAATGATC -> AGGCATCTCTTAATGATCT
CAGTGGATTTGATAAACGC -> AGTGGATTTGATAAACGCA
TCCTCTGACGGAATGGACA -> CCTCTGACGGAATGGACAC
ACCCAAGAAAAGTCGGTAG -> CCCAAGAAAAGTCGGTAGT
GATCTTTTTACAAAACTTA -> ATCTTTTTACAAAACTTAG
TGCTCAGCGCAAAATCTTA -> GCTCAGCGCAAAATCTTAA
TCCCTCCTTCCGAACAAAA -> CCCTCCTTCCGAACAAAAT
ATTCGTGCCACGATCGTCT -> TTCGTGCCACGATCGTCTG
TCGATAACTCGGGCACTAG -> CGATAACTCGGGCACTAGG
ATCTAGTTGAATTGGTCTT -> TCTAGTTGAATTGGTCTTC
CGAGAATACCTCGATACTC -> GAGAATACCTCGATACTCG
GTTCTGGTTGAGTACCTAT -> TTCTGGTTGAGTACCTATG
TGTGCGAAACAAGGACGCC -> GTGCGAAACAAGGACGCCT
GTTAATATGAGTTGCTTTG -> TTAATATGAGTTGCTTTGG
CTATGAGTTAAGCAGGTCG -> TATGAGTTAAGCAGGTCGG
ATGAAGACCCACGAGAATA -> TGAAGACCCACGAGAATAC
CAAATAGCGCAATGAGCCT -> AAATAGCGCAATGAGCCTA
TATGACTTATGGCTCTAAA -> ATGACTTATGGCTCTAAAG
TCCCTGGCACTAATGGACT -> CCCTGGCACTAATGGACTT
TGGTCTAGTTTAACCGATG -> GGTCTAGTTTAACCGATGA
CCAAGAAAAGTCGGTAGTT -> CAAGAAAAGTCGGTAGTTC
ATTTATATCCCATGAAAGT -> TTTATATCCCATGAAAGTG
GGACACACGTGTTAATATG -> GACACACGTGTTAATATGA
AGGTTCGGCCCCCACCCAT -> GGTTCGGCCCCCACCCATG
CCCTGCACTTACTCACTGT -> CCTGCACTTACTCACTGTG
AGGATGCAACATATATCGT -> GGATGCAACATATATCGTT
GGATTTGATAAACGCATCT -> GATTTGATAAACGCATCTT
CTGAATTTAGATCGATCTT -> TGAATTTAGATCGATCTTT
TCAGAATCCGCCGGCGTTA -> CAGAATCCGCCGGCGTTAG
CAGTCCTGTCCAGTAGAAA -> AGTCCTGTCCAGTAGAAAT
GGATTAGTAGTAAGCCCTT -> GATTAGTAGTAAGCCCTTG
AACGCATTATGAACCCTGT -> ACGCATTATGAACCCTGTT
CGCAACACTGAAGGTCTGA -> GCAACACTGAAGGTCTGAA
ATATATAAAGGTCAGTCCT -> TATATAAAGGTCAGTCCTG
GGAGGTAAACGGGTCCGGG -> GAGGTAAACGGGTCCGGGT
GTTATCACTAGGCCACGCG -> TTATCACTAGGCCACGCGA
TTGGTAGACCCTCCGGCCA -> TGGTAGACCCTCCGGCCAT
AGGCGGAACAAGTAGCGTC -> GGCGGAACAAGTAGCGTCT
TAGACCCTCCGGCCATTCG -> AGACCCTCCGGCCATTCGC
GCGCGCGGCACTACACAAT -> CGCGCGGCACTACACAATC
ACCACGAGGTGGTTATCAC -> CCACGAGGTGGTTATCACT
ATGACAAATTATCCCGAGT -> TGACAAATTATCCCGAGTG
CATGGGTCATTGCCCCTAA -> ATGGGTCATTGCCCCTAAG
GAGACTGATGAAGCGTTGG -> AGACTGATGAAGCGTTGGT
GTGATTTAGCAGGTGGTGT -> TGATTTAGCAGGTGGTGTC
AGCTCAGGTGACTACCAGG -> GCTCAGGTGACTACCAGGC
GCCCATACTCGAGTGAGGC -> CCCATACTCGAGTGAGGCG
GTCATCCTCTGACGGAATG -> TCATCCTCTGACGGAATGG
CTATTCACTATCTTAATCC -> TATTCACTATCTTAATCCA
AGGACGCCTCCCGCAGGTC -> GGACGCCTCCCGCAGGTCA
TTCGGCCCCCACCCATGGG -> TCGGCCCCCACCCATGGGT
TTATCACTAGGCCACGCGA -> TATCACTAGGCCACGCGAC
AAACGGGTCCGGGTGCCAG -> AACGGGTCCGGGTGCCAGT
GGAGTCACTAATGGGGTGC -> GAGTCACTAATGGGGTGCT
TGGTTGAGTACCTATGAAG -> GGTTGAGTACCTATGAAGA
TGAAAGTGCCAATCTTTAC -> GAAAGTGCCAATCTTTACT
ATACTCGGCTTGTCTCCTG -> TACTCGGCTTGTCTCCTGG
GACCGCTTCCACGATCCCT -> ACCGCTTCCACGATCCCTG
GAGTATGACTTATGGCTCT -> AGTATGACTTATGGCTCTA
ACATACGAGCGGAGTTGCA -> CATACGAGCGGAGTTGCAT
GCCCTTACAAATATAGGCC -> CCCTTACAAATATAGGCCC
GGCCCTGGTCTAGTTTAAC -> GCCCTGGTCTAGTTTAACC
TTAAAAACAACGGCACAGT -> TAAAAACAACGGCACAGTC
CGCAGGTCAAATAGCGCAA -> GCAGGTCAAATAGCGCAAT
AGGGCGGCTTACAGAGCGC -> GGGCGGCTTACAGAGCGCG
ACAGTCAACATCAAAACCC -> CAGTCAACATCAAAACCCG
GCCGACGGAATGGACACAC -> CCGACGGAATGGACACACG
GCCGGCCCGGACAATAACA -> CCGGCCCGGACAATAACAT
CCTGGCCCTCCCCAGGAAG -> CTGGCCCTCCCCAGGAAGG
CTGCCCTTACAAATATAGG -> TGCCCTTACAAATATAGGC
ACGAGAATACCTCGATACT -> CGAGAATACCTCGATACTC
CACGCGACCACAGGCGGAA -> ACGCGACCACAGGCGGAAC
TGGTCCTAGGAATAAAGTT -> GGTCCTAGGAATAAAGTTT
GGCACTAATGGACTTCACT -> GCACTAATGGACTTCACTT
GGTCAAATAGCGCAATGAG -> GTCAAATAGCGCAATGAGC
GCTTGTCTCCTGGATAAGA -> CTTGTCTCCTGGATAAGAT
GGGTCTTAAATACACGCCG -> GGTCTTAAATACACGCCGC
TGTCTCCTGGATAAGATTT -> GTCTCCTGGATAAGATTTA
CGTGATTTAGCAGGTGGTG -> GTGATTTAGCAGGTGGTGT
TACACGCCGCGCGTGTAAA -> ACACGCCGCGCGTGTAAAC
TGTCCCTCCTTCCGAACAA -> GTCCCTCCTTCCGAACAAA
ATGCCAAGTCGAGTATATA -> TGCCAAGTCGAGTATATAT
AAAGTCGGTAGTTCTGGTT -> AAGTCGGTAGTTCTGGTTG
ATGACTTATGGCTCTAAAG -> TGACTTATGGCTCTAAAGA
TACGCACATTCGTGCCACG -> ACGCACATTCGTGCCACGA
TTAACCGATGATGAACTGA -> TAACCGATGATGAACTGAG
CTTAATCCACAGTCAAAAC -> TTAATCCACAGTCAAAACT
CGTGAGCCCATTAAAAACA -> GTGAGCCCATTAAAAACAA
GGGTTGGTAACTATTCTAA -> GGTTGGTAACTATTCTAAA
TCCACAGTCAAAACTATAA -> CCACAGTCAAAACTATAAG
CGACCTACTTATGCCGGCC -> GACCTACTTATGCCGGCCC
GAAGACCCACGAGAATACC -> AAGACCCACGAGAATACCT
GCCAGGGTAGCGAGGATAT -> CCAGGGTAGCGAGGATATA
ATGAGTTGCTTTGGGTCGC -> TGAGTTGCTTTGGGTCGCA
TCCACAGTCAACATCAAAA -> CCACAGTCAACATCAAAAC
ATCTTAATCCACAGTCAAT -> TCTTAATCCACAGTCAATC
TTATCCTGGCCCTCCCCAG -> TATCCTGGCCCTCCCCAGG
TTTAAGAGGACTCACCACC -> TTAAGAGGACTCACCACCC
TAGCGCAATGAGCCTAGTA -> AGCGCAATGAGCCTAGTAA
GAGGGCCCCCTATCCTGAG -> AGGGCCCCCTATCCTGAGT
CGCGATATCGACACCACGA -> GCGATATCGACACCACGAG
AAGGCGATCGTGTGTATTT -> AGGCGATCGTGTGTATTTA
GACCCTGCACTTACTCACT -> ACCCTGCACTTACTCACTG
CTGTTCTGACGGAATGGAC -> TGTTCTGACGGAATGGACA
AGGTGACTACCAGGCGGAT -> GGTGACTACCAGGCGGATA
ATTACAGCCGTGTTATAAC -> TTACAGCCGTGTTATAACT
CGGCGTTAGGACAGGCGAC -> GGCGTTAGGACAGGCGACA
TGATGAAGCGTTGGTAGAC -> GATGAAGCGTTGGTAGACC
GGTGGTGTCCCTCCTTCCG -> GTGGTGTCCCTCCTTCCGA
CCTGTCCAGTAGAAATTTT -> CTGTCCAGTAGAAATTTTG
TGCATGGGGTTGGTAACTA -> GCATGGGGTTGGTAACTAT
TTAATCCACAGTCAATCTT -> TAATCCACAGTCAATCTTC
AGAATCCGCCGGCGTTAGG -> GAATCCGCCGGCGTTAGGA
GCAAGCCGATAAAAGTCCT -> CAAGCCGATAAAAGTCCTA
GCGTGCCTAGTATGTAGTA -> CGTGCCTAGTATGTAGTAC
TGGAAATCGCAACTGCCCT -> GGAAATCGCAACTGCCCTT
ACGTAGACGTTTGTTTAGA -> CGTAGACGTTTGTTTAGAC
TATATAAAGGTCAGTCCTG -> ATATAAAGGTCAGTCCTGT
TCTTCTGGTCCTAGGAATA -> CTTCTGGTCCTAGGAATAA
AGAAACCCGACCTACTTAT -> GAAACCCGACCTACTTATG
CATCCTCTGACGGAATGGA -> ATCCTCTGACGGAATGGAC
CCGACTGGCTGAATTTAGA -> CGACTGGCTGAATTTAGAT
AGTCCTCGTCAGAATCCGC -> GTCCTCGTCAGAATCCGCC
AATCGCAACTGCCCTTACA -> ATCGCAACTGCCCTTACAA
TATGCTGTAGCTCGTTCGA -> ATGCTGTAGCTCGTTCGAG
CATTCGCGATATCGACACC -> ATTCGCGATATCGACACCA
GAAAGACCTAGACCAATCT -> AAAGACCTAGACCAATCTA
GAGTGAGGCGTTTCGCTGA -> AGTGAGGCGTTTCGCTGAC
TGAAGACCCACGAGAATAC -> GAAGACCCACGAGAATACC
ATGCTGTAGCTCGTTCGAG -> TGCTGTAGCTCGTTCGAGT
TTACAAAACTTAGTGGCGT -> TACAAAACTTAGTGGCGTA
AGGCCCTGTTTAAGAGGAC -> GGCCCTGTTTAAGAGGACT
ATGGACACACGTGATTTAG -> TGGACACACGTGATTTAGC
TACTAATCTGGATAGAATT -> ACTAATCTGGATAGAATTA
CACGTTGGAAGAAAGACCT -> ACGTTGGAAGAAAGACCTA
ATGATCTTAATCCACAGTC -> TGATCTTAATCCACAGTCA
GGACAATAACATTCTACTA -> GACAATAACATTCTACTAA
GATCGTGTGTATTTAGCCT -> ATCGTGTGTATTTAGCCTC
CAAGTAGCGTCTTACGTTA -> AAGTAGCGTCTTACGTTAT
TTAGCAGGTGGTGTCCCTC -> TAGCAGGTGGTGTCCCTCC
CCACGATCGTCTGGGGGCG -> CACGATCGTCTGGGGGCGT
CACAGCTTGATCCTAGCGC -> ACAGCTTGATCCTAGCGCC
GAGTTGCTTTGGGTCGCAC -> AGTTGCTTTGGGTCGCACA
GTGCTGATGCCCATACTCG -> TGCTGATGCCCATACTCGA
ATGCAACATATATCGTTGG -> TGCAACATATATCGTTGGA
CTCCCGCAGGTCAAATAGC -> TCCCGCAGGTCAAATAGCG
TCCACGCTATGCGTCGCAG -> CCACGCTATGCGTCGCAGT
CCTATCCTGAGTCTCCCAC -> CTATCCTGAGTCTCCCACT
TAGACAGTGGATTTGATAA -> AGACAGTGGATTTGATAAA
TAAAGGTCAGTCCTGTCCA -> AAAGGTCAGTCCTGTCCAG
TCCTAGGAATAAAGTTTAT -> CCTAGGAATAAAGTTTATG
ACAATAACATTCTACTAAT -> CAATAACATTCTACTAATC
ATGAGTTAAGCAGGTCGGA -> TGAGTTAAGCAGGTCGGAG
GCATGACAAATTATCCCGA -> CATGACAAATTATCCCGAG
CTAGGATTTTATCGATGCC -> TAGGATTTTATCGATGCCA
ATCTAGAAACCCGACCTAC -> TCTAGAAACCCGACCTACT
ACACAATCTTTTGGGTTCG -> CACAATCTTTTGGGTTCGT
TTACCCCCTTCAGGCCACT -> TACCCCCTTCAGGCCACTC
GGGTCATTGCCCCTAAGTG -> GGTCATTGCCCCTAAGTGG
GTTGCATGGGGTTGGTAAC -> TTGCATGGGGTTGGTAACT
AACAAGTAGCGTCTTACGT -> ACAAGTAGCGTCTTACGTT
ACACGCCGCGCGTGTAAAC -> CACGCCGCGCGTGTAAACG
GCGGAACAAGTAGCGTCTT -> CGGAACAAGTAGCGTCTTA
CTGTAGCTCGTTCGAGTAT -> TGTAGCTCGTTCGAGTATG
GGCGACATGATCACCCAAG -> GCGACATGATCACCCAAGA
CGACCGCTTCCACGATCCC -> GACCGCTTCCACGATCCCT
GGCCATTTTTGGTTAGGTT -> GCCATTTTTGGTTAGGTTC
CACATTCGTGCCACGATCG -> ACATTCGTGCCACGATCGT
AGCCGACGGAATGGACACA -> GCCGACGGAATGGACACAC
ACACAGCTTGATCCTAGCG -> CACAGCTTGATCCTAGCGC
GCCAAGTCGAGTATATATA -> CCAAGTCGAGTATATATAA
CGACACCACGAGGTGGTTA -> GACACCACGAGGTGGTTAT
GGCGTTTCGCTGACAGGAT -> GCGTTTCGCTGACAGGATT
CGGCTTGTCTCCTGGATAA -> GGCTTGTCTCCTGGATAAG
TGTATTCTCATAGGCATCT -> GTATTCTCATAGGCATCTC
GCCCTCCCCAGGAAGGCGA -> CCCTCCCCAGGAAGGCGAT
CCACTCCTATTTACACAGG -> CACTCCTATTTACACAGGT
TGGGGTGCTGATGCCCATA -> GGGGTGCTGATGCCCATAC
GGCGGCTTACAGAGCGCGT -> GCGGCTTACAGAGCGCGTT
TTAGAGCAACTGCGTGGAG -> TAGAGCAACTGCGTGGAGG
GCCTAGTATGTAGTACCAT -> CCTAGTATGTAGTACCATT
TTTGGTCGTGATTACTAAG -> TTGGTCGTGATTACTAAGT
CCGATGATGAACTGAGCGC -> CGATGATGAACTGAGCGCG
ATAAAGGTCAGTCCTGTCC -> TAAAGGTCAGTCCTGTCCA
GAACGTAGACGTTTGTTTA -> AACGTAGACGTTTGTTTAG
TCTAGTTTAACCGATGATG -> CTAGTTTAACCGATGATGA
CCAATCTTTACTCGATATC -> CAATCTTTACTCGATATCA
TAGTCTTTCTGGGTTTGGA -> AGTCTTTCTGGGTTTGGAT
ATTAGTCTTTCTGGGTTTG -> TTAGTCTTTCTGGGTTTGG
TAGTTGAATTGGTCTTCTG -> AGTTGAATTGGTCTTCTGG
GAAGCCCCCAAGCGCCTTA -> AAGCCCCCAAGCGCCTTAT
GTCGGAGTCACTAATGGGG -> TCGGAGTCACTAATGGGGT
TGACTTATGGCTCTAAAGA -> GACTTATGGCTCTAAAGAA
GTAAACGGGTCCGGGTGCC -> TAAACGGGTCCGGGTGCCA
GCTCAGCGCAAAATCTTAA -> CTCAGCGCAAAATCTTAAT
GCACATTCGTGCCACGATC -> CACATTCGTGCCACGATCG
AAATACACGCCGCGCGTGT -> AATACACGCCGCGCGTGTA
GCCATTCGCGATATCGACA -> CCATTCGCGATATCGACAC
AGAATACCTCGATACTCGG -> GAATACCTCGATACTCGGC
CTTTCTGGGTTTGGATCCA -> TTTCTGGGTTTGGATCCAA
CGTTGGTAGACCCTCCGGC -> GTTGGTAGACCCTCCGGCC
CCTGGTCGATACATTAAAT -> CTGGTCGATACATTAAATA
TGATGAACTGAGCGCGCGG -> GATGAACTGAGCGCGCGGC
TTACGTTATCCACGCTATG -> TACGTTATCCACGCTATGC
GTATATATAAAGGTCAGTC -> TATATATAAAGGTCAGTCC
TGACAGGATTAGTAGTAAG -> GACAGGATTAGTAGTAAGC
CGTGCACGACCTTAGGGCC -> GTGCACGACCTTAGGGCCA
GGCTGGCAGACCCTGCACT -> GCTGGCAGACCCTGCACTT
GTAGAGTACGGCATGGCAA -> TAGAGTACGGCATGGCAAG
TTACTCGATATCAAGAACT -> TACTCGATATCAAGAACTA
TCACTTAGTATCTATTCAC -> CACTTAGTATCTATTCACT
CCTGGCACTAATGGACTTC -> CTGGCACTAATGGACTTCA
ACCGCTTCCACGATCCCTG -> CCGCTTCCACGATCCCTGG
AGTTTAACCGATGATGAAC -> GTTTAACCGATGATGAACT
TATTTACACAGGTTGTGGG -> ATTTACACAGGTTGTGGGC
CACATCGACTCACAACACT -> ACATCGACTCACAACACTA
AATATGAGTTGCTTTGGGT -> ATATGAGTTGCTTTGGGTC
TTTGGGTCGCACATCGACT -> TTGGGTCGCACATCGACTC
TGCCCCTAAGTGGCCATGC -> GCCCCTAAGTGGCCATGCC
CAACTGCCCTTACAAATAT -> AACTGCCCTTACAAATATA
CAGGTCGGAGTCACTAATG -> AGGTCGGAGTCACTAATGG
CACAGTCAATCTTCTGTTC -> ACAGTCAATCTTCTGTTCT
GCCTAGTAAGTAGTACAAC -> CCTAGTAAGTAGTACAACG
CTACCAGGCGGATATGGTT -> TACCAGGCGGATATGGTTG
AGCCTAGTAAGTAGTACAA -> GCCTAGTAAGTAGTACAAC
AATTCCGGCCCTGGTCTAG -> ATTCCGGCCCTGGTCTAGT
TACTCGATAACTCGGGCAC -> ACTCGATAACTCGGGCACT
GGATATATCGGTCGTTACC -> GATATATCGGTCGTTACCC
CCTTCCGAACAAAATGCCA -> CTTCCGAACAAAATGCCAA
TTCCGGCCCTGGTCTAGTT -> TCCGGCCCTGGTCTAGTTT
ACAAATTATCCCGAGTGGA -> CAAATTATCCCGAGTGGAG
AATTTAGATCGATCTTTTT -> ATTTAGATCGATCTTTTTA
ATGATGAACTGAGCGCGCG -> TGATGAACTGAGCGCGCGG
CGCGGCACTACACAATCTT -> GCGGCACTACACAATCTTT
TGTTTAAGAGGACTCACCA -> GTTTAAGAGGACTCACCAC
CCACAGTCAATCTTCTGTT -> CACAGTCAATCTTCTGTTC
GGGTCCGGGTGCCAGTCCT -> GGTCCGGGTGCCAGTCCTC
AGGTTGTGGGCCGCGGAAG -> GGTTGTGGGCCGCGGAAGA
TATTCTAAAGAAGCCCCCA -> ATTCTAAAGAAGCCCCCAA
CGGACAATAACATTCTACT -> GGACAATAACATTCTACTA
GCTGCGACCGCTTCCACGA -> CTGCGACCGCTTCCACGAT
ATTCTAAAGAAGCCCCCAA -> TTCTAAAGAAGCCCCCAAG
ATTATGAACCCTGTTTACA -> TTATGAACCCTGTTTACAC
ACAAGTAGCGTCTTACGTT -> CAAGTAGCGTCTTACGTTA
GTCGCAGTTAGAGCAACTG -> TCGCAGTTAGAGCAACTGC
TTTAGCAGGTGGTGTCCCT -> TTAGCAGGTGGTGTCCCTC
GCCTTATCCTGGCCCTCCC -> CCTTATCCTGGCCCTCCCC
GCAGGTCGGAGTCACTAAT -> CAGGTCGGAGTCACTAATG
CGAGGTGGTTATCACTAGG -> GAGGTGGTTATCACTAGGC
CAGGTGGTGTCCCTCCTTC -> AGGTGGTGTCCCTCCTTCC
GGATTTTATCGATGCCACG -> GATTTTATCGATGCCACGT
CCTTGTATGTATCGTCCTG -> CTTGTATGTATCGTCCTGG
CTCCGGCCATTCGCGATAT -> TCCGGCCATTCGCGATATC
TAGGGCCATTTTTGGTTAG -> AGGGCCATTTTTGGTTAGG
TTACACAGGTTGTGGGCCG -> TACACAGGTTGTGGGCCGC
CTGGGGGCGTGCCTAGTAT -> TGGGGGCGTGCCTAGTATG
CCGCGCGTGTAAACGCATT -> CGCGCGTGTAAACGCATTA
ATGGCTGGCAGACCCTGCA -> TGGCTGGCAGACCCTGCAC
GTACCATTATGCTGTAGCT -> TACCATTATGCTGTAGCTC
GGGTTTGAGGCATGACAAA -> GGTTTGAGGCATGACAAAT
GACCTACTTATGCCGGCCC -> ACCTACTTATGCCGGCCCG
AGTTTATGGCTGGCAGACC -> GTTTATGGCTGGCAGACCC
TAGACCAATCTAGTTGAAT -> AGACCAATCTAGTTGAATT
GCTCGTTCGAGTATGACTT -> CTCGTTCGAGTATGACTTA
CTGTTTACACAGCTTGATC -> TGTTTACACAGCTTGATCC
TTACTCATTGAACGTAGAC -> TACTCATTGAACGTAGACG
TCCTGGCCCTCCCCAGGAA -> CCTGGCCCTCCCCAGGAAG
CCTAAGTGGCCATGCCTTA -> CTAAGTGGCCATGCCTTAC
ACTAGGATTTTATCGATGC -> CTAGGATTTTATCGATGCC
CAACATCAAAACCCGACGG -> AACATCAAAACCCGACGGA
CAATAACATTCTACTAATC -> AATAACATTCTACTAATCT
GTCAGTCCTGTCCAGTAGA -> TCAGTCCTGTCCAGTAGAA
AGACCTAGACCAATCTAGT -> GACCTAGACCAATCTAGTT
AGTCCTACTCGATAACTCG -> GTCCTACTCGATAACTCGG
CTAATGGGGTGCTGATGCC -> TAATGGGGTGCTGATGCCC
GCGTTGCTCAGCGCAAAAT -> CGTTGCTCAGCGCAAAATC
AGGCATCTCTTAATGATCT -> GGCATCTCTTAATGATCTT
TTGGAATAATTCTTCCGGG -> TGGAATAATTCTTCCGGGG
TAATCCACAGTCAATCTTC -> AATCCACAGTCAATCTTCT
TTAGGTTCGGCCCCCACCC -> TAGGTTCGGCCCCCACCCA
ATATATCGTTGGAATAATT -> TATATCGTTGGAATAATTC
CGATAACTCGGGCACTAGG -> GATAACTCGGGCACTAGGA
CGGGCACTAGGATTTTATC -> GGGCACTAGGATTTTATCG
ACCTACTTATGCCGGCCCG -> CCTACTTATGCCGGCCCGG
AGGGCCATTTTTGGTTAGG -> GGGCCATTTTTGGTTAGGT
ATAAGATTTATATCCCATG -> TAAGATTTATATCCCATGA
GGACAGGCGACATGATCAC -> GACAGGCGACATGATCACC
AGTAAGCCCTTGTATGTAT -> GTAAGCCCTTGTATGTATC
CCAATGAGAACGTTACCGC -> CAATGAGAACGTTACCGCC
CTGGTCGATACATTAAATA -> TGGTCGATACATTAAATAG
GGTCCTAGGAATAAAGTTT -> GTCCTAGGAATAAAGTTTA
TCCGCGTTTTATCAGTCCG -> CCGCGTTTTATCAGTCCGG
TAGTACAACGTGAGCCCAT -> AGTACAACGTGAGCCCATT
AGGAGGGCGGCTTACAGAG -> GGAGGGCGGCTTACAGAGC
GAGATAAGATGTTAATTCC -> AGATAAGATGTTAATTCCG
AACATCAAAACCCGACGGA -> ACATCAAAACCCGACGGAA
CACAGTCAACATCAAAACC -> ACAGTCAACATCAAAACCC
AGGGCCCCCTATCCTGAGT -> GGGCCCCCTATCCTGAGTC
GAGTGGAGGTAAACGGGTC -> AGTGGAGGTAAACGGGTCC
TCGATGCCACGTTGGAAGA -> CGATGCCACGTTGGAAGAA
GTGGCCATGCCTTACTCAT -> TGGCCATGCCTTACTCATT
AAGCCCTTGTATGTATCGT -> AGCCCTTGTATGTATCGTC
TCGGGCACTAGGATTTTAT -> CGGGCACTAGGATTTTATC
TACTCGATATCAAGAACTA -> ACTCGATATCAAGAACTAT
TAGTAAGTAGTACAACGTG -> AGTAAGTAGTACAACGTGA
TGGGGTTGGTAACTATTCT -> GGGGTTGGTAACTATTCTA
CTAGAATACTCGTCCAGGA -> TAGAATACTCGTCCAGGAG
AGTTGAGAGTATCTAGAAA -> GTTGAGAGTATCTAGAAAC
TCGTGATTACTAAGTTGAG -> CGTGATTACTAAGTTGAGA
CGTCTTACGTTATCCACGC -> GTCTTACGTTATCCACGCT
AAGACCTAGACCAATCTAG -> AGACCTAGACCAATCTAGT
CATTGAACGTAGACGTTTG -> ATTGAACGTAGACGTTTGT
CCCTTGTATGTATCGTCCT -> CCTTGTATGTATCGTCCTG
GATATCGACACCACGAGGT -> ATATCGACACCACGAGGTG
TTATATCCCATGAAAGTGC -> TATATCCCATGAAAGTGCC
TGTTAATATGAGTTGCTTT -> GTTAATATGAGTTGCTTTG
GCTTTGGGTCGCACATCGA -> CTTTGGGTCGCACATCGAC
GCGATCGTGTGTATTTAGC -> CGATCGTGTGTATTTAGCC
TATGAACCCTGTTTACACA -> ATGAACCCTGTTTACACAG
TTCGAGTATGACTTATGGC -> TCGAGTATGACTTATGGCT
GAGTTGCATGGGGTTGGTA -> AGTTGCATGGGGTTGGTAA
AGGTAAACGGGTCCGGGTG -> GGTAAACGGGTCCGGGTGC
TGAGCCTAGTAAGTAGTAC -> GAGCCTAGTAAGTAGTACA
GGGACTTAATTCCGGCCCT -> GGACTTAATTCCGGCCCTG
CACTACACAATCTTTTGGG -> ACTACACAATCTTTTGGGT
TGCCAGTCCTCGTCAGAAT -> GCCAGTCCTCGTCAGAATC
CCTAGTAAGTAGTACAACG -> CTAGTAAGTAGTACAACGT
TCTTCCGGGGTCTTAAATA -> CTTCCGGGGTCTTAAATAC
TTAGACATACGAGCGGAGT -> TAGACATACGAGCGGAGTT
GTGTTATAACTCCAATGAG -> TGTTATAACTCCAATGAGA
ACTCATTGAACGTAGACGT -> CTCATTGAACGTAGACGTT
TACGTTATCCACGCTATGC -> ACGTTATCCACGCTATGCG
AGACATACGAGCGGAGTTG -> GACATACGAGCGGAGTTGC
TACTAAGTTGAGAGTATCT -> ACTAAGTTGAGAGTATCTA
CATCAAAACCCGACGGAAT -> ATCAAAACCCGACGGAATG
AGATAAGATGTTAATTCCG -> GATAAGATGTTAATTCCGC
TAGCCTCAAGAAGTTTCCT -> AGCCTCAAGAAGTTTCCTA
GCGTTTCGCTGACAGGATT -> CGTTTCGCTGACAGGATTA
GAATTAGTCTTTCTGGGTT -> AATTAGTCTTTCTGGGTTT
AAGCGCCTTATCCTGGCCC -> AGCGCCTTATCCTGGCCCT
GGGTTTGGATCCAACTGCG -> GGTTTGGATCCAACTGCGC
ACACCACGAGGTGGTTATC -> CACCACGAGGTGGTTATCA
AAATATAGGCCCTGTTTAA -> AATATAGGCCCTGTTTAAG
CCCTTCAGGCCACTCCTAT -> CCTTCAGGCCACTCCTATT
GGCATGGCAAGCCGATAAA -> GCATGGCAAGCCGATAAAA
CGTGTTATAACTCCAATGA -> GTGTTATAACTCCAATGAG
TATCGATGCCACGTTGGAA -> ATCGATGCCACGTTGGAAG
GCATGGGGTTGGTAACTAT -> CATGGGGTTGGTAACTATT
GTATGACTTATGGCTCTAA -> TATGACTTATGGCTCTAAA
CCCTTACAAATATAGGCCC -> CCTTACAAATATAGGCCCT
CTGAGCGCGCGGCACTACA -> TGAGCGCGCGGCACTACAC
AAATAGCGCAATGAGCCTA -> AATAGCGCAATGAGCCTAG
TATCGTCCTGGTCGATACA -> ATCGTCCTGGTCGATACAT
GGACACACGTGAGGGCCCC -> GACACACGTGAGGGCCCCC
TAGGTTCGGCCCCCACCCA -> AGGTTCGGCCCCCACCCAT
CATTCGTGCCACGATCGTC -> ATTCGTGCCACGATCGTCT
GGTCGGAGTCACTAATGGG -> GTCGGAGTCACTAATGGGG
CACAGTCAAAACTATAAGC -> ACAGTCAAAACTATAAGCC
TCTGACGGAATGGACACAC -> CTGACGGAATGGACACACG,CTGACGGAATGGACACACG
GGTGGTTATCACTAGGCCA -> GTGGTTATCACTAGGCCAC
TCGGTAGTTCTGGTTGAGT -> CGGTAGTTCTGGTTGAGTA
ATATAGGCCCTGTTTAAGA -> TATAGGCCCTGTTTAAGAG
GGAAGAGATAAGATGTTAA -> GAAGAGATAAGATGTTAAT
AGTCATGAAGACCCACGAG -> GTCATGAAGACCCACGAGA
AGCGTCTTACGTTATCCAC -> GCGTCTTACGTTATCCACG
CCAGTAGAAATTTTGGTCG -> CAGTAGAAATTTTGGTCGT
GTTGGTAGACCCTCCGGCC -> TTGGTAGACCCTCCGGCCA
GAGTCTCCCACTTACGCAC -> AGTCTCCCACTTACGCACA
GTTAGAGCAACTGCGTGGA -> TTAGAGCAACTGCGTGGAG
GACATGATCACCCAAGAAA -> ACATGATCACCCAAGAAAA
GGTAGACCCTCCGGCCATT -> GTAGACCCTCCGGCCATTC
CGGAATGGACACACGTGAT -> GGAATGGACACACGTGATT
CAAGCCGATAAAAGTCCTA -> AAGCCGATAAAAGTCCTAC
GATAAGATGTTAATTCCGC -> ATAAGATGTTAATTCCGCG
TCCAGGAGGGCGGCTTACA -> CCAGGAGGGCGGCTTACAG
TCACAACACTACCTAGAAT -> CACAACACTACCTAGAATT
AACAACGGCACAGTCATGA -> ACAACGGCACAGTCATGAA
ACTTATGCCGGCCCGGACA -> CTTATGCCGGCCCGGACAA
AATGAGAACGTTACCGCCA -> ATGAGAACGTTACCGCCAG
GCAATGAGCCTAGTAAGTA -> CAATGAGCCTAGTAAGTAG
GTGGATTTGATAAACGCAT -> TGGATTTGATAAACGCATC
AATGGACACACGTGATTTA -> ATGGACACACGTGATTTAG
CCCCAAGCGCCTTATCCTG -> CCCAAGCGCCTTATCCTGG
CCTCCTTCCGAACAAAATG -> CTCCTTCCGAACAAAATGC
TTATCCACGCTATGCGTCG -> TATCCACGCTATGCGTCGC
GAATTTAGATCGATCTTTT -> AATTTAGATCGATCTTTTT
ATCCACAGTCAATCTTCTG -> TCCACAGTCAATCTTCTGT
GGATGCAACATATATCGTT -> GATGCAACATATATCGTTG
TTGGATCCAACTGCGCCTT -> TGGATCCAACTGCGCCTTT
GTTCTGACGGAATGGACAC -> TTCTGACGGAATGGACACA
GTGGTTATCACTAGGCCAC -> TGGTTATCACTAGGCCACG
TGGTAGACCCTCCGGCCAT -> GGTAGACCCTCCGGCCATT
ATGCCACGTTGGAAGAAAG -> TGCCACGTTGGAAGAAAGA
CATCTCTTAATGATCTTAA -> ATCTCTTAATGATCTTAAT
CGCTATGCGTCGCAGTTAG -> GCTATGCGTCGCAGTTAGA
ACTCGAGTGAGGCGTTTCG -> CTCGAGTGAGGCGTTTCGC
GCACTAATGGACTTCACTT -> CACTAATGGACTTCACTTA
AGTAGTAAGCCCTTGTATG -> GTAGTAAGCCCTTGTATGT
TCCGGTAGAGTACGGCATG -> CCGGTAGAGTACGGCATGG
CTGACAGGATTAGTAGTAA -> TGACAGGATTAGTAGTAAG
ATCTTAATCCACAGTCAAA -> TCTTAATCCACAGTCAAAA
CTTAGTATCTATTCACTAT -> TTAGTATCTATTCACTATC
GGTTTGAGGCATGACAAAT -> GTTTGAGGCATGACAAATT
GCATTATGAACCCTGTTTA -> CATTATGAACCCTGTTTAC
TCGTCAGAATCCGCCGGCG -> CGTCAGAATCCGCCGGCGT
ATAAACGCATCTTAATCCA -> TAAACGCATCTTAATCCAC
TGGCAGACCCTGCACTTAC -> GGCAGACCCTGCACTTACT
GATCCAACTGCGCCTTTGG -> ATCCAACTGCGCCTTTGGA
CTTATGGCTCTAAAGAAAC -> TTATGGCTCTAAAGAAACA
CCCATGGAGACTGATGAAG -> CCATGGAGACTGATGAAGC
AACGTGAGCCCATTAAAAA -> ACGTGAGCCCATTAAAAAC
ATTGGTCTTCTGGTCCTAG -> TTGGTCTTCTGGTCCTAGG
AGGAAGGCGATCGTGTGTA -> GGAAGGCGATCGTGTGTAT
TGTAAACGCATTATGAACC -> GTAAACGCATTATGAACCC
ATGGACTTCACTTAGTATC -> TGGACTTCACTTAGTATCT
ACAGGCGACATGATCACCC -> CAGGCGACATGATCACCCA
GATTTATATCCCATGAAAG -> ATTTATATCCCATGAAAGT
CCCCAGGAAGGCGATCGTG -> CCCAGGAAGGCGATCGTGT
GATATATCGGTCGTTACCC -> ATATATCGGTCGTTACCCC
TGGATAGAATTACAGCCGT -> GGATAGAATTACAGCCGTG
ATAACTCCAATGAGAACGT -> TAACTCCAATGAGAACGTT
ACAGGATTAGTAGTAAGCC -> CAGGATTAGTAGTAAGCCC
TTACGCACATTCGTGCCAC -> TACGCACATTCGTGCCACG
AACTCGGGCACTAGGATTT -> ACTCGGGCACTAGGATTTT
GGGGTCTTAAATACACGCC -> GGGTCTTAAATACACGCCG
GAACAAGTAGCGTCTTACG -> AACAAGTAGCGTCTTACGT
GGTCTTCTGGTCCTAGGAA -> GTCTTCTGGTCCTAGGAAT
CTGCGACCGCTTCCACGAT -> TGCGACCGCTTCCACGATC
ACACGTGCACGACCTTAGG -> CACGTGCACGACCTTAGGG
CCGCTTCCACGATCCCTGG -> CGCTTCCACGATCCCTGGC
TTGCTTTGGGTCGCACATC -> TGCTTTGGGTCGCACATCG
GTCCTGTCCAGTAGAAATT -> TCCTGTCCAGTAGAAATTT
GCAGTTAGAGCAACTGCGT -> CAGTTAGAGCAACTGCGTG
GCTTGATCCTAGCGCCGTC -> CTTGATCCTAGCGCCGTCC
GCGCAAAATCTTAATCCAC -> CGCAAAATCTTAATCCACA
CCGCCAGGGTAGCGAGGAT -> CGCCAGGGTAGCGAGGATA
ATCTTTACTCGATATCAAG -> TCTTTACTCGATATCAAGA
CACACGTGCACGACCTTAG -> ACACGTGCACGACCTTAGG
CGTGAGGGCCCCCTATCCT -> GTGAGGGCCCCCTATCCTG
GGAAGAAAGACCTAGACCA -> GAAGAAAGACCTAGACCAA
CGGGTGCCAGTCCTCGTCA -> GGGTGCCAGTCCTCGTCAG
TAAGATGTTAATTCCGCGT -> AAGATGTTAATTCCGCGTT
ATTCTTCCGGGGTCTTAAA -> TTCTTCCGGGGTCTTAAAT
TCTCCTGGATAAGATTTAT -> CTCCTGGATAAGATTTATA
ACTCGATATCAAGAACTAT -> CTCGATATCAAGAACTATG
TATCCTGAGTCTCCCACTT -> ATCCTGAGTCTCCCACTTA
GATACATTAAATAGGGACT -> ATACATTAAATAGGGACTT
TATAAAGGTCAGTCCTGTC -> ATAAAGGTCAGTCCTGTCC
ATCCCTGGCACTAATGGAC -> TCCCTGGCACTAATGGACT
CCCTGTTTAAGAGGACTCA -> CCTGTTTAAGAGGACTCAC
GTCTCCTGGATAAGATTTA -> TCTCCTGGATAAGATTTAT
TCACTGTGCGAAACAAGGA -> CACTGTGCGAAACAAGGAC
AGCGGAGTTGCATGGGGTT -> GCGGAGTTGCATGGGGTTG
GCCATTTTTGGTTAGGTTC -> CCATTTTTGGTTAGGTTCG
AGTCCGGTAGAGTACGGCA -> GTCCGGTAGAGTACGGCAT
GCTGACAGGATTAGTAGTA -> CTGACAGGATTAGTAGTAA
AAGAAGCCCCCAAGCGCCT -> AGAAGCCCCCAAGCGCCTT
AGCGCCGTCCGACTGGCTG -> GCGCCGTCCGACTGGCTGA
ACCCGACCTACTTATGCCG -> CCCGACCTACTTATGCCGG
TTTGGGTTCGTGTATTCTC -> TTGGGTTCGTGTATTCTCA
GACGCCTCCCGCAGGTCAA -> ACGCCTCCCGCAGGTCAAA
CGCATCTTAATCCACAGTC -> GCATCTTAATCCACAGTCA
ACCTTAGGGCCATTTTTGG -> CCTTAGGGCCATTTTTGGT
GTGCGAAACAAGGACGCCT -> TGCGAAACAAGGACGCCTC
ATGGACACACGTGTTAATA -> TGGACACACGTGTTAATAT
ATGGGGTGCTGATGCCCAT -> TGGGGTGCTGATGCCCATA
TACACAGCTTGATCCTAGC -> ACACAGCTTGATCCTAGCG
CTTGTCTCCTGGATAAGAT -> TTGTCTCCTGGATAAGATT
ACACGTGAGGGCCCCCTAT -> CACGTGAGGGCCCCCTATC
CTCACCACCCATGGAGACT -> TCACCACCCATGGAGACTG
GTCTTCTGGTCCTAGGAAT -> TCTTCTGGTCCTAGGAATA
TGGAGACTGATGAAGCGTT -> GGAGACTGATGAAGCGTTG
AACGGGTCCGGGTGCCAGT -> ACGGGTCCGGGTGCCAGTC
CCTATGAAGAGCTCAGGTG -> CTATGAAGAGCTCAGGTGA
AGTCCTGTCCAGTAGAAAT -> GTCCTGTCCAGTAGAAATT
GAGCTCAGGTGACTACCAG -> AGCTCAGGTGACTACCAGG
CCACCCATGGGTCATTGCC -> CACCCATGGGTCATTGCCC
AAATCGCAACTGCCCTTAC -> AATCGCAACTGCCCTTACA
GTGATTACTAAGTTGAGAG -> TGATTACTAAGTTGAGAGT
TTGTGGGCCGCGGAAGAGA -> TGTGGGCCGCGGAAGAGAT
AGAAAAGTCGGTAGTTCTG -> GAAAAGTCGGTAGTTCTGG
CTGACGGAATGGACACACG -> TGACGGAATGGACACACGT,TGACGGAATGGACACACGT
TACTCGAGTGAGGCGTTTC -> ACTCGAGTGAGGCGTTTCG
AGGTCGGAGTCACTAATGG -> GGTCGGAGTCACTAATGGG
TAGTATGTAGTACCATTAT -> AGTATGTAGTACCATTATG
GATATCAAGAACTATGAGT -> ATATCAAGAACTATGAGTT
ATCACTAGGCCACGCGACC -> TCACTAGGCCACGCGACCA
GCACTAGGATTTTATCGAT -> CACTAGGATTTTATCGATG
GGCGTATTGCTGCGACCGC -> GCGTATTGCTGCGACCGCT
GACTCACCACCCATGGAGA -> ACTCACCACCCATGGAGAC
CGATACTCGGCTTGTCTCC -> GATACTCGGCTTGTCTCCT
GTGGCGTATTGCTGCGACC -> TGGCGTATTGCTGCGACCG
CTAATCTGGATAGAATTAC -> TAATCTGGATAGAATTACA
TACATTAAATAGGGACTTA -> ACATTAAATAGGGACTTAA
GGACACACGTGCACGACCT -> GACACACGTGCACGACCTT
CTTTGGAAATCGCAACTGC -> TTTGGAAATCGCAACTGCC
CGCAACTGCCCTTACAAAT -> GCAACTGCCCTTACAAATA
GAGGTAAACGGGTCCGGGT -> AGGTAAACGGGTCCGGGTG
CAAATTATCCCGAGTGGAG -> AAATTATCCCGAGTGGAGG
ATCCCATGAAAGTGCCAAT -> TCCCATGAAAGTGCCAATC
TGATGCCCATACTCGAGTG -> GATGCCCATACTCGAGTGA
TAGAGCAACTGCGTGGAGG -> AGAGCAACTGCGTGGAGGA
CAATCTTTACTCGATATCA -> AATCTTTACTCGATATCAA
TTGCCCCTAAGTGGCCATG -> TGCCCCTAAGTGGCCATGC
TGAGTTAAGCAGGTCGGAG -> GAGTTAAGCAGGTCGGAGT
GATTAGTAGTAAGCCCTTG -> ATTAGTAGTAAGCCCTTGT
ATCGACTCACAACACTACC -> TCGACTCACAACACTACCT
AGCAGGTCGGAGTCACTAA -> GCAGGTCGGAGTCACTAAT
TCTTAAATACACGCCGCGC -> CTTAAATACACGCCGCGCG
GAAAGTGCCAATCTTTACT -> AAAGTGCCAATCTTTACTC
TCTAAAGAAGCCCCCAAGC -> CTAAAGAAGCCCCCAAGCG
AGAAGCCCCCAAGCGCCTT -> GAAGCCCCCAAGCGCCTTA
TAAAGAAGCCCCCAAGCGC -> AAAGAAGCCCCCAAGCGCC
GAACAAAATGCCAAGTCGA -> AACAAAATGCCAAGTCGAG
TCGAGTATGACTTATGGCT -> CGAGTATGACTTATGGCTC
AGGTCATCCTCTGACGGAA -> GGTCATCCTCTGACGGAAT
CTGTGCGAAACAAGGACGC -> TGTGCGAAACAAGGACGCC
CGTTAGGACAGGCGACATG -> GTTAGGACAGGCGACATGA
TTAAGAGGACTCACCACCC -> TAAGAGGACTCACCACCCA
TTACAGCCGTGTTATAACT -> TACAGCCGTGTTATAACTC
GATTACTAAGTTGAGAGTA -> ATTACTAAGTTGAGAGTAT
TGGACACACGTGATTTAGC -> GGACACACGTGATTTAGCA
ATTCTACTAATCTGGATAG -> TTCTACTAATCTGGATAGA
CCCACTTACGCACATTCGT -> CCACTTACGCACATTCGTG
GACCCTCCGGCCATTCGCG -> ACCCTCCGGCCATTCGCGA
AGGCGGATATGGTTGCGCA -> GGCGGATATGGTTGCGCAA
GGTAAACGGGTCCGGGTGC -> GTAAACGGGTCCGGGTGCC
ATCTTCTGTTCTGACGGAA -> TCTTCTGTTCTGACGGAAT
GGAATGGACACACGTGCAC -> GAATGGACACACGTGCACG
GTCACTAATGGGGTGCTGA -> TCACTAATGGGGTGCTGAT
CAATCTTCTGTTCTGACGG -> AATCTTCTGTTCTGACGGA
TACTTATGCCGGCCCGGAC -> ACTTATGCCGGCCCGGACA
AGTGGCGTATTGCTGCGAC -> GTGGCGTATTGCTGCGACC
AATTACAGCCGTGTTATAA -> ATTACAGCCGTGTTATAAC
CTTAATCCACAGTCAACAT -> TTAATCCACAGTCAACATC
CTTACTCATTGAACGTAGA -> TTACTCATTGAACGTAGAC
GCACGACCTTAGGGCCATT -> CACGACCTTAGGGCCATTT
GTCTGGGTTTGAGGCATGA -> TCTGGGTTTGAGGCATGAC
CTCATTGAACGTAGACGTT -> TCATTGAACGTAGACGTTT
CGTTGGAATAATTCTTCCG -> GTTGGAATAATTCTTCCGG
ACAGAGCGCGTTGCTCAGC -> CAGAGCGCGTTGCTCAGCG
AAAATCTTAATCCACAGTC -> AAATCTTAATCCACAGTCA
GGCGGAACAAGTAGCGTCT -> GCGGAACAAGTAGCGTCTT
GGGTGCCAGTCCTCGTCAG -> GGTGCCAGTCCTCGTCAGA
TTGGTAACTATTCTAAAGA -> TGGTAACTATTCTAAAGAA
GTTTAGACATACGAGCGGA -> TTTAGACATACGAGCGGAG
AGGAATAAAGTTTATGGCT -> GGAATAAAGTTTATGGCTG
TCACTAGGCCACGCGACCA -> CACTAGGCCACGCGACCAC
AATGGACACACGTGTTAAT -> ATGGACACACGTGTTAATA
CTGGCAGACCCTGCACTTA -> TGGCAGACCCTGCACTTAC
GCCGTGTTATAACTCCAAT -> CCGTGTTATAACTCCAATG
CAATCTAGTTGAATTGGTC -> AATCTAGTTGAATTGGTCT
GCGTTAGGACAGGCGACAT -> CGTTAGGACAGGCGACATG
CAGGCGGATATGGTTGCGC -> AGGCGGATATGGTTGCGCA
AATAACATTCTACTAATCT -> ATAACATTCTACTAATCTG
GGAATAAAGTTTATGGCTG -> GAATAAAGTTTATGGCTGG
CGTGTTAATATGAGTTGCT -> GTGTTAATATGAGTTGCTT
CTTAAATACACGCCGCGCG -> TTAAATACACGCCGCGCGT
TCAAAACTATAAGCCGACG -> CAAAACTATAAGCCGACGG
GCTCTAAAGAAACATCCTA -> CTCTAAAGAAACATCCTAG
GATAGAATTACAGCCGTGT -> ATAGAATTACAGCCGTGTT
TTACTCACTGTGCGAAACA -> TACTCACTGTGCGAAACAA
AAGTAGTACAACGTGAGCC -> AGTAGTACAACGTGAGCCC
GTATCTAGAAACCCGACCT -> TATCTAGAAACCCGACCTA
GAGGTGGTTATCACTAGGC -> AGGTGGTTATCACTAGGCC
AGAACTATGAGTTAAGCAG -> GAACTATGAGTTAAGCAGG
CCCTATCCTGAGTCTCCCA -> CCTATCCTGAGTCTCCCAC
AAACTTAGTGGCGTATTGC -> AACTTAGTGGCGTATTGCT
TCTTACGTTATCCACGCTA -> CTTACGTTATCCACGCTAT
ACGCATCTTAATCCACAGT -> CGCATCTTAATCCACAGTC
TTGTCTCCTGGATAAGATT -> TGTCTCCTGGATAAGATTT
TGGCTGAATTTAGATCGAT -> GGCTGAATTTAGATCGATC
GTACAACGTGAGCCCATTA -> TACAACGTGAGCCCATTAA
ATCTTTTTACAAAACTTAG -> TCTTTTTACAAAACTTAGT
CTTACAAATATAGGCCCTG -> TTACAAATATAGGCCCTGT
CCACCCATGGAGACTGATG -> CACCCATGGAGACTGATGA
CCTAGCGCCGTCCGACTGG -> CTAGCGCCGTCCGACTGGC
CTAGGCCACGCGACCACAG -> TAGGCCACGCGACCACAGG
GTCCGGGTGCCAGTCCTCG -> TCCGGGTGCCAGTCCTCGT
ATACGAGCGGAGTTGCATG -> TACGAGCGGAGTTGCATGG
CAAGAACTATGAGTTAAGC -> AAGAACTATGAGTTAAGCA
ACCCATGGGTCATTGCCCC -> CCCATGGGTCATTGCCCCT
ACACTGAAGGTCTGAATTA -> CACTGAAGGTCTGAATTAG
TAAAGTTTATGGCTGGCAG -> AAAGTTTATGGCTGGCAGA
CACTAGGATTTTATCGATG -> ACTAGGATTTTATCGATGC
GGCGATCGTGTGTATTTAG -> GCGATCGTGTGTATTTAGC
ACATCAAAACCCGACGGAA -> CATCAAAACCCGACGGAAT
GAAACCCGACCTACTTATG -> AAACCCGACCTACTTATGC
CAACATATATCGTTGGAAT -> AACATATATCGTTGGAATA
AGAACGTTACCGCCAGGGT -> GAACGTTACCGCCAGGGTA
AATAAAGTTTATGGCTGGC -> ATAAAGTTTATGGCTGGCA
TATGGCTCTAAAGAAACAT -> ATGGCTCTAAAGAAACATC
TCCTTCCGAACAAAATGCC -> CCTTCCGAACAAAATGCCA
ACAGTCATGAAGACCCACG -> CAGTCATGAAGACCCACGA
GAGAACGTTACCGCCAGGG -> AGAACGTTACCGCCAGGGT
TATCGGTCGTTACCCCCTT -> ATCGGTCGTTACCCCCTTC
CGTGGAGGATGCAACATAT -> GTGGAGGATGCAACATATA
TTTGGTTAGGTTCGGCCCC -> TTGGTTAGGTTCGGCCCCC
ATATAAAGGTCAGTCCTGT -> TATAAAGGTCAGTCCTGTC
AAATCTTAATCCACAGTCA -> AATCTTAATCCACAGTCAA
TGAATTGGTCTTCTGGTCC -> GAATTGGTCTTCTGGTCCT
TGACTACCAGGCGGATATG -> GACTACCAGGCGGATATGG
ACTGGCTGAATTTAGATCG -> CTGGCTGAATTTAGATCGA
CGATCGTGTGTATTTAGCC -> GATCGTGTGTATTTAGCCT
AGTATATATAAAGGTCAGT -> GTATATATAAAGGTCAGTC
TCACCACCCATGGAGACTG -> CACCACCCATGGAGACTGA
CCGCGGAAGAGATAAGATG -> CGCGGAAGAGATAAGATGT
GTCGTGATTACTAAGTTGA -> TCGTGATTACTAAGTTGAG
GACCTAGACCAATCTAGTT -> ACCTAGACCAATCTAGTTG
GTAAGTAGTACAACGTGAG -> TAAGTAGTACAACGTGAGC
TAGGGACTTAATTCCGGCC -> AGGGACTTAATTCCGGCCC
AATCTTAATCCACAGTCAA -> ATCTTAATCCACAGTCAAA
TCCGAACAAAATGCCAAGT -> CCGAACAAAATGCCAAGTC
ACCCCCTTCAGGCCACTCC -> CCCCCTTCAGGCCACTCCT
CACACGTGAGGGCCCCCTA -> ACACGTGAGGGCCCCCTAT
GTGTAAACGCATTATGAAC -> TGTAAACGCATTATGAACC
AAGAAACATCCTAGAATAC -> AGAAACATCCTAGAATACT
CACGTGTTAATATGAGTTG -> ACGTGTTAATATGAGTTGC
CCTCCCGCAGGTCAAATAG -> CTCCCGCAGGTCAAATAGC
GGAAGGCGATCGTGTGTAT -> GAAGGCGATCGTGTGTATT
ACTAAGTTGAGAGTATCTA -> CTAAGTTGAGAGTATCTAG
TTTAGACATACGAGCGGAG -> TTAGACATACGAGCGGAGT
ACTGTGCGAAACAAGGACG -> CTGTGCGAAACAAGGACGC
AATTAGTCTTTCTGGGTTT -> ATTAGTCTTTCTGGGTTTG
GTTTGAGGCATGACAAATT -> TTTGAGGCATGACAAATTA
CTCAAGAAGTTTCCTAGAC -> TCAAGAAGTTTCCTAGACA
ATAAGCCGACGGAATGGAC -> TAAGCCGACGGAATGGACA
CGGATATGGTTGCGCAACA -> GGATATGGTTGCGCAACAC
TGGCGTATTGCTGCGACCG -> GGCGTATTGCTGCGACCGC
ATCCGCCGGCGTTAGGACA -> TCCGCCGGCGTTAGGACAG
AGAGGACTCACCACCCATG -> GAGGACTCACCACCCATGG
TCCGGGTGCCAGTCCTCGT -> CCGGGTGCCAGTCCTCGTC
ACGAGGTGGTTATCACTAG -> CGAGGTGGTTATCACTAGG
TAACTATTCTAAAGAAGCC -> AACTATTCTAAAGAAGCCC
TGAGTCTCCCACTTACGCA -> GAGTCTCCCACTTACGCAC
TAGCTCGTTCGAGTATGAC -> AGCTCGTTCGAGTATGACT
ACGAGCGGAGTTGCATGGG -> CGAGCGGAGTTGCATGGGG
CTTGATCCTAGCGCCGTCC -> TTGATCCTAGCGCCGTCCG
CCACGAGAATACCTCGATA -> CACGAGAATACCTCGATAC
CTATGCGTCGCAGTTAGAG -> TATGCGTCGCAGTTAGAGC
GTGAGGGCCCCCTATCCTG -> TGAGGGCCCCCTATCCTGA
AGTCAACATCAAAACCCGA -> GTCAACATCAAAACCCGAC
GCATCTTAATCCACAGTCA -> CATCTTAATCCACAGTCAA
ACGGAATGGACACACGTGA -> CGGAATGGACACACGTGAG,CGGAATGGACACACGTGAT
AGAGCAACTGCGTGGAGGA -> GAGCAACTGCGTGGAGGAT
ACTGCCCTTACAAATATAG -> CTGCCCTTACAAATATAGG
ACGTGAGGGCCCCCTATCC -> CGTGAGGGCCCCCTATCCT
GGCCCGGACAATAACATTC -> GCCCGGACAATAACATTCT
CAGGAGGGCGGCTTACAGA -> AGGAGGGCGGCTTACAGAG
AGAAGTTTCCTAGACAGTG -> GAAGTTTCCTAGACAGTGG
CCTTTGGAAATCGCAACTG -> CTTTGGAAATCGCAACTGC
GCCACGCGACCACAGGCGG -> CCACGCGACCACAGGCGGA
ATTCCGCGTTTTATCAGTC -> TTCCGCGTTTTATCAGTCC
CATGACAAATTATCCCGAG -> ATGACAAATTATCCCGAGT
ATCTTAATCCACAGTCAAC -> TCTTAATCCACAGTCAACA
CGCGACCACAGGCGGAACA -> GCGACCACAGGCGGAACAA
TAGAAACCCGACCTACTTA -> AGAAACCCGACCTACTTAT
GACTTATGGCTCTAAAGAA -> ACTTATGGCTCTAAAGAAA
ATGCCCATACTCGAGTGAG -> TGCCCATACTCGAGTGAGG
CTAGCGCCGTCCGACTGGC -> TAGCGCCGTCCGACTGGCT
GAGCCTAGTAAGTAGTACA -> AGCCTAGTAAGTAGTACAA
AGACCCTCCGGCCATTCGC -> GACCCTCCGGCCATTCGCG
AGTATGACTTATGGCTCTA -> GTATGACTTATGGCTCTAA
CTTCTGTTCTGACGGAATG -> TTCTGTTCTGACGGAATGG
CCACGTTGGAAGAAAGACC -> CACGTTGGAAGAAAGACCT
CGCCTCCCGCAGGTCAAAT -> GCCTCCCGCAGGTCAAATA
ATAGGCCCTGTTTAAGAGG -> TAGGCCCTGTTTAAGAGGA
ATGAACTGAGCGCGCGGCA -> TGAACTGAGCGCGCGGCAC
AAGCCCCCAAGCGCCTTAT -> AGCCCCCAAGCGCCTTATC
GCAGGTCAAATAGCGCAAT -> CAGGTCAAATAGCGCAATG
TCTGGTCCTAGGAATAAAG -> CTGGTCCTAGGAATAAAGT
GAGCGCGCGGCACTACACA -> AGCGCGCGGCACTACACAA
AGTTTCCTAGACAGTGGAT -> GTTTCCTAGACAGTGGATT
CATATATCGTTGGAATAAT -> ATATATCGTTGGAATAATT
AGGTGGTGTCCCTCCTTCC -> GGTGGTGTCCCTCCTTCCG
TCCTAGAATACTCGTCCAG -> CCTAGAATACTCGTCCAGG
ATCTCTTAATGATCTTAAT -> TCTCTTAATGATCTTAATC
CCAGGCGGATATGGTTGCG -> CAGGCGGATATGGTTGCGC
TGGTTGCGCAACACTGAAG -> GGTTGCGCAACACTGAAGG
CCTTCAGGCCACTCCTATT -> CTTCAGGCCACTCCTATTT
GATGAAGCGTTGGTAGACC -> ATGAAGCGTTGGTAGACCC
CGTCCGACTGGCTGAATTT -> GTCCGACTGGCTGAATTTA
TGGTTATCACTAGGCCACG -> GGTTATCACTAGGCCACGC
TCGTGTGTATTTAGCCTCA -> CGTGTGTATTTAGCCTCAA
CTCGTCCAGGAGGGCGGCT -> TCGTCCAGGAGGGCGGCTT
AAGCAGGTCGGAGTCACTA -> AGCAGGTCGGAGTCACTAA
TATGAGTTGCTTTGGGTCG -> ATGAGTTGCTTTGGGTCGC
AGCGCCTTATCCTGGCCCT -> GCGCCTTATCCTGGCCCTC
GTACCTATGAAGAGCTCAG -> TACCTATGAAGAGCTCAGG
CATGGCAAGCCGATAAAAG -> ATGGCAAGCCGATAAAAGT
AGGATATATCGGTCGTTAC -> GGATATATCGGTCGTTACC
GGCATCTCTTAATGATCTT -> GCATCTCTTAATGATCTTA
CTGGGTTTGGATCCAACTG -> TGGGTTTGGATCCAACTGC
CGCTGACAGGATTAGTAGT -> GCTGACAGGATTAGTAGTA
GGCCCCCTATCCTGAGTCT -> GCCCCCTATCCTGAGTCTC
ATATCAAGAACTATGAGTT -> TATCAAGAACTATGAGTTA
ATTAAAAACAACGGCACAG -> TTAAAAACAACGGCACAGT
CACCCATGGGTCATTGCCC -> ACCCATGGGTCATTGCCCC
GCGTGTAAACGCATTATGA -> CGTGTAAACGCATTATGAA
CTTAGTGGCGTATTGCTGC -> TTAGTGGCGTATTGCTGCG
CCACGCGACCACAGGCGGA -> CACGCGACCACAGGCGGAA
CGGAATGGACACACGTGCA -> GGAATGGACACACGTGCAC
GGTCTTAAATACACGCCGC -> GTCTTAAATACACGCCGCG
ATTGCTGCGACCGCTTCCA -> TTGCTGCGACCGCTTCCAC
ACATCGACTCACAACACTA -> CATCGACTCACAACACTAC
GAGCCCATTAAAAACAACG -> AGCCCATTAAAAACAACGG
AATGGGGTGCTGATGCCCA -> ATGGGGTGCTGATGCCCAT
ACACACGTGATTTAGCAGG -> CACACGTGATTTAGCAGGT
CGATGCCACGTTGGAAGAA -> GATGCCACGTTGGAAGAAA
ACATTCGTGCCACGATCGT -> CATTCGTGCCACGATCGTC
AATCTTTACTCGATATCAA -> ATCTTTACTCGATATCAAG
ATATGAGTTGCTTTGGGTC -> TATGAGTTGCTTTGGGTCG
TATCCACGCTATGCGTCGC -> ATCCACGCTATGCGTCGCA
CAGACCCTGCACTTACTCA -> AGACCCTGCACTTACTCAC
ACTTACGCACATTCGTGCC -> CTTACGCACATTCGTGCCA
TGGTGTCCCTCCTTCCGAA -> GGTGTCCCTCCTTCCGAAC
ACATCCTAGAATACTCGTC -> CATCCTAGAATACTCGTCC
GGCCACTCCTATTTACACA -> GCCACTCCTATTTACACAG
ACTAATGGGGTGCTGATGC -> CTAATGGGGTGCTGATGCC
TTACAGAGCGCGTTGCTCA -> TACAGAGCGCGTTGCTCAG
ACCTAGACCAATCTAGTTG -> CCTAGACCAATCTAGTTGA
CCGCAGGTCAAATAGCGCA -> CGCAGGTCAAATAGCGCAA
ACGTGCACGACCTTAGGGC -> CGTGCACGACCTTAGGGCC
AGCGCGCGGCACTACACAA -> GCGCGCGGCACTACACAAT
CACCCATGGAGACTGATGA -> ACCCATGGAGACTGATGAA
CTCCCACTTACGCACATTC -> TCCCACTTACGCACATTCG
TATCAGTCCGGTAGAGTAC -> ATCAGTCCGGTAGAGTACG
CCTGGTCTAGTTTAACCGA -> CTGGTCTAGTTTAACCGAT
TGATTACTAAGTTGAGAGT -> GATTACTAAGTTGAGAGTA
ATCCACAGTCAACATCAAA -> TCCACAGTCAACATCAAAA
AGCGTTGGTAGACCCTCCG -> GCGTTGGTAGACCCTCCGG
TCTCCCACTTACGCACATT -> CTCCCACTTACGCACATTC
TAACTCCAATGAGAACGTT -> AACTCCAATGAGAACGTTA
CTAGACAGTGGATTTGATA -> TAGACAGTGGATTTGATAA
CAACGTGAGCCCATTAAAA -> AACGTGAGCCCATTAAAAA
AAGGTCATCCTCTGACGGA -> AGGTCATCCTCTGACGGAA
GAACCCTGTTTACACAGCT -> AACCCTGTTTACACAGCTT
CTAAGTGGCCATGCCTTAC -> TAAGTGGCCATGCCTTACT
CACACGTGATTTAGCAGGT -> ACACGTGATTTAGCAGGTG
TCTTTTTACAAAACTTAGT -> CTTTTTACAAAACTTAGTG
CCTACTCGATAACTCGGGC -> CTACTCGATAACTCGGGCA
TAATTCCGCGTTTTATCAG -> AATTCCGCGTTTTATCAGT
GTAGACGTTTGTTTAGACA -> TAGACGTTTGTTTAGACAT
TTTGAGGCATGACAAATTA -> TTGAGGCATGACAAATTAT
ATTTTATCGATGCCACGTT -> TTTTATCGATGCCACGTTG
AAAAGTCGGTAGTTCTGGT -> AAAGTCGGTAGTTCTGGTT
TATCACTAGGCCACGCGAC -> ATCACTAGGCCACGCGACC
AGCAACTGCGTGGAGGATG -> GCAACTGCGTGGAGGATGC
AACCCTGTTTACACAGCTT -> ACCCTGTTTACACAGCTTG
GCCCCCAAGCGCCTTATCC -> CCCCCAAGCGCCTTATCCT
TTTACAAAACTTAGTGGCG -> TTACAAAACTTAGTGGCGT
ACGCCGCGCGTGTAAACGC -> CGCCGCGCGTGTAAACGCA
GTTTCCTAGACAGTGGATT -> TTTCCTAGACAGTGGATTT
CATCTTAATCCACAGTCAA -> ATCTTAATCCACAGTCAAC
AGCCCCCAAGCGCCTTATC -> GCCCCCAAGCGCCTTATCC
AACCCGACGGAATGGACAC -> ACCCGACGGAATGGACACA
CAGGTTGTGGGCCGCGGAA -> AGGTTGTGGGCCGCGGAAG
CAGTTAGAGCAACTGCGTG -> AGTTAGAGCAACTGCGTGG
TTACTAAGTTGAGAGTATC -> TACTAAGTTGAGAGTATCT
CGTTACCCCCTTCAGGCCA -> GTTACCCCCTTCAGGCCAC
TGAAGCGTTGGTAGACCCT -> GAAGCGTTGGTAGACCCTC
GGCTTACAGAGCGCGTTGC -> GCTTACAGAGCGCGTTGCT
TCTGTTCTGACGGAATGGA -> CTGTTCTGACGGAATGGAC
CTAAGTTGAGAGTATCTAG -> TAAGTTGAGAGTATCTAGA
TCAAGAAGTTTCCTAGACA -> CAAGAAGTTTCCTAGACAG
CCCGACGGAATGGACACAC -> CCGACGGAATGGACACACG
TCGTTGGAATAATTCTTCC -> CGTTGGAATAATTCTTCCG
GTTTAACCGATGATGAACT -> TTTAACCGATGATGAACTG
GGAGGGCGGCTTACAGAGC -> GAGGGCGGCTTACAGAGCG
AAGTTTATGGCTGGCAGAC -> AGTTTATGGCTGGCAGACC
GCGAGGATATATCGGTCGT -> CGAGGATATATCGGTCGTT
CTTAGGGCCATTTTTGGTT -> TTAGGGCCATTTTTGGTTA
CAGGATTAGTAGTAAGCCC -> AGGATTAGTAGTAAGCCCT
CCACAGTCAAGGTCATCCT -> CACAGTCAAGGTCATCCTC
TCTTAATGATCTTAATCCA -> CTTAATGATCTTAATCCAC
CGAGTATATATAAAGGTCA -> GAGTATATATAAAGGTCAG
GGCATGACAAATTATCCCG -> GCATGACAAATTATCCCGA
GATGCCACGTTGGAAGAAA -> ATGCCACGTTGGAAGAAAG
GTAGACCCTCCGGCCATTC -> TAGACCCTCCGGCCATTCG
CTGGTCTAGTTTAACCGAT -> TGGTCTAGTTTAACCGATG
GGGCGTGCCTAGTATGTAG -> GGCGTGCCTAGTATGTAGT
CGGGTCCGGGTGCCAGTCC -> GGGTCCGGGTGCCAGTCCT
CCGTGTTATAACTCCAATG -> CGTGTTATAACTCCAATGA
TCTTAATCCACAGTCAAAA -> CTTAATCCACAGTCAAAAC
ACATTCTACTAATCTGGAT -> CATTCTACTAATCTGGATA
TATCAAGAACTATGAGTTA -> ATCAAGAACTATGAGTTAA
CATCGACTCACAACACTAC -> ATCGACTCACAACACTACC
AGCCCTTGTATGTATCGTC -> GCCCTTGTATGTATCGTCC
GTTAGGTTCGGCCCCCACC -> TTAGGTTCGGCCCCCACCC
CCGTCCGACTGGCTGAATT -> CGTCCGACTGGCTGAATTT
ACGGGTCCGGGTGCCAGTC -> CGGGTCCGGGTGCCAGTCC
TTAATCCACAGTCAAAACT -> TAATCCACAGTCAAAACTA
CCAAGCGCCTTATCCTGGC -> CAAGCGCCTTATCCTGGCC
TGCTGTAGCTCGTTCGAGT -> GCTGTAGCTCGTTCGAGTA
GTATCGTCCTGGTCGATAC -> TATCGTCCTGGTCGATACA
GTTGCTTTGGGTCGCACAT -> TTGCTTTGGGTCGCACATC
GAGAATACCTCGATACTCG -> AGAATACCTCGATACTCGG
TCAGCGCAAAATCTTAATC -> CAGCGCAAAATCTTAATCC
GGGCCCCCTATCCTGAGTC -> GGCCCCCTATCCTGAGTCT
ACCACAGGCGGAACAAGTA -> CCACAGGCGGAACAAGTAG
TTAATATGAGTTGCTTTGG -> TAATATGAGTTGCTTTGGG
CACTGAAGGTCTGAATTAG -> ACTGAAGGTCTGAATTAGT
CGATCTTTTTACAAAACTT -> GATCTTTTTACAAAACTTA
TGGCCCTCCCCAGGAAGGC -> GGCCCTCCCCAGGAAGGCG
CTTATCCTGGCCCTCCCCA -> TTATCCTGGCCCTCCCCAG
TTAGATCGATCTTTTTACA -> TAGATCGATCTTTTTACAA
CCGGCCCGGACAATAACAT -> CGGCCCGGACAATAACATT
CAACACTGAAGGTCTGAAT -> AACACTGAAGGTCTGAATT
TGCGCCTTTGGAAATCGCA -> GCGCCTTTGGAAATCGCAA
GACACACGTGAGGGCCCCC -> ACACACGTGAGGGCCCCCT
ATTCACTATCTTAATCCAC -> TTCACTATCTTAATCCACA
CGGTCGTTACCCCCTTCAG -> GGTCGTTACCCCCTTCAGG
TGGTCGATACATTAAATAG -> GGTCGATACATTAAATAGG
GTGACTACCAGGCGGATAT -> TGACTACCAGGCGGATATG
CAGTAGAAATTTTGGTCGT -> AGTAGAAATTTTGGTCGTG
AGTCGAGTATATATAAAGG -> GTCGAGTATATATAAAGGT
TTCCGGGGTCTTAAATACA -> TCCGGGGTCTTAAATACAC
GTATCTATTCACTATCTTA -> TATCTATTCACTATCTTAA
TTAATTCCGCGTTTTATCA -> TAATTCCGCGTTTTATCAG
TTTGGAAATCGCAACTGCC -> TTGGAAATCGCAACTGCCC
CAAGGTCATCCTCTGACGG -> AAGGTCATCCTCTGACGGA
ACGTTACCGCCAGGGTAGC -> CGTTACCGCCAGGGTAGCG
CAGTCCTCGTCAGAATCCG -> AGTCCTCGTCAGAATCCGC
ACACGTGTTAATATGAGTT -> CACGTGTTAATATGAGTTG
TCGACTCACAACACTACCT -> CGACTCACAACACTACCTA
TGAATTTAGATCGATCTTT -> GAATTTAGATCGATCTTTT
GAGGATGCAACATATATCG -> AGGATGCAACATATATCGT
CACACGTGTTAATATGAGT -> ACACGTGTTAATATGAGTT
AAGAACTATGAGTTAAGCA -> AGAACTATGAGTTAAGCAG
ATCTGGATAGAATTACAGC -> TCTGGATAGAATTACAGCC
AAGTCGAGTATATATAAAG -> AGTCGAGTATATATAAAGG
GAAGTTTCCTAGACAGTGG -> AAGTTTCCTAGACAGTGGA
AAGTAGCGTCTTACGTTAT -> AGTAGCGTCTTACGTTATC
TCTGGATAGAATTACAGCC -> CTGGATAGAATTACAGCCG
CTAAAGAAACATCCTAGAA -> TAAAGAAACATCCTAGAAT
TGAGTACCTATGAAGAGCT -> GAGTACCTATGAAGAGCTC
AGGCGATCGTGTGTATTTA -> GGCGATCGTGTGTATTTAG
GCCGCGGAAGAGATAAGAT -> CCGCGGAAGAGATAAGATG
GCGCGTTGCTCAGCGCAAA -> CGCGTTGCTCAGCGCAAAA
GTTATCCACGCTATGCGTC -> TTATCCACGCTATGCGTCG
TCGATATCAAGAACTATGA -> CGATATCAAGAACTATGAG
TGGAGGTAAACGGGTCCGG -> GGAGGTAAACGGGTCCGGG
ACAAATATAGGCCCTGTTT -> CAAATATAGGCCCTGTTTA
TGCTGATGCCCATACTCGA -> GCTGATGCCCATACTCGAG
GACAGGCGACATGATCACC -> ACAGGCGACATGATCACCC
TTTTGGGTTCGTGTATTCT -> TTTGGGTTCGTGTATTCTC
CCCATGAAAGTGCCAATCT -> CCATGAAAGTGCCAATCTT
TACCTCGATACTCGGCTTG -> ACCTCGATACTCGGCTTGT
GCTCAGGTGACTACCAGGC -> CTCAGGTGACTACCAGGCG
GCCACGATCGTCTGGGGGC -> CCACGATCGTCTGGGGGCG
GAGTATATATAAAGGTCAG -> AGTATATATAAAGGTCAGT
GTGAGGCGTTTCGCTGACA -> TGAGGCGTTTCGCTGACAG
GGTTCGGCCCCCACCCATG -> GTTCGGCCCCCACCCATGG
GTCGATACATTAAATAGGG -> TCGATACATTAAATAGGGA
TGCCGGCCCGGACAATAAC -> GCCGGCCCGGACAATAACA
GCGCCGTCCGACTGGCTGA -> CGCCGTCCGACTGGCTGAA
TCTCTTAATGATCTTAATC -> CTCTTAATGATCTTAATCC
TATTCTCATAGGCATCTCT -> ATTCTCATAGGCATCTCTT
AAACGCATCTTAATCCACA -> AACGCATCTTAATCCACAG
GGCGGATATGGTTGCGCAA -> GCGGATATGGTTGCGCAAC
AGGCATGACAAATTATCCC -> GGCATGACAAATTATCCCG
CCGGCGTTAGGACAGGCGA -> CGGCGTTAGGACAGGCGAC
CATTAAAAACAACGGCACA -> ATTAAAAACAACGGCACAG
GGTTCGTGTATTCTCATAG -> GTTCGTGTATTCTCATAGG
CGAGCGGAGTTGCATGGGG -> GAGCGGAGTTGCATGGGGT
AGTAGTACAACGTGAGCCC -> GTAGTACAACGTGAGCCCA
ATCCACAGTCAAGGTCATC -> TCCACAGTCAAGGTCATCC
GGTCTGAATTAGTCTTTCT -> GTCTGAATTAGTCTTTCTG
TGGTCTTCTGGTCCTAGGA -> GGTCTTCTGGTCCTAGGAA
CTACACAATCTTTTGGGTT -> TACACAATCTTTTGGGTTC
GGCACTAGGATTTTATCGA -> GCACTAGGATTTTATCGAT
GGTAACTATTCTAAAGAAG -> GTAACTATTCTAAAGAAGC
CGATGATGAACTGAGCGCG -> GATGATGAACTGAGCGCGC
GAATCCGCCGGCGTTAGGA -> AATCCGCCGGCGTTAGGAC
GGCCACGCGACCACAGGCG -> GCCACGCGACCACAGGCGG
GGAATGGACACACGTGATT -> GAATGGACACACGTGATTT
CGCACATCGACTCACAACA -> GCACATCGACTCACAACAC
TTCACTTAGTATCTATTCA -> TCACTTAGTATCTATTCAC
TTGGAAGAAAGACCTAGAC -> TGGAAGAAAGACCTAGACC
ATTTAGCCTCAAGAAGTTT -> TTTAGCCTCAAGAAGTTTC
ACAAAATGCCAAGTCGAGT -> CAAAATGCCAAGTCGAGTA
ATCCACGCTATGCGTCGCA -> TCCACGCTATGCGTCGCAG
TAACATTCTACTAATCTGG -> AACATTCTACTAATCTGGA
TAGAAATTTTGGTCGTGAT -> AGAAATTTTGGTCGTGATT
TCTCATAGGCATCTCTTAA -> CTCATAGGCATCTCTTAAT
CAGTCAAGGTCATCCTCTG -> AGTCAAGGTCATCCTCTGA
CCAGGAGGGCGGCTTACAG -> CAGGAGGGCGGCTTACAGA
ACTAATCTGGATAGAATTA -> CTAATCTGGATAGAATTAC
CGTTTCGCTGACAGGATTA -> GTTTCGCTGACAGGATTAG
ACAGTCAAGGTCATCCTCT -> CAGTCAAGGTCATCCTCTG
GTCTGGGGGCGTGCCTAGT -> TCTGGGGGCGTGCCTAGTA
CCGGTAGAGTACGGCATGG -> CGGTAGAGTACGGCATGGC
TTCCGCGTTTTATCAGTCC -> TCCGCGTTTTATCAGTCCG
ATTATGCTGTAGCTCGTTC -> TTATGCTGTAGCTCGTTCG
GTAACTATTCTAAAGAAGC -> TAACTATTCTAAAGAAGCC
GGTAGTCTGGGTTTGAGGC -> GTAGTCTGGGTTTGAGGCA
TTAGTATCTATTCACTATC -> TAGTATCTATTCACTATCT
CTCGATACTCGGCTTGTCT -> TCGATACTCGGCTTGTCTC
CACTGTGCGAAACAAGGAC -> ACTGTGCGAAACAAGGACG
TTATGCTGTAGCTCGTTCG -> TATGCTGTAGCTCGTTCGA
TGGCTGGCAGACCCTGCAC -> GGCTGGCAGACCCTGCACT
TAAACGGGTCCGGGTGCCA -> AAACGGGTCCGGGTGCCAG
AGTGGAGGTAAACGGGTCC -> GTGGAGGTAAACGGGTCCG
GTCGAGTATATATAAAGGT -> TCGAGTATATATAAAGGTC
CCAACTGCGCCTTTGGAAA -> CAACTGCGCCTTTGGAAAT
CCATGCCTTACTCATTGAA -> CATGCCTTACTCATTGAAC
AAGATGTTAATTCCGCGTT -> AGATGTTAATTCCGCGTTT
GGAATAATTCTTCCGGGGT -> GAATAATTCTTCCGGGGTC
TATCCCATGAAAGTGCCAA -> ATCCCATGAAAGTGCCAAT
AGAATTACAGCCGTGTTAT -> GAATTACAGCCGTGTTATA
GAAGCGTTGGTAGACCCTC -> AAGCGTTGGTAGACCCTCC
AAGCCGATAAAAGTCCTAC -> AGCCGATAAAAGTCCTACT
TAAGCCCTTGTATGTATCG -> AAGCCCTTGTATGTATCGT
GGTAGCGAGGATATATCGG -> GTAGCGAGGATATATCGGT
ACAGGTTGTGGGCCGCGGA -> CAGGTTGTGGGCCGCGGAA
ACCCACGAGAATACCTCGA -> CCCACGAGAATACCTCGAT
TCGTCCTGGTCGATACATT -> CGTCCTGGTCGATACATTA
GCGCGTGTAAACGCATTAT -> CGCGTGTAAACGCATTATG
TGCTTTGGGTCGCACATCG -> GCTTTGGGTCGCACATCGA
ATCGTGTGTATTTAGCCTC -> TCGTGTGTATTTAGCCTCA
ACTCGGCTTGTCTCCTGGA -> CTCGGCTTGTCTCCTGGAT
GATGAACTGAGCGCGCGGC -> ATGAACTGAGCGCGCGGCA
CGGCCCGGACAATAACATT -> GGCCCGGACAATAACATTC
CTCTTAATGATCTTAATCC -> TCTTAATGATCTTAATCCA
TTTTTGGTTAGGTTCGGCC -> TTTTGGTTAGGTTCGGCCC
AAAACTATAAGCCGACGGA -> AAACTATAAGCCGACGGAA
CTTTACTCGATATCAAGAA -> TTTACTCGATATCAAGAAC
GTATGTAGTACCATTATGC -> TATGTAGTACCATTATGCT
CGGAGTCACTAATGGGGTG -> GGAGTCACTAATGGGGTGC
TGTTATAACTCCAATGAGA -> GTTATAACTCCAATGAGAA
ATAAAAGTCCTACTCGATA -> TAAAAGTCCTACTCGATAA
CTGGATAAGATTTATATCC -> TGGATAAGATTTATATCCC
CCATGGAGACTGATGAAGC -> CATGGAGACTGATGAAGCG
ATCCCGAGTGGAGGTAAAC -> TCCCGAGTGGAGGTAAACG
CGATATCAAGAACTATGAG -> GATATCAAGAACTATGAGT
GACCACAGGCGGAACAAGT -> ACCACAGGCGGAACAAGTA
TTGAATTGGTCTTCTGGTC -> TGAATTGGTCTTCTGGTCC
TGGGTTCGTGTATTCTCAT -> GGGTTCGTGTATTCTCATA
CGTGCCTAGTATGTAGTAC -> GTGCCTAGTATGTAGTACC
GTGTTAATATGAGTTGCTT -> TGTTAATATGAGTTGCTTT
TCCTACTCGATAACTCGGG -> CCTACTCGATAACTCGGGC
GATAACTCGGGCACTAGGA -> ATAACTCGGGCACTAGGAT
CGCAGTTAGAGCAACTGCG -> GCAGTTAGAGCAACTGCGT
GTCAAAACTATAAGCCGAC -> TCAAAACTATAAGCCGACG
CGATCCCTGGCACTAATGG -> GATCCCTGGCACTAATGGA
ACACACGTGTTAATATGAG -> CACACGTGTTAATATGAGT
GACCAATCTAGTTGAATTG -> ACCAATCTAGTTGAATTGG
TTATAACTCCAATGAGAAC -> TATAACTCCAATGAGAACG
GTCCGACTGGCTGAATTTA -> TCCGACTGGCTGAATTTAG
TAAAAGTCCTACTCGATAA -> AAAAGTCCTACTCGATAAC
CTCGGGCACTAGGATTTTA -> TCGGGCACTAGGATTTTAT
TATGAAGAGCTCAGGTGAC -> ATGAAGAGCTCAGGTGACT
TAGTCTGGGTTTGAGGCAT -> AGTCTGGGTTTGAGGCATG
TTAATCCACAGTCAAGGTC -> TAATCCACAGTCAAGGTCA
CTTACGTTATCCACGCTAT -> TTACGTTATCCACGCTATG
GAATGGACACACGTGATTT -> AATGGACACACGTGATTTA
GGCCATGCCTTACTCATTG -> GCCATGCCTTACTCATTGA
TTACACAGCTTGATCCTAG -> TACACAGCTTGATCCTAGC
CTGAATTAGTCTTTCTGGG -> TGAATTAGTCTTTCTGGGT
AATAATTCTTCCGGGGTCT -> ATAATTCTTCCGGGGTCTT
ATCCTGAGTCTCCCACTTA -> TCCTGAGTCTCCCACTTAC
GATGATGAACTGAGCGCGC -> ATGATGAACTGAGCGCGCG
ACCCTCCGGCCATTCGCGA -> CCCTCCGGCCATTCGCGAT
AGCAGGTGGTGTCCCTCCT -> GCAGGTGGTGTCCCTCCTT
TTTATATCCCATGAAAGTG -> TTATATCCCATGAAAGTGC
GTTAATTCCGCGTTTTATC -> TTAATTCCGCGTTTTATCA
ATCGTTGGAATAATTCTTC -> TCGTTGGAATAATTCTTCC
GCCAGTCCTCGTCAGAATC -> CCAGTCCTCGTCAGAATCC
CACTCCTATTTACACAGGT -> ACTCCTATTTACACAGGTT
TCACTAATGGGGTGCTGAT -> CACTAATGGGGTGCTGATG
GCCTCCCGCAGGTCAAATA -> CCTCCCGCAGGTCAAATAG
CATGAAGACCCACGAGAAT -> ATGAAGACCCACGAGAATA
TTAATTCCGGCCCTGGTCT -> TAATTCCGGCCCTGGTCTA
TCAAGAACTATGAGTTAAG -> CAAGAACTATGAGTTAAGC
TGGGGGCGTGCCTAGTATG -> GGGGGCGTGCCTAGTATGT
CCCCCAAGCGCCTTATCCT -> CCCCAAGCGCCTTATCCTG
TGGGTCATTGCCCCTAAGT -> GGGTCATTGCCCCTAAGTG
TAATCCACAGTCAACATCA -> AATCCACAGTCAACATCAA
TTCGCTGACAGGATTAGTA -> TCGCTGACAGGATTAGTAG
GTAGCGTCTTACGTTATCC -> TAGCGTCTTACGTTATCCA
GATATGGTTGCGCAACACT -> ATATGGTTGCGCAACACTG
TATTGCTGCGACCGCTTCC -> ATTGCTGCGACCGCTTCCA
AGGCGTTTCGCTGACAGGA -> GGCGTTTCGCTGACAGGAT
GACTTAATTCCGGCCCTGG -> ACTTAATTCCGGCCCTGGT
CAGGTGACTACCAGGCGGA -> AGGTGACTACCAGGCGGAT
ATCGACACCACGAGGTGGT -> TCGACACCACGAGGTGGTT
ACGCTATGCGTCGCAGTTA -> CGCTATGCGTCGCAGTTAG
CACAGTCATGAAGACCCAC -> ACAGTCATGAAGACCCACG
TATCGACACCACGAGGTGG -> ATCGACACCACGAGGTGGT
GATACTCGGCTTGTCTCCT -> ATACTCGGCTTGTCTCCTG
CATGGAGACTGATGAAGCG -> ATGGAGACTGATGAAGCGT
AGAAATTTTGGTCGTGATT -> GAAATTTTGGTCGTGATTA
GGTGTCCCTCCTTCCGAAC -> GTGTCCCTCCTTCCGAACA
GCCCTGGTCTAGTTTAACC -> CCCTGGTCTAGTTTAACCG
TCCAATGAGAACGTTACCG -> CCAATGAGAACGTTACCGC
GTAAGCCCTTGTATGTATC -> TAAGCCCTTGTATGTATCG
GCCCCCACCCATGGGTCAT -> CCCCCACCCATGGGTCATT
AGTACGGCATGGCAAGCCG -> GTACGGCATGGCAAGCCGA
ATAGGCATCTCTTAATGAT -> TAGGCATCTCTTAATGATC
TGGTTAGGTTCGGCCCCCA -> GGTTAGGTTCGGCCCCCAC
TATGCCGGCCCGGACAATA -> ATGCCGGCCCGGACAATAA
GGAGGATGCAACATATATC -> GAGGATGCAACATATATCG
CCCATACTCGAGTGAGGCG -> CCATACTCGAGTGAGGCGT
ACTCCTATTTACACAGGTT -> CTCCTATTTACACAGGTTG
GTGTCCCTCCTTCCGAACA -> TGTCCCTCCTTCCGAACAA
ATATCGGTCGTTACCCCCT -> TATCGGTCGTTACCCCCTT
GGATAAGATTTATATCCCA -> GATAAGATTTATATCCCAT
AACTGAGCGCGCGGCACTA -> ACTGAGCGCGCGGCACTAC
GGTCAGTCCTGTCCAGTAG -> GTCAGTCCTGTCCAGTAGA
GCGTATTGCTGCGACCGCT -> CGTATTGCTGCGACCGCTT
CGACATGATCACCCAAGAA -> GACATGATCACCCAAGAAA
CCGCCGGCGTTAGGACAGG -> CGCCGGCGTTAGGACAGGC
GACACACGTGCACGACCTT -> ACACACGTGCACGACCTTA
CCTAGACCAATCTAGTTGA -> CTAGACCAATCTAGTTGAA
CCCGGACAATAACATTCTA -> CCGGACAATAACATTCTAC
CTATTCTAAAGAAGCCCCC -> TATTCTAAAGAAGCCCCCA
TTATGGCTCTAAAGAAACA -> TATGGCTCTAAAGAAACAT
CGGAAGAGATAAGATGTTA -> GGAAGAGATAAGATGTTAA
AATCTTCTGTTCTGACGGA -> ATCTTCTGTTCTGACGGAA
TCGTTCGAGTATGACTTAT -> CGTTCGAGTATGACTTATG
AACTATGAGTTAAGCAGGT -> ACTATGAGTTAAGCAGGTC
TACTCGTCCAGGAGGGCGG -> ACTCGTCCAGGAGGGCGGC
CCTAGTATGTAGTACCATT -> CTAGTATGTAGTACCATTA
GAGCAACTGCGTGGAGGAT -> AGCAACTGCGTGGAGGATG
CCGGGGTCTTAAATACACG -> CGGGGTCTTAAATACACGC
AGAGCGCGTTGCTCAGCGC -> GAGCGCGTTGCTCAGCGCA
AGTACCATTATGCTGTAGC -> GTACCATTATGCTGTAGCT
AATGCCAAGTCGAGTATAT -> ATGCCAAGTCGAGTATATA
TCGAGTATATATAAAGGTC -> CGAGTATATATAAAGGTCA
GTCTTTCTGGGTTTGGATC -> TCTTTCTGGGTTTGGATCC
TGCCACGTTGGAAGAAAGA -> GCCACGTTGGAAGAAAGAC
AGTCAAAACTATAAGCCGA -> GTCAAAACTATAAGCCGAC
TAGCGAGGATATATCGGTC -> AGCGAGGATATATCGGTCG
CGAGGATATATCGGTCGTT -> GAGGATATATCGGTCGTTA
AGAAACATCCTAGAATACT -> GAAACATCCTAGAATACTC
CTACTTATGCCGGCCCGGA -> TACTTATGCCGGCCCGGAC
ATCGTCTGGGGGCGTGCCT -> TCGTCTGGGGGCGTGCCTA
CTGATGAAGCGTTGGTAGA -> TGATGAAGCGTTGGTAGAC
GACAATAACATTCTACTAA -> ACAATAACATTCTACTAAT
ACTCGGGCACTAGGATTTT -> CTCGGGCACTAGGATTTTA
GGGCCATTTTTGGTTAGGT -> GGCCATTTTTGGTTAGGTT
TATTTAGCCTCAAGAAGTT -> ATTTAGCCTCAAGAAGTTT
TTAGTCTTTCTGGGTTTGG -> TAGTCTTTCTGGGTTTGGA
AGATGTTAATTCCGCGTTT -> GATGTTAATTCCGCGTTTT
CGCTTCCACGATCCCTGGC -> GCTTCCACGATCCCTGGCA
CGTGTATTCTCATAGGCAT -> GTGTATTCTCATAGGCATC
TTACCGCCAGGGTAGCGAG -> TACCGCCAGGGTAGCGAGG
CAACTGCGCCTTTGGAAAT -> AACTGCGCCTTTGGAAATC
GAGTATCTAGAAACCCGAC -> AGTATCTAGAAACCCGACC
TATGGCTGGCAGACCCTGC -> ATGGCTGGCAGACCCTGCA
TTTATGGCTGGCAGACCCT -> TTATGGCTGGCAGACCCTG
ATCGTCCTGGTCGATACAT -> TCGTCCTGGTCGATACATT
CTGAGTCTCCCACTTACGC -> TGAGTCTCCCACTTACGCA
CCTAGAATACTCGTCCAGG -> CTAGAATACTCGTCCAGGA
GACGGAATGGACACACGTG -> ACGGAATGGACACACGTGA,ACGGAATGGACACACGTGC,ACGGAATGGACACACGTGT,ACGGAATGGACACACGTGA
ATAAGATGTTAATTCCGCG -> TAAGATGTTAATTCCGCGT
AAGAAAAGTCGGTAGTTCT -> AGAAAAGTCGGTAGTTCTG
CACTAATGGACTTCACTTA -> ACTAATGGACTTCACTTAG
GGGGTTGGTAACTATTCTA -> GGGTTGGTAACTATTCTAA
AGTCTTTCTGGGTTTGGAT -> GTCTTTCTGGGTTTGGATC
GTTGCGCAACACTGAAGGT -> TTGCGCAACACTGAAGGTC
GGAGTTGCATGGGGTTGGT -> GAGTTGCATGGGGTTGGTA
CGGAATGGACACACGTGAG -> GGAATGGACACACGTGAGG
CTCTGACGGAATGGACACA -> TCTGACGGAATGGACACAC
CAGGCGACATGATCACCCA -> AGGCGACATGATCACCCAA
CGTTTTATCAGTCCGGTAG -> GTTTTATCAGTCCGGTAGA
TCTGAATTAGTCTTTCTGG -> CTGAATTAGTCTTTCTGGG
ATATCGACACCACGAGGTG -> TATCGACACCACGAGGTGG
TCGTCCAGGAGGGCGGCTT -> CGTCCAGGAGGGCGGCTTA
AAGTGCCAATCTTTACTCG -> AGTGCCAATCTTTACTCGA
AACTGCGTGGAGGATGCAA -> ACTGCGTGGAGGATGCAAC
CTCGTCAGAATCCGCCGGC -> TCGTCAGAATCCGCCGGCG
GCGCGGCACTACACAATCT -> CGCGGCACTACACAATCTT
GACAGTGGATTTGATAAAC -> ACAGTGGATTTGATAAACG
TTGTATGTATCGTCCTGGT -> TGTATGTATCGTCCTGGTC
TCCTGGTCGATACATTAAA -> CCTGGTCGATACATTAAAT
ATCCTAGAATACTCGTCCA -> TCCTAGAATACTCGTCCAG
ACCAGGCGGATATGGTTGC -> CCAGGCGGATATGGTTGCG
AAGATTTATATCCCATGAA -> AGATTTATATCCCATGAAA
ACATTAAATAGGGACTTAA -> CATTAAATAGGGACTTAAT
CTGTCCAGTAGAAATTTTG -> TGTCCAGTAGAAATTTTGG
GTCCTCGTCAGAATCCGCC -> TCCTCGTCAGAATCCGCCG
CCGACCTACTTATGCCGGC -> CGACCTACTTATGCCGGCC
ATGTATCGTCCTGGTCGAT -> TGTATCGTCCTGGTCGATA
AGTTGAATTGGTCTTCTGG -> GTTGAATTGGTCTTCTGGT
TGAGGGCCCCCTATCCTGA -> GAGGGCCCCCTATCCTGAG
ACTGCGTGGAGGATGCAAC -> CTGCGTGGAGGATGCAACA
CAGAGCGCGTTGCTCAGCG -> AGAGCGCGTTGCTCAGCGC
CTGAAGGTCTGAATTAGTC -> TGAAGGTCTGAATTAGTCT
GTGCCTAGTATGTAGTACC -> TGCCTAGTATGTAGTACCA
TGAGGCGTTTCGCTGACAG -> GAGGCGTTTCGCTGACAGG
CATGCCTTACTCATTGAAC -> ATGCCTTACTCATTGAACG
CCACAGGCGGAACAAGTAG -> CACAGGCGGAACAAGTAGC
GCCCTTGTATGTATCGTCC -> CCCTTGTATGTATCGTCCT
AAAGAAGCCCCCAAGCGCC -> AAGAAGCCCCCAAGCGCCT
ATTAAATAGGGACTTAATT -> TTAAATAGGGACTTAATTC
CTCAGCGCAAAATCTTAAT -> TCAGCGCAAAATCTTAATC
TATGGTTGCGCAACACTGA -> ATGGTTGCGCAACACTGAA
GGGTAGCGAGGATATATCG -> GGTAGCGAGGATATATCGG
CCCAAGAAAAGTCGGTAGT -> CCAAGAAAAGTCGGTAGTT
TTTCTGGGTTTGGATCCAA -> TTCTGGGTTTGGATCCAAC
TCTGGGTTTGAGGCATGAC -> CTGGGTTTGAGGCATGACA
TCTGGGGGCGTGCCTAGTA -> CTGGGGGCGTGCCTAGTAT
TTGAGAGTATCTAGAAACC -> TGAGAGTATCTAGAAACCC
TGCGACCGCTTCCACGATC -> GCGACCGCTTCCACGATCC
GTCTAGTTTAACCGATGAT -> TCTAGTTTAACCGATGATG
TGAACGTAGACGTTTGTTT -> GAACGTAGACGTTTGTTTA
TGCAACATATATCGTTGGA -> GCAACATATATCGTTGGAA
CAGTCAATCTTCTGTTCTG -> AGTCAATCTTCTGTTCTGA
GTTAAGCAGGTCGGAGTCA -> TTAAGCAGGTCGGAGTCAC
GGGTAGTCTGGGTTTGAGG -> GGTAGTCTGGGTTTGAGGC
ATCAGTCCGGTAGAGTACG -> TCAGTCCGGTAGAGTACGG
AACCGATGATGAACTGAGC -> ACCGATGATGAACTGAGCG
AGCGCAAAATCTTAATCCA -> GCGCAAAATCTTAATCCAC
CAAGCGCCTTATCCTGGCC -> AAGCGCCTTATCCTGGCCC
TACTCACTGTGCGAAACAA -> ACTCACTGTGCGAAACAAG
CGCCGTCCGACTGGCTGAA -> GCCGTCCGACTGGCTGAAT
GCACAGTCATGAAGACCCA -> CACAGTCATGAAGACCCAC
CCTGCACTTACTCACTGTG -> CTGCACTTACTCACTGTGC
CAGGCGGAACAAGTAGCGT -> AGGCGGAACAAGTAGCGTC
AGAATACTCGTCCAGGAGG -> GAATACTCGTCCAGGAGGG
TACAAATATAGGCCCTGTT -> ACAAATATAGGCCCTGTTT
CTCCTTCCGAACAAAATGC -> TCCTTCCGAACAAAATGCC
CTTTTTACAAAACTTAGTG -> TTTTTACAAAACTTAGTGG
GACTACCAGGCGGATATGG -> ACTACCAGGCGGATATGGT
CGCGTTTTATCAGTCCGGT -> GCGTTTTATCAGTCCGGTA
AAGAGGACTCACCACCCAT -> AGAGGACTCACCACCCATG
ACTATCTTAATCCACAGTC -> CTATCTTAATCCACAGTCA
TCACTATCTTAATCCACAG -> CACTATCTTAATCCACAGT
CCGACGGAATGGACACACG -> CGACGGAATGGACACACGT,CGACGGAATGGACACACGT
AGTCAAGGTCATCCTCTGA -> GTCAAGGTCATCCTCTGAC
TCCTGTCCAGTAGAAATTT -> CCTGTCCAGTAGAAATTTT
CCCAAGCGCCTTATCCTGG -> CCAAGCGCCTTATCCTGGC
GGGGTGCTGATGCCCATAC -> GGGTGCTGATGCCCATACT
GGATATGGTTGCGCAACAC -> GATATGGTTGCGCAACACT
TCTGGTTGAGTACCTATGA -> CTGGTTGAGTACCTATGAA
ACGCACATTCGTGCCACGA -> CGCACATTCGTGCCACGAT
CACTAGGCCACGCGACCAC -> ACTAGGCCACGCGACCACA
CTCGAGTGAGGCGTTTCGC -> TCGAGTGAGGCGTTTCGCT
TAGGCCCTGTTTAAGAGGA -> AGGCCCTGTTTAAGAGGAC
CTTTGGGTCGCACATCGAC -> TTTGGGTCGCACATCGACT
TAATGATCTTAATCCACAG -> AATGATCTTAATCCACAGT
ACCACCCATGGAGACTGAT -> CCACCCATGGAGACTGATG
CGCACATTCGTGCCACGAT -> GCACATTCGTGCCACGATC
TCGATCTTTTTACAAAACT -> CGATCTTTTTACAAAACTT
CTATAAGCCGACGGAATGG -> TATAAGCCGACGGAATGGA
TAAACGCATCTTAATCCAC -> AAACGCATCTTAATCCACA
GATAAGATTTATATCCCAT -> ATAAGATTTATATCCCATG
AACTGCGCCTTTGGAAATC -> ACTGCGCCTTTGGAAATCG
CGTGCCACGATCGTCTGGG -> GTGCCACGATCGTCTGGGG
CCGGCCATTCGCGATATCG -> CGGCCATTCGCGATATCGA
TTGGGTCGCACATCGACTC -> TGGGTCGCACATCGACTCA
GCCGTCCGACTGGCTGAAT -> CCGTCCGACTGGCTGAATT
AGTCTCCCACTTACGCACA -> GTCTCCCACTTACGCACAT
TATCTTAATCCACAGTCAA -> ATCTTAATCCACAGTCAAT
GTATGTATCGTCCTGGTCG -> TATGTATCGTCCTGGTCGA
GGATAGAATTACAGCCGTG -> GATAGAATTACAGCCGTGT
GGAATGGACACACGTGTTA -> GAATGGACACACGTGTTAA
AAATAGGGACTTAATTCCG -> AATAGGGACTTAATTCCGG
GATTTTATCGATGCCACGT -> ATTTTATCGATGCCACGTT
TTTACACAGGTTGTGGGCC -> TTACACAGGTTGTGGGCCG
GCGTTGGTAGACCCTCCGG -> CGTTGGTAGACCCTCCGGC
AAAGGTCAGTCCTGTCCAG -> AAGGTCAGTCCTGTCCAGT
TATATCGGTCGTTACCCCC -> ATATCGGTCGTTACCCCCT
AAGGTCAGTCCTGTCCAGT -> AGGTCAGTCCTGTCCAGTA
TGTTAATTCCGCGTTTTAT -> GTTAATTCCGCGTTTTATC
ACAGCTTGATCCTAGCGCC -> CAGCTTGATCCTAGCGCCG
TCTATTCACTATCTTAATC -> CTATTCACTATCTTAATCC
GCACTACACAATCTTTTGG -> CACTACACAATCTTTTGGG
TAAGTTGAGAGTATCTAGA -> AAGTTGAGAGTATCTAGAA
ACATATATCGTTGGAATAA -> CATATATCGTTGGAATAAT
GTTGTGGGCCGCGGAAGAG -> TTGTGGGCCGCGGAAGAGA
AAGTTGAGAGTATCTAGAA -> AGTTGAGAGTATCTAGAAA
GTTATAACTCCAATGAGAA -> TTATAACTCCAATGAGAAC
TTGCTGCGACCGCTTCCAC -> TGCTGCGACCGCTTCCACG
AATTGGTCTTCTGGTCCTA -> ATTGGTCTTCTGGTCCTAG
GCCCCCTATCCTGAGTCTC -> CCCCCTATCCTGAGTCTCC
CAAAACCCGACGGAATGGA -> AAAACCCGACGGAATGGAC
CACTTAGTATCTATTCACT -> ACTTAGTATCTATTCACTA
TTCCGAACAAAATGCCAAG -> TCCGAACAAAATGCCAAGT
GGATCCAACTGCGCCTTTG -> GATCCAACTGCGCCTTTGG
TGCCTTACTCATTGAACGT -> GCCTTACTCATTGAACGTA
CTGGGTTTGAGGCATGACA -> TGGGTTTGAGGCATGACAA
AGTACCTATGAAGAGCTCA -> GTACCTATGAAGAGCTCAG
ATCGATGCCACGTTGGAAG -> TCGATGCCACGTTGGAAGA
TGACAAATTATCCCGAGTG -> GACAAATTATCCCGAGTGG
CTCACAACACTACCTAGAA -> TCACAACACTACCTAGAAT
GTATTCTCATAGGCATCTC -> TATTCTCATAGGCATCTCT
AAAAGTCCTACTCGATAAC -> AAAGTCCTACTCGATAACT
AACACTGAAGGTCTGAATT -> ACACTGAAGGTCTGAATTA
CTCGATAACTCGGGCACTA -> TCGATAACTCGGGCACTAG
ATTAGTAGTAAGCCCTTGT -> TTAGTAGTAAGCCCTTGTA
CCGGACAATAACATTCTAC -> CGGACAATAACATTCTACT
TCATTGAACGTAGACGTTT -> CATTGAACGTAGACGTTTG
AAGTCCTACTCGATAACTC -> AGTCCTACTCGATAACTCG
CAAAATGCCAAGTCGAGTA -> AAAATGCCAAGTCGAGTAT
CCATACTCGAGTGAGGCGT -> CATACTCGAGTGAGGCGTT
ATCGATCTTTTTACAAAAC -> TCGATCTTTTTACAAAACT
TAGGACAGGCGACATGATC -> AGGACAGGCGACATGATCA
GTAGTAAGCCCTTGTATGT -> TAGTAAGCCCTTGTATGTA
ACCCGACGGAATGGACACA -> CCCGACGGAATGGACACAC
CGGAACAAGTAGCGTCTTA -> GGAACAAGTAGCGTCTTAC
TATCCTGGCCCTCCCCAGG -> ATCCTGGCCCTCCCCAGGA
TACCCCCTTCAGGCCACTC -> ACCCCCTTCAGGCCACTCC
TTTACTCGATATCAAGAAC -> TTACTCGATATCAAGAACT
TCTACTAATCTGGATAGAA -> CTACTAATCTGGATAGAAT
ATGATCACCCAAGAAAAGT -> TGATCACCCAAGAAAAGTC
CTACTCGATAACTCGGGCA -> TACTCGATAACTCGGGCAC
TGGCCATGCCTTACTCATT -> GGCCATGCCTTACTCATTG
CGTTACCGCCAGGGTAGCG -> GTTACCGCCAGGGTAGCGA
CGACGGAATGGACACACGT -> GACGGAATGGACACACGTG,GACGGAATGGACACACGTG
GACACACGTGTTAATATGA -> ACACACGTGTTAATATGAG
CACGATCCCTGGCACTAAT -> ACGATCCCTGGCACTAATG
ATTTTGGTCGTGATTACTA -> TTTTGGTCGTGATTACTAA
GCAACACTGAAGGTCTGAA -> CAACACTGAAGGTCTGAAT
AAACCCGACCTACTTATGC -> AACCCGACCTACTTATGCC
AGAGATAAGATGTTAATTC -> GAGATAAGATGTTAATTCC
AATCCACAGTCAATCTTCT -> ATCCACAGTCAATCTTCTG
AGGCGACATGATCACCCAA -> GGCGACATGATCACCCAAG
CATTTTTGGTTAGGTTCGG -> ATTTTTGGTTAGGTTCGGC
CGGGGTCTTAAATACACGC -> GGGGTCTTAAATACACGCC
GGTCGCACATCGACTCACA -> GTCGCACATCGACTCACAA
AGGCCACTCCTATTTACAC -> GGCCACTCCTATTTACACA
TTATCAGTCCGGTAGAGTA -> TATCAGTCCGGTAGAGTAC
ATTTACACAGGTTGTGGGC -> TTTACACAGGTTGTGGGCC
ACACGTGATTTAGCAGGTG -> CACGTGATTTAGCAGGTGG
AGACCAATCTAGTTGAATT -> GACCAATCTAGTTGAATTG
GTGGGCCGCGGAAGAGATA -> TGGGCCGCGGAAGAGATAA
GTTGGTAACTATTCTAAAG -> TTGGTAACTATTCTAAAGA
TCCCACTTACGCACATTCG -> CCCACTTACGCACATTCGT
TTCTCATAGGCATCTCTTA -> TCTCATAGGCATCTCTTAA
TGAGTTGCTTTGGGTCGCA -> GAGTTGCTTTGGGTCGCAC
TGGACTTCACTTAGTATCT -> GGACTTCACTTAGTATCTA
TATATCCCATGAAAGTGCC -> ATATCCCATGAAAGTGCCA
CGTTATCCACGCTATGCGT -> GTTATCCACGCTATGCGTC
ATGGCAAGCCGATAAAAGT -> TGGCAAGCCGATAAAAGTC
TTGCTCAGCGCAAAATCTT -> TGCTCAGCGCAAAATCTTA
GCGCAACACTGAAGGTCTG -> CGCAACACTGAAGGTCTGA
AAGAGATAAGATGTTAATT -> AGAGATAAGATGTTAATTC
TTTTGGTCGTGATTACTAA -> TTTGGTCGTGATTACTAAG
CAGCGCAAAATCTTAATCC -> AGCGCAAAATCTTAATCCA
TCTTTACTCGATATCAAGA -> CTTTACTCGATATCAAGAA
TGAACCCTGTTTACACAGC -> GAACCCTGTTTACACAGCT
GCGAAACAAGGACGCCTCC -> CGAAACAAGGACGCCTCCC
GGTTGAGTACCTATGAAGA -> GTTGAGTACCTATGAAGAG
CCTAGGAATAAAGTTTATG -> CTAGGAATAAAGTTTATGG
TTAATGATCTTAATCCACA -> TAATGATCTTAATCCACAG
ATATGGTTGCGCAACACTG -> TATGGTTGCGCAACACTGA
TAGCGCCGTCCGACTGGCT -> AGCGCCGTCCGACTGGCTG
AGCGAGGATATATCGGTCG -> GCGAGGATATATCGGTCGT
GTCGCACATCGACTCACAA -> TCGCACATCGACTCACAAC
ATTTGATAAACGCATCTTA -> TTTGATAAACGCATCTTAA
TGGCAAGCCGATAAAAGTC -> GGCAAGCCGATAAAAGTCC
TGGAATAATTCTTCCGGGG -> GGAATAATTCTTCCGGGGT
TTAGTGGCGTATTGCTGCG -> TAGTGGCGTATTGCTGCGA
AATCTGGATAGAATTACAG -> ATCTGGATAGAATTACAGC
TTCTACTAATCTGGATAGA -> TCTACTAATCTGGATAGAA
TCCTAGACAGTGGATTTGA -> CCTAGACAGTGGATTTGAT
TGGTCGTGATTACTAAGTT -> GGTCGTGATTACTAAGTTG
ACTTAGTGGCGTATTGCTG -> CTTAGTGGCGTATTGCTGC
GGTAGTTCTGGTTGAGTAC -> GTAGTTCTGGTTGAGTACC
GACCTTAGGGCCATTTTTG -> ACCTTAGGGCCATTTTTGG
TCTAGAAACCCGACCTACT -> CTAGAAACCCGACCTACTT
CTAGTTTAACCGATGATGA -> TAGTTTAACCGATGATGAA
TAGTGGCGTATTGCTGCGA -> AGTGGCGTATTGCTGCGAC
TAGATCGATCTTTTTACAA -> AGATCGATCTTTTTACAAA
AGAGTACGGCATGGCAAGC -> GAGTACGGCATGGCAAGCC
GAGGACTCACCACCCATGG -> AGGACTCACCACCCATGGA
CCCCTAAGTGGCCATGCCT -> CCCTAAGTGGCCATGCCTT
ACGGCACAGTCATGAAGAC -> CGGCACAGTCATGAAGACC
AACGCATCTTAATCCACAG -> ACGCATCTTAATCCACAGT
GTATTTAGCCTCAAGAAGT -> TATTTAGCCTCAAGAAGTT
GCATGGCAAGCCGATAAAA -> CATGGCAAGCCGATAAAAG
TCTTAATCCACAGTCAATC -> CTTAATCCACAGTCAATCT
GCTATGCGTCGCAGTTAGA -> CTATGCGTCGCAGTTAGAG
AGTCAATCTTCTGTTCTGA -> GTCAATCTTCTGTTCTGAC
CGAACAAAATGCCAAGTCG -> GAACAAAATGCCAAGTCGA
ATCTTAATCCACAGTCAAG -> TCTTAATCCACAGTCAAGG
GATCGTCTGGGGGCGTGCC -> ATCGTCTGGGGGCGTGCCT
AGGGTAGCGAGGATATATC -> GGGTAGCGAGGATATATCG
AAACAAGGACGCCTCCCGC -> AACAAGGACGCCTCCCGCA
ACCGCCAGGGTAGCGAGGA -> CCGCCAGGGTAGCGAGGAT
TCATTGCCCCTAAGTGGCC -> CATTGCCCCTAAGTGGCCA
TAATCCACAGTCAAAACTA -> AATCCACAGTCAAAACTAT
TCTGGGTTTGGATCCAACT -> CTGGGTTTGGATCCAACTG
GCATCTCTTAATGATCTTA -> CATCTCTTAATGATCTTAA
TCCGGCCATTCGCGATATC -> CCGGCCATTCGCGATATCG
ACTATTCTAAAGAAGCCCC -> CTATTCTAAAGAAGCCCCC
TTCTGGTTGAGTACCTATG -> TCTGGTTGAGTACCTATGA
GTAAACGCATTATGAACCC -> TAAACGCATTATGAACCCT
TCCCCAGGAAGGCGATCGT -> CCCCAGGAAGGCGATCGTG
TGGCACTAATGGACTTCAC -> GGCACTAATGGACTTCACT
TTAATCCACAGTCAACATC -> TAATCCACAGTCAACATCA
CAAAACTATAAGCCGACGG -> AAAACTATAAGCCGACGGA
TATATCGTTGGAATAATTC -> ATATCGTTGGAATAATTCT
TCGGTCGTTACCCCCTTCA -> CGGTCGTTACCCCCTTCAG
TACCAGGCGGATATGGTTG -> ACCAGGCGGATATGGTTGC
CTACTAATCTGGATAGAAT -> TACTAATCTGGATAGAATT
TTATGGCTGGCAGACCCTG -> TATGGCTGGCAGACCCTGC
GCCCGGACAATAACATTCT -> CCCGGACAATAACATTCTA
GAACTATGAGTTAAGCAGG -> AACTATGAGTTAAGCAGGT
TCCAACTGCGCCTTTGGAA -> CCAACTGCGCCTTTGGAAA
AGTTAGAGCAACTGCGTGG -> GTTAGAGCAACTGCGTGGA
TCGCTGACAGGATTAGTAG -> CGCTGACAGGATTAGTAGT
AGCGCAATGAGCCTAGTAA -> GCGCAATGAGCCTAGTAAG
GGGTTCGTGTATTCTCATA -> GGTTCGTGTATTCTCATAG
TGGATAAGATTTATATCCC -> GGATAAGATTTATATCCCA
ATGCGTCGCAGTTAGAGCA -> TGCGTCGCAGTTAGAGCAA
GCGCAATGAGCCTAGTAAG -> CGCAATGAGCCTAGTAAGT
TATCTATTCACTATCTTAA -> ATCTATTCACTATCTTAAT
GGACGCCTCCCGCAGGTCA -> GACGCCTCCCGCAGGTCAA
TGAGAACGTTACCGCCAGG -> GAGAACGTTACCGCCAGGG
TCAACATCAAAACCCGACG -> CAACATCAAAACCCGACGG
GATGCCCATACTCGAGTGA -> ATGCCCATACTCGAGTGAG
GCCTCAAGAAGTTTCCTAG -> CCTCAAGAAGTTTCCTAGA
AACGTAGACGTTTGTTTAG -> ACGTAGACGTTTGTTTAGA
GGTCCGGGTGCCAGTCCTC -> GTCCGGGTGCCAGTCCTCG
GATTTAGCAGGTGGTGTCC -> ATTTAGCAGGTGGTGTCCC
CTTCTGGTCCTAGGAATAA -> TTCTGGTCCTAGGAATAAA
ACCCATGGAGACTGATGAA -> CCCATGGAGACTGATGAAG
GCGCCTTATCCTGGCCCTC -> CGCCTTATCCTGGCCCTCC
AGACCCACGAGAATACCTC -> GACCCACGAGAATACCTCG
GGAATGGACACACGTGAGG -> GAATGGACACACGTGAGGG
AATTCCGCGTTTTATCAGT -> ATTCCGCGTTTTATCAGTC
TTATGCCGGCCCGGACAAT -> TATGCCGGCCCGGACAATA
GCGACATGATCACCCAAGA -> CGACATGATCACCCAAGAA
TGCCCTTACAAATATAGGC -> GCCCTTACAAATATAGGCC
GTCAATCTTCTGTTCTGAC -> TCAATCTTCTGTTCTGACG
CAGTCAAAACTATAAGCCG -> AGTCAAAACTATAAGCCGA
ATGCCTTACTCATTGAACG -> TGCCTTACTCATTGAACGT
GGAAATCGCAACTGCCCTT -> GAAATCGCAACTGCCCTTA
AGTTCTGGTTGAGTACCTA -> GTTCTGGTTGAGTACCTAT
TACACAGGTTGTGGGCCGC -> ACACAGGTTGTGGGCCGCG
GAGGATATATCGGTCGTTA -> AGGATATATCGGTCGTTAC
CATAGGCATCTCTTAATGA -> ATAGGCATCTCTTAATGAT
GCTGGCAGACCCTGCACTT -> CTGGCAGACCCTGCACTTA
GTCAACATCAAAACCCGAC -> TCAACATCAAAACCCGACG
AAAACCCGACGGAATGGAC -> AAACCCGACGGAATGGACA
GTTTACACAGCTTGATCCT -> TTTACACAGCTTGATCCTA
AACCCGACCTACTTATGCC -> ACCCGACCTACTTATGCCG
CACAATCTTTTGGGTTCGT -> ACAATCTTTTGGGTTCGTG
CCTCTGACGGAATGGACAC -> CTCTGACGGAATGGACACA
GTTAGGACAGGCGACATGA -> TTAGGACAGGCGACATGAT
GAGGCATGACAAATTATCC -> AGGCATGACAAATTATCCC
TTTAACCGATGATGAACTG -> TTAACCGATGATGAACTGA
CTCTAAAGAAACATCCTAG -> TCTAAAGAAACATCCTAGA
CGTGTAAACGCATTATGAA -> GTGTAAACGCATTATGAAC
GCGTCTTACGTTATCCACG -> CGTCTTACGTTATCCACGC
AAAACTTAGTGGCGTATTG -> AAACTTAGTGGCGTATTGC
ACTGAGCGCGCGGCACTAC -> CTGAGCGCGCGGCACTACA
GCCGCGCGTGTAAACGCAT -> CCGCGCGTGTAAACGCATT
AAAAACAACGGCACAGTCA -> AAAACAACGGCACAGTCAT
TTTGATAAACGCATCTTAA -> TTGATAAACGCATCTTAAT
TTCGCGATATCGACACCAC -> TCGCGATATCGACACCACG
TCGCAACTGCCCTTACAAA -> CGCAACTGCCCTTACAAAT
AGGTCTGAATTAGTCTTTC -> GGTCTGAATTAGTCTTTCT
ACTCACAACACTACCTAGA -> CTCACAACACTACCTAGAA
GTTACCCCCTTCAGGCCAC -> TTACCCCCTTCAGGCCACT
CTGGCTGAATTTAGATCGA -> TGGCTGAATTTAGATCGAT
CTAGGAATAAAGTTTATGG -> TAGGAATAAAGTTTATGGC
ACAGTGGATTTGATAAACG -> CAGTGGATTTGATAAACGC
TGCCAATCTTTACTCGATA -> GCCAATCTTTACTCGATAT
AATAGCGCAATGAGCCTAG -> ATAGCGCAATGAGCCTAGT
GGTTGTGGGCCGCGGAAGA -> GTTGTGGGCCGCGGAAGAG
CGTCTGGGGGCGTGCCTAG -> GTCTGGGGGCGTGCCTAGT
ATGGGTCATTGCCCCTAAG -> TGGGTCATTGCCCCTAAGT
AGTCACTAATGGGGTGCTG -> GTCACTAATGGGGTGCTGA
GCGCCTTTGGAAATCGCAA -> CGCCTTTGGAAATCGCAAC
GACACACGTGATTTAGCAG -> ACACACGTGATTTAGCAGG
CTTACAGAGCGCGTTGCTC -> TTACAGAGCGCGTTGCTCA
CCGGGTGCCAGTCCTCGTC -> CGGGTGCCAGTCCTCGTCA
CTGCGTGGAGGATGCAACA -> TGCGTGGAGGATGCAACAT
AACGGCACAGTCATGAAGA -> ACGGCACAGTCATGAAGAC
GCCGATAAAAGTCCTACTC -> CCGATAAAAGTCCTACTCG
GCGGAGTTGCATGGGGTTG -> CGGAGTTGCATGGGGTTGG
CAAGGACGCCTCCCGCAGG -> AAGGACGCCTCCCGCAGGT
GGCAAGCCGATAAAAGTCC -> GCAAGCCGATAAAAGTCCT
TACGGCATGGCAAGCCGAT -> ACGGCATGGCAAGCCGATA
TATGTAGTACCATTATGCT -> ATGTAGTACCATTATGCTG
GGTCGTGATTACTAAGTTG -> GTCGTGATTACTAAGTTGA
GCAACTGCGTGGAGGATGC -> CAACTGCGTGGAGGATGCA
GTTGGAATAATTCTTCCGG -> TTGGAATAATTCTTCCGGG
AGGGACTTAATTCCGGCCC -> GGGACTTAATTCCGGCCCT
ATGAGCCTAGTAAGTAGTA -> TGAGCCTAGTAAGTAGTAC
TCAAGGTCATCCTCTGACG -> CAAGGTCATCCTCTGACGG
TCTTCTGTTCTGACGGAAT -> CTTCTGTTCTGACGGAATG
ATATATCGGTCGTTACCCC -> TATATCGGTCGTTACCCCC
AGCGCGTTGCTCAGCGCAA -> GCGCGTTGCTCAGCGCAAA
ACTCACCACCCATGGAGAC -> CTCACCACCCATGGAGACT
TGTATCGTCCTGGTCGATA -> GTATCGTCCTGGTCGATAC
TTAGGACAGGCGACATGAT -> TAGGACAGGCGACATGATC
TGTTTACACAGCTTGATCC -> GTTTACACAGCTTGATCCT
TCCTCGTCAGAATCCGCCG -> CCTCGTCAGAATCCGCCGG
TTCCTAGACAGTGGATTTG -> TCCTAGACAGTGGATTTGA
CGAGTGAGGCGTTTCGCTG -> GAGTGAGGCGTTTCGCTGA
AAGAGCTCAGGTGACTACC -> AGAGCTCAGGTGACTACCA
TAGCGTCTTACGTTATCCA -> AGCGTCTTACGTTATCCAC
CTTCACTTAGTATCTATTC -> TTCACTTAGTATCTATTCA
CAAGTCGAGTATATATAAA -> AAGTCGAGTATATATAAAG
CCGATAAAAGTCCTACTCG -> CGATAAAAGTCCTACTCGA
TATGCGTCGCAGTTAGAGC -> ATGCGTCGCAGTTAGAGCA
AGACGTTTGTTTAGACATA -> GACGTTTGTTTAGACATAC
GATCCTAGCGCCGTCCGAC -> ATCCTAGCGCCGTCCGACT
TCAGTCCTGTCCAGTAGAA -> CAGTCCTGTCCAGTAGAAA
CAGTCAACATCAAAACCCG -> AGTCAACATCAAAACCCGA
TCCGGCCCTGGTCTAGTTT -> CCGGCCCTGGTCTAGTTTA
CCATTCGCGATATCGACAC -> CATTCGCGATATCGACACC
AGTATGTAGTACCATTATG -> GTATGTAGTACCATTATGC
CAAAATCTTAATCCACAGT -> AAAATCTTAATCCACAGTC
TTTTATCGATGCCACGTTG -> TTTATCGATGCCACGTTGG
ACCTATGAAGAGCTCAGGT -> CCTATGAAGAGCTCAGGTG
GTGGTGTCCCTCCTTCCGA -> TGGTGTCCCTCCTTCCGAA
ACGACCTTAGGGCCATTTT -> CGACCTTAGGGCCATTTTT
TCGATACTCGGCTTGTCTC -> CGATACTCGGCTTGTCTCC
TCTTTTGGGTTCGTGTATT -> CTTTTGGGTTCGTGTATTC
CAATGAGCCTAGTAAGTAG -> AATGAGCCTAGTAAGTAGT
GCGTCGCAGTTAGAGCAAC -> CGTCGCAGTTAGAGCAACT
TGTATGTATCGTCCTGGTC -> GTATGTATCGTCCTGGTCG
CTTCCGGGGTCTTAAATAC -> TTCCGGGGTCTTAAATACA
AACAAAATGCCAAGTCGAG -> ACAAAATGCCAAGTCGAGT
CCCACCCATGGGTCATTGC -> CCACCCATGGGTCATTGCC
CTCCTGGATAAGATTTATA -> TCCTGGATAAGATTTATAT
TTTTACAAAACTTAGTGGC -> TTTACAAAACTTAGTGGCG
ATCCTGGCCCTCCCCAGGA -> TCCTGGCCCTCCCCAGGAA
CCCTCCTTCCGAACAAAAT -> CCTCCTTCCGAACAAAATG
CCCCTATCCTGAGTCTCCC -> CCCTATCCTGAGTCTCCCA
CCCTGGTCTAGTTTAACCG -> CCTGGTCTAGTTTAACCGA
CGCGTGTAAACGCATTATG -> GCGTGTAAACGCATTATGA
AAGGACGCCTCCCGCAGGT -> AGGACGCCTCCCGCAGGTC
GTAGAAATTTTGGTCGTGA -> TAGAAATTTTGGTCGTGAT
CACTTACTCACTGTGCGAA -> ACTTACTCACTGTGCGAAA
AGCTCGTTCGAGTATGACT -> GCTCGTTCGAGTATGACTT
CCAATCTAGTTGAATTGGT -> CAATCTAGTTGAATTGGTC
TTGCGCAACACTGAAGGTC -> TGCGCAACACTGAAGGTCT
CATCCTAGAATACTCGTCC -> ATCCTAGAATACTCGTCCA
GCCCTGTTTAAGAGGACTC -> CCCTGTTTAAGAGGACTCA
AAATTTTGGTCGTGATTAC -> AATTTTGGTCGTGATTACT
CGCCAGGGTAGCGAGGATA -> GCCAGGGTAGCGAGGATAT
TCACCCAAGAAAAGTCGGT -> CACCCAAGAAAAGTCGGTA
CTGGCCCTCCCCAGGAAGG -> TGGCCCTCCCCAGGAAGGC
GATCACCCAAGAAAAGTCG -> ATCACCCAAGAAAAGTCGG
GGTGCTGATGCCCATACTC -> GTGCTGATGCCCATACTCG
TTCTGACGGAATGGACACA -> TCTGACGGAATGGACACAC
ACGATCCCTGGCACTAATG -> CGATCCCTGGCACTAATGG
CGTGTGTATTTAGCCTCAA -> GTGTGTATTTAGCCTCAAG
TTATCGATGCCACGTTGGA -> TATCGATGCCACGTTGGAA
CGACTGGCTGAATTTAGAT -> GACTGGCTGAATTTAGATC
TATATATAAAGGTCAGTCC -> ATATATAAAGGTCAGTCCT
CATACTCGAGTGAGGCGTT -> ATACTCGAGTGAGGCGTTT
AATCCACAGTCAACATCAA -> ATCCACAGTCAACATCAAA
CCAGTCCTCGTCAGAATCC -> CAGTCCTCGTCAGAATCCG
TAATCTGGATAGAATTACA -> AATCTGGATAGAATTACAG
ACTACACAATCTTTTGGGT -> CTACACAATCTTTTGGGTT
CCCCACCCATGGGTCATTG -> CCCACCCATGGGTCATTGC
GATCGATCTTTTTACAAAA -> ATCGATCTTTTTACAAAAC
CAGTCATGAAGACCCACGA -> AGTCATGAAGACCCACGAG
ATACACGCCGCGCGTGTAA -> TACACGCCGCGCGTGTAAA
TACAAAACTTAGTGGCGTA -> ACAAAACTTAGTGGCGTAT
TAGAATTACAGCCGTGTTA -> AGAATTACAGCCGTGTTAT
ACTCGTCCAGGAGGGCGGC -> CTCGTCCAGGAGGGCGGCT
ACGCATTATGAACCCTGTT -> CGCATTATGAACCCTGTTT
GTCAAGGTCATCCTCTGAC -> TCAAGGTCATCCTCTGACG
GCCTTACTCATTGAACGTA -> CCTTACTCATTGAACGTAG
TGGAGGATGCAACATATAT -> GGAGGATGCAACATATATC
ACGTTTGTTTAGACATACG -> CGTTTGTTTAGACATACGA
CCCAGGAAGGCGATCGTGT -> CCAGGAAGGCGATCGTGTG
GTTTTATCAGTCCGGTAGA -> TTTTATCAGTCCGGTAGAG
TATCGTTGGAATAATTCTT -> ATCGTTGGAATAATTCTTC
GGGCACTAGGATTTTATCG -> GGCACTAGGATTTTATCGA
TAGTATCTATTCACTATCT -> AGTATCTATTCACTATCTT
CCCCCACCCATGGGTCATT -> CCCCACCCATGGGTCATTG
CACTAATGGGGTGCTGATG -> ACTAATGGGGTGCTGATGC
TATAAGCCGACGGAATGGA -> ATAAGCCGACGGAATGGAC
GTAGTACCATTATGCTGTA -> TAGTACCATTATGCTGTAG
CCAGGGTAGCGAGGATATA -> CAGGGTAGCGAGGATATAT
TGGACACACGTGCACGACC -> GGACACACGTGCACGACCT
GGTTTGGATCCAACTGCGC -> GTTTGGATCCAACTGCGCC
CTATCCTGAGTCTCCCACT -> TATCCTGAGTCTCCCACTT
GACTTCACTTAGTATCTAT -> ACTTCACTTAGTATCTATT
CTCCAATGAGAACGTTACC -> TCCAATGAGAACGTTACCG
TTAAGCAGGTCGGAGTCAC -> TAAGCAGGTCGGAGTCACT
ACAAAACTTAGTGGCGTAT -> CAAAACTTAGTGGCGTATT
GTCCAGGAGGGCGGCTTAC -> TCCAGGAGGGCGGCTTACA
TTGGAAATCGCAACTGCCC -> TGGAAATCGCAACTGCCCT
TCGTGTATTCTCATAGGCA -> CGTGTATTCTCATAGGCAT
GTAGTACAACGTGAGCCCA -> TAGTACAACGTGAGCCCAT
TCGACACCACGAGGTGGTT -> CGACACCACGAGGTGGTTA
CGCGGAAGAGATAAGATGT -> GCGGAAGAGATAAGATGTT
TTTGTTTAGACATACGAGC -> TTGTTTAGACATACGAGCG
ATAGCGCAATGAGCCTAGT -> TAGCGCAATGAGCCTAGTA
TTCGTGTATTCTCATAGGC -> TCGTGTATTCTCATAGGCA
CCCTGGCACTAATGGACTT -> CCTGGCACTAATGGACTTC
ATTTAGATCGATCTTTTTA -> TTTAGATCGATCTTTTTAC
GAATAAAGTTTATGGCTGG -> AATAAAGTTTATGGCTGGC
ACTACCAGGCGGATATGGT -> CTACCAGGCGGATATGGTT
GTTGAGTACCTATGAAGAG -> TTGAGTACCTATGAAGAGC
ATCACCCAAGAAAAGTCGG -> TCACCCAAGAAAAGTCGGT
ATCCTAGCGCCGTCCGACT -> TCCTAGCGCCGTCCGACTG
GACAAATTATCCCGAGTGG -> ACAAATTATCCCGAGTGGA
AATATAGGCCCTGTTTAAG -> ATATAGGCCCTGTTTAAGA
AAGCCGACGGAATGGACAC -> AGCCGACGGAATGGACACA
AACATATATCGTTGGAATA -> ACATATATCGTTGGAATAA
CCTGTTTACACAGCTTGAT -> CTGTTTACACAGCTTGATC
ATTGAACGTAGACGTTTGT -> TTGAACGTAGACGTTTGTT
ACACACGTGAGGGCCCCCT -> CACACGTGAGGGCCCCCTA
TTCACTATCTTAATCCACA -> TCACTATCTTAATCCACAG
CCAAGTCGAGTATATATAA -> CAAGTCGAGTATATATAAA
AGCCGATAAAAGTCCTACT -> GCCGATAAAAGTCCTACTC
TGAGGCATGACAAATTATC -> GAGGCATGACAAATTATCC
CCACGATCCCTGGCACTAA -> CACGATCCCTGGCACTAAT
CACGCTATGCGTCGCAGTT -> ACGCTATGCGTCGCAGTTA
CATGAAAGTGCCAATCTTT -> ATGAAAGTGCCAATCTTTA
GTTCGAGTATGACTTATGG -> TTCGAGTATGACTTATGGC
ACGATCGTCTGGGGGCGTG -> CGATCGTCTGGGGGCGTGC
AATCTAGTTGAATTGGTCT -> ATCTAGTTGAATTGGTCTT
CTGGTCCTAGGAATAAAGT -> TGGTCCTAGGAATAAAGTT
GAGCGCGTTGCTCAGCGCA -> AGCGCGTTGCTCAGCGCAA
GAATTACAGCCGTGTTATA -> AATTACAGCCGTGTTATAA
AATCCGCCGGCGTTAGGAC -> ATCCGCCGGCGTTAGGACA
GTAGTTCTGGTTGAGTACC -> TAGTTCTGGTTGAGTACCT
AATGGACACACGTGAGGGC -> ATGGACACACGTGAGGGCC
TCTAGTTGAATTGGTCTTC -> CTAGTTGAATTGGTCTTCT
GTGTATTTAGCCTCAAGAA -> TGTATTTAGCCTCAAGAAG
GTGCACGACCTTAGGGCCA -> TGCACGACCTTAGGGCCAT
CTAATGGACTTCACTTAGT -> TAATGGACTTCACTTAGTA
CCACGCTATGCGTCGCAGT -> CACGCTATGCGTCGCAGTT
AAATGCCAAGTCGAGTATA -> AATGCCAAGTCGAGTATAT
TTCCACGATCCCTGGCACT -> TCCACGATCCCTGGCACTA
ATCGGTCGTTACCCCCTTC -> TCGGTCGTTACCCCCTTCA
CTATGAAGAGCTCAGGTGA -> TATGAAGAGCTCAGGTGAC
GGGCCGCGGAAGAGATAAG -> GGCCGCGGAAGAGATAAGA
TTTCGCTGACAGGATTAGT -> TTCGCTGACAGGATTAGTA
ACGGCATGGCAAGCCGATA -> CGGCATGGCAAGCCGATAA
AAATTATCCCGAGTGGAGG -> AATTATCCCGAGTGGAGGT
GATCTTAATCCACAGTCAA -> ATCTTAATCCACAGTCAAG
TCATGAAGACCCACGAGAA -> CATGAAGACCCACGAGAAT
TGGAAGAAAGACCTAGACC -> GGAAGAAAGACCTAGACCA
CGACCTTAGGGCCATTTTT -> GACCTTAGGGCCATTTTTG
TGCACTTACTCACTGTGCG -> GCACTTACTCACTGTGCGA
CTTAATCCACAGTCAATCT -> TTAATCCACAGTCAATCTT
GCGATATCGACACCACGAG -> CGATATCGACACCACGAGG
GATCCCTGGCACTAATGGA -> ATCCCTGGCACTAATGGAC
GTACGGCATGGCAAGCCGA -> TACGGCATGGCAAGCCGAT
CTTCCACGATCCCTGGCAC -> TTCCACGATCCCTGGCACT
TGAGCCCATTAAAAACAAC -> GAGCCCATTAAAAACAACG
GACTGATGAAGCGTTGGTA -> ACTGATGAAGCGTTGGTAG
ACTCCAATGAGAACGTTAC -> CTCCAATGAGAACGTTACC
GTTGAATTGGTCTTCTGGT -> TTGAATTGGTCTTCTGGTC
GAGTCACTAATGGGGTGCT -> AGTCACTAATGGGGTGCTG
CGGAATGGACACACGTGTT -> GGAATGGACACACGTGTTA
TCATAGGCATCTCTTAATG -> CATAGGCATCTCTTAATGA
TCTTAATCCACAGTCAACA -> CTTAATCCACAGTCAACAT
CCTCCGGCCATTCGCGATA -> CTCCGGCCATTCGCGATAT
AAGAAAGACCTAGACCAAT -> AGAAAGACCTAGACCAATC
TACCGCCAGGGTAGCGAGG -> ACCGCCAGGGTAGCGAGGA
TTAGTAGTAAGCCCTTGTA -> TAGTAGTAAGCCCTTGTAT
AACAAGGACGCCTCCCGCA -> ACAAGGACGCCTCCCGCAG
AATTATCCCGAGTGGAGGT -> ATTATCCCGAGTGGAGGTA
CACGCCGCGCGTGTAAACG -> ACGCCGCGCGTGTAAACGC
CTATCTTAATCCACAGTCA -> TATCTTAATCCACAGTCAA
GTCAGAATCCGCCGGCGTT -> TCAGAATCCGCCGGCGTTA
GACTGGCTGAATTTAGATC -> ACTGGCTGAATTTAGATCG
TGTAGTACCATTATGCTGT -> GTAGTACCATTATGCTGTA
TTATCCCGAGTGGAGGTAA -> TATCCCGAGTGGAGGTAAA
GGTTAGGTTCGGCCCCCAC -> GTTAGGTTCGGCCCCCACC
CATTAAATAGGGACTTAAT -> ATTAAATAGGGACTTAATT
ATAATTCTTCCGGGGTCTT -> TAATTCTTCCGGGGTCTTA
ATTCCGGCCCTGGTCTAGT -> TTCCGGCCCTGGTCTAGTT
TGCCACGATCGTCTGGGGG -> GCCACGATCGTCTGGGGGC
TAATGGACTTCACTTAGTA -> AATGGACTTCACTTAGTAT
GGTCGTTACCCCCTTCAGG -> GTCGTTACCCCCTTCAGGC
AGGATTTTATCGATGCCAC -> GGATTTTATCGATGCCACG
TCCACAGTCAATCTTCTGT -> CCACAGTCAATCTTCTGTT
CATTGCCCCTAAGTGGCCA -> ATTGCCCCTAAGTGGCCAT
GTTTGTTTAGACATACGAG -> TTTGTTTAGACATACGAGC
ACGTGTTAATATGAGTTGC -> CGTGTTAATATGAGTTGCT
AATACCTCGATACTCGGCT -> ATACCTCGATACTCGGCTT
ACTGATGAAGCGTTGGTAG -> CTGATGAAGCGTTGGTAGA
GGTGCCAGTCCTCGTCAGA -> GTGCCAGTCCTCGTCAGAA
GGTTATCACTAGGCCACGC -> GTTATCACTAGGCCACGCG
CGTATTGCTGCGACCGCTT -> GTATTGCTGCGACCGCTTC
TTAAATACACGCCGCGCGT -> TAAATACACGCCGCGCGTG
TCGGCCCCCACCCATGGGT -> CGGCCCCCACCCATGGGTC
TGGGCCGCGGAAGAGATAA -> GGGCCGCGGAAGAGATAAG
GACCCACGAGAATACCTCG -> ACCCACGAGAATACCTCGA
AGTAGCGTCTTACGTTATC -> GTAGCGTCTTACGTTATCC
CGGCTTACAGAGCGCGTTG -> GGCTTACAGAGCGCGTTGC
CCTAGACAGTGGATTTGAT -> CTAGACAGTGGATTTGATA
CGGCATGGCAAGCCGATAA -> GGCATGGCAAGCCGATAAA
GTCTGAATTAGTCTTTCTG -> TCTGAATTAGTCTTTCTGG
TCCTATTTACACAGGTTGT -> CCTATTTACACAGGTTGTG
GTTACCGCCAGGGTAGCGA -> TTACCGCCAGGGTAGCGAG
CTAGTAAGTAGTACAACGT -> TAGTAAGTAGTACAACGTG
CGGCACTACACAATCTTTT -> GGCACTACACAATCTTTTG
ACAGGCGGAACAAGTAGCG -> CAGGCGGAACAAGTAGCGT
GCCTTTGGAAATCGCAACT -> CCTTTGGAAATCGCAACTG
CCTACTTATGCCGGCCCGG -> CTACTTATGCCGGCCCGGA
CTTAATCCACAGTCAAGGT -> TTAATCCACAGTCAAGGTC
AAAGTGCCAATCTTTACTC -> AAGTGCCAATCTTTACTCG
CCCACGAGAATACCTCGAT -> CCACGAGAATACCTCGATA
TATGTATCGTCCTGGTCGA -> ATGTATCGTCCTGGTCGAT
ATCAAGAACTATGAGTTAA -> TCAAGAACTATGAGTTAAG
GTGCCACGATCGTCTGGGG -> TGCCACGATCGTCTGGGGG
TAACTCGGGCACTAGGATT -> AACTCGGGCACTAGGATTT
CCTGTTTAAGAGGACTCAC -> CTGTTTAAGAGGACTCACC
TGAATTAGTCTTTCTGGGT -> GAATTAGTCTTTCTGGGTT
ACTAATGGACTTCACTTAG -> CTAATGGACTTCACTTAGT
CGTAGACGTTTGTTTAGAC -> GTAGACGTTTGTTTAGACA
CCACAGTCAACATCAAAAC -> CACAGTCAACATCAAAACC
CCATGGGTCATTGCCCCTA -> CATGGGTCATTGCCCCTAA
ATGGACACACGTGAGGGCC -> TGGACACACGTGAGGGCCC
AGGTGGTTATCACTAGGCC -> GGTGGTTATCACTAGGCCA
CCTTACAAATATAGGCCCT -> CTTACAAATATAGGCCCTG
TAGAATACTCGTCCAGGAG -> AGAATACTCGTCCAGGAGG
GCCGGCGTTAGGACAGGCG -> CCGGCGTTAGGACAGGCGA
CGTCCAGGAGGGCGGCTTA -> GTCCAGGAGGGCGGCTTAC
TCTTTCTGGGTTTGGATCC -> CTTTCTGGGTTTGGATCCA
ACAGTCAAAACTATAAGCC -> CAGTCAAAACTATAAGCCG
TTGAGTACCTATGAAGAGC -> TGAGTACCTATGAAGAGCT
TACAGAGCGCGTTGCTCAG -> ACAGAGCGCGTTGCTCAGC
CATTCTACTAATCTGGATA -> ATTCTACTAATCTGGATAG
AACATCCTAGAATACTCGT -> ACATCCTAGAATACTCGTC
TCTAAAGAAACATCCTAGA -> CTAAAGAAACATCCTAGAA
TTATGAACCCTGTTTACAC -> TATGAACCCTGTTTACACA
GTGGAGGATGCAACATATA -> TGGAGGATGCAACATATAT
AACTTAGTGGCGTATTGCT -> ACTTAGTGGCGTATTGCTG
ATACTCGTCCAGGAGGGCG -> TACTCGTCCAGGAGGGCGG
TTCTAAAGAAGCCCCCAAG -> TCTAAAGAAGCCCCCAAGC
CAGGCCACTCCTATTTACA -> AGGCCACTCCTATTTACAC
ACCTCGATACTCGGCTTGT -> CCTCGATACTCGGCTTGTC
GTCTCCCACTTACGCACAT -> TCTCCCACTTACGCACATT
GAGAGTATCTAGAAACCCG -> AGAGTATCTAGAAACCCGA
GCGTTTTATCAGTCCGGTA -> CGTTTTATCAGTCCGGTAG
ACAGTCAATCTTCTGTTCT -> CAGTCAATCTTCTGTTCTG
CCGAACAAAATGCCAAGTC -> CGAACAAAATGCCAAGTCG
ATGAAGAGCTCAGGTGACT -> TGAAGAGCTCAGGTGACTA
ACCAATCTAGTTGAATTGG -> CCAATCTAGTTGAATTGGT
TCGTGCCACGATCGTCTGG -> CGTGCCACGATCGTCTGGG
GTTGCTCAGCGCAAAATCT -> TTGCTCAGCGCAAAATCTT
AAACATCCTAGAATACTCG -> AACATCCTAGAATACTCGT
TTTAGCCTCAAGAAGTTTC -> TTAGCCTCAAGAAGTTTCC
AGGTCAGTCCTGTCCAGTA -> GGTCAGTCCTGTCCAGTAG
TGCCAAGTCGAGTATATAT -> GCCAAGTCGAGTATATATA
AGCCGTGTTATAACTCCAA -> GCCGTGTTATAACTCCAAT
TATAACTCCAATGAGAACG -> ATAACTCCAATGAGAACGT
TGGCTCTAAAGAAACATCC -> GGCTCTAAAGAAACATCCT
GTCTTACGTTATCCACGCT -> TCTTACGTTATCCACGCTA
ACGTTATCCACGCTATGCG -> CGTTATCCACGCTATGCGT
ACGGAATGGACACACGTGT -> CGGAATGGACACACGTGTT
GTCCTACTCGATAACTCGG -> TCCTACTCGATAACTCGGG
CTCGGCTTGTCTCCTGGAT -> TCGGCTTGTCTCCTGGATA
CTGTTTAAGAGGACTCACC -> TGTTTAAGAGGACTCACCA
CCCGACCTACTTATGCCGG -> CCGACCTACTTATGCCGGC
ATGTAGTACCATTATGCTG -> TGTAGTACCATTATGCTGT
TACACAATCTTTTGGGTTC -> ACACAATCTTTTGGGTTCG
TGTTTAGACATACGAGCGG -> GTTTAGACATACGAGCGGA
AATACTCGTCCAGGAGGGC -> ATACTCGTCCAGGAGGGCG
TCCACAGTCAAGGTCATCC -> CCACAGTCAAGGTCATCCT
CGCGTTGCTCAGCGCAAAA -> GCGTTGCTCAGCGCAAAAT
TGAACTGAGCGCGCGGCAC -> GAACTGAGCGCGCGGCACT
TAAACGCATTATGAACCCT -> AAACGCATTATGAACCCTG
TGTTCTGACGGAATGGACA -> GTTCTGACGGAATGGACAC
CTCGATATCAAGAACTATG -> TCGATATCAAGAACTATGA
CCCATGGGTCATTGCCCCT -> CCATGGGTCATTGCCCCTA
CTTAATTCCGGCCCTGGTC -> TTAATTCCGGCCCTGGTCT
TAATGGGGTGCTGATGCCC -> AATGGGGTGCTGATGCCCA
TAAAAACAACGGCACAGTC -> AAAAACAACGGCACAGTCA
TTTATCGATGCCACGTTGG -> TTATCGATGCCACGTTGGA
GTCCAGTAGAAATTTTGGT -> TCCAGTAGAAATTTTGGTC
AGTTGCATGGGGTTGGTAA -> GTTGCATGGGGTTGGTAAC
TAATTCTTCCGGGGTCTTA -> AATTCTTCCGGGGTCTTAA
CCTCGATACTCGGCTTGTC -> CTCGATACTCGGCTTGTCT
ACTGCGCCTTTGGAAATCG -> CTGCGCCTTTGGAAATCGC
ACTTAATTCCGGCCCTGGT -> CTTAATTCCGGCCCTGGTC
CGGCCATTCGCGATATCGA -> GGCCATTCGCGATATCGAC
GTCCTAGGAATAAAGTTTA -> TCCTAGGAATAAAGTTTAT
TGATCCTAGCGCCGTCCGA -> GATCCTAGCGCCGTCCGAC
GGGGCGTGCCTAGTATGTA -> GGGCGTGCCTAGTATGTAG
GGTTGGTAACTATTCTAAA -> GTTGGTAACTATTCTAAAG
CAGGAAGGCGATCGTGTGT -> AGGAAGGCGATCGTGTGTA
ATGTTAATTCCGCGTTTTA -> TGTTAATTCCGCGTTTTAT
CGCATTATGAACCCTGTTT -> GCATTATGAACCCTGTTTA
GACAGGATTAGTAGTAAGC -> ACAGGATTAGTAGTAAGCC
GCAGGTGGTGTCCCTCCTT -> CAGGTGGTGTCCCTCCTTC
GATAAAAGTCCTACTCGAT -> ATAAAAGTCCTACTCGATA
TGCGAAACAAGGACGCCTC -> GCGAAACAAGGACGCCTCC
GATAAACGCATCTTAATCC -> ATAAACGCATCTTAATCCA
GATGCAACATATATCGTTG -> ATGCAACATATATCGTTGG
CCTTAGGGCCATTTTTGGT -> CTTAGGGCCATTTTTGGTT
CTAGTATGTAGTACCATTA -> TAGTATGTAGTACCATTAT
TCCGACTGGCTGAATTTAG -> CCGACTGGCTGAATTTAGA
GGCTCTAAAGAAACATCCT -> GCTCTAAAGAAACATCCTA
TGTGTATTTAGCCTCAAGA -> GTGTATTTAGCCTCAAGAA
GAGGGCGGCTTACAGAGCG -> AGGGCGGCTTACAGAGCGC
CCTGAGTCTCCCACTTACG -> CTGAGTCTCCCACTTACGC
CTGGCACTAATGGACTTCA -> TGGCACTAATGGACTTCAC
CAGCCGTGTTATAACTCCA -> AGCCGTGTTATAACTCCAA
CACGAGAATACCTCGATAC -> ACGAGAATACCTCGATACT
CTTCAGGCCACTCCTATTT -> TTCAGGCCACTCCTATTTA
AGCTTGATCCTAGCGCCGT -> GCTTGATCCTAGCGCCGTC
CACGTGCACGACCTTAGGG -> ACGTGCACGACCTTAGGGC
CGAGTGGAGGTAAACGGGT -> GAGTGGAGGTAAACGGGTC
TGAGCGCGCGGCACTACAC -> GAGCGCGCGGCACTACACA
TACCATTATGCTGTAGCTC -> ACCATTATGCTGTAGCTCG
AAACTATAAGCCGACGGAA -> AACTATAAGCCGACGGAAT
ATGAAGCGTTGGTAGACCC -> TGAAGCGTTGGTAGACCCT
CAATGAGAACGTTACCGCC -> AATGAGAACGTTACCGCCA
ATTGCCCCTAAGTGGCCAT -> TTGCCCCTAAGTGGCCATG
AACTCCAATGAGAACGTTA -> ACTCCAATGAGAACGTTAC
GCCCATTAAAAACAACGGC -> CCCATTAAAAACAACGGCA
CGCCGGCGTTAGGACAGGC -> GCCGGCGTTAGGACAGGCG
ACTTACTCACTGTGCGAAA -> CTTACTCACTGTGCGAAAC
GCGGAAGAGATAAGATGTT -> CGGAAGAGATAAGATGTTA
CGCGCGTGTAAACGCATTA -> GCGCGTGTAAACGCATTAT
GGACACACGTGATTTAGCA -> GACACACGTGATTTAGCAG
TAAGTAGTACAACGTGAGC -> AAGTAGTACAACGTGAGCC
GCCACTCCTATTTACACAG -> CCACTCCTATTTACACAGG
GCGGCACTACACAATCTTT -> CGGCACTACACAATCTTTT
ACAATCTTTTGGGTTCGTG -> CAATCTTTTGGGTTCGTGT
CCACAGTCAAAACTATAAG -> CACAGTCAAAACTATAAGC
GGCTGAATTTAGATCGATC -> GCTGAATTTAGATCGATCT
CCCTAAGTGGCCATGCCTT -> CCTAAGTGGCCATGCCTTA
TGGACACACGTGAGGGCCC -> GGACACACGTGAGGGCCCC
ATGGAGACTGATGAAGCGT -> TGGAGACTGATGAAGCGTT
AAAGTCCTACTCGATAACT -> AAGTCCTACTCGATAACTC
TAATCCACAGTCAAGGTCA -> AATCCACAGTCAAGGTCAT
TGCGTGGAGGATGCAACAT -> GCGTGGAGGATGCAACATA
TTCAGGCCACTCCTATTTA -> TCAGGCCACTCCTATTTAC
TAAGCAGGTCGGAGTCACT -> AAGCAGGTCGGAGTCACTA
TGCGCAACACTGAAGGTCT -> GCGCAACACTGAAGGTCTG
TGCCCATACTCGAGTGAGG -> GCCCATACTCGAGTGAGGC
TTACAAATATAGGCCCTGT -> TACAAATATAGGCCCTGTT
CCATGAAAGTGCCAATCTT -> CATGAAAGTGCCAATCTTT
GAATACTCGTCCAGGAGGG -> AATACTCGTCCAGGAGGGC
CTTACTCACTGTGCGAAAC -> TTACTCACTGTGCGAAACA
GGCCCTCCCCAGGAAGGCG -> GCCCTCCCCAGGAAGGCGA
GTTCGGCCCCCACCCATGG -> TTCGGCCCCCACCCATGGG
AACATTCTACTAATCTGGA -> ACATTCTACTAATCTGGAT
CCACGAGGTGGTTATCACT -> CACGAGGTGGTTATCACTA
CCCTCCCCAGGAAGGCGAT -> CCTCCCCAGGAAGGCGATC
GGCCCTGTTTAAGAGGACT -> GCCCTGTTTAAGAGGACTC
CTTACGCACATTCGTGCCA -> TTACGCACATTCGTGCCAC
ACCGATGATGAACTGAGCG -> CCGATGATGAACTGAGCGC
CTGCGCCTTTGGAAATCGC -> TGCGCCTTTGGAAATCGCA
CCTTATCCTGGCCCTCCCC -> CTTATCCTGGCCCTCCCCA
AAGTCGGTAGTTCTGGTTG -> AGTCGGTAGTTCTGGTTGA
GCCACGTTGGAAGAAAGAC -> CCACGTTGGAAGAAAGACC
CGGTAGAGTACGGCATGGC -> GGTAGAGTACGGCATGGCA
GTCCCTCCTTCCGAACAAA -> TCCCTCCTTCCGAACAAAA
TAGGAATAAAGTTTATGGC -> AGGAATAAAGTTTATGGCT
TTTACACAGCTTGATCCTA -> TTACACAGCTTGATCCTAG
TTAGGGCCATTTTTGGTTA -> TAGGGCCATTTTTGGTTAG
AATGAGCCTAGTAAGTAGT -> ATGAGCCTAGTAAGTAGTA
TTAGCCTCAAGAAGTTTCC -> TAGCCTCAAGAAGTTTCCT
CTAGTTGAATTGGTCTTCT -> TAGTTGAATTGGTCTTCTG
ACAAGGACGCCTCCCGCAG -> CAAGGACGCCTCCCGCAGG
