AAAAACAGCTG -> AAAACAGCTGG
AAAAACTCCGG -> AAAACTCCGGA
AAAACAGCGTG -> AAACAGCGTGG
AAAACAGCTGG -> AAACAGCTGGC
AAAACTCCGGA -> AAACTCCGGAT
AAAAGTTGATA -> AAAGTTGATAG
AAAATTCATAA -> AAATTCATAAG
AAACAACCGGT -> AACAACCGGTA
AAACACCCCCA -> AACACCCCCAT
AAACAGCGTGG -> AACAGCGTGGC
AAACAGCTGGC -> AACAGCTGGCG
AAACATGTGTT -> AACATGTGTTT
AAACCAAGGGG -> AACCAAGGGGG
AAACCGCGCGT -> AACCGCGCGTA
AAACCGCTTAG -> AACCGCTTAGT
AAACGAACACC -> AACGAACACCA
AAACTCACCGA -> AACTCACCGAA
AAACTCCGGAT -> AACTCCGGATC
AAACTGCGATT -> AACTGCGATTC
AAACTTGCAAA -> AACTTGCAAAT
AAAGATACCTA -> AAGATACCTAC
AAAGGGTACGG -> AAGGGTACGGT
AAAGGGTCCTC -> AAGGGTCCTCG
AAAGGGTGAAA -> AAGGGTGAAAG
AAAGGTCTGTC -> AAGGTCTGTCG
AAAGTCCCGAA -> AAGTCCCGAAC
AAAGTGTTTAC -> AAGTGTTTACG
AAAGTTGATAG -> AAGTTGATAGG
AAATAGTGGGA -> AATAGTGGGAC
AAATCAAGCAC -> AATCAAGCACC
AAATCTGTCCA -> AATCTGTCCAC
AAATGGTAAAC -> AATGGTAAACC
AAATGTATCGA -> AATGTATCGAC
AAATTCATAAG -> AATTCATAAGA
AACAACCGGTA -> ACAACCGGTAA
AACACCACGAT -> ACACCACGATG
AACACCCCCAT -> ACACCCCCATG
AACACCCGCCG -> ACACCCGCCGG
AACACCGTTAA -> ACACCGTTAAA
AACAGACCATA -> ACAGACCATAT
AACAGCGTGGC -> ACAGCGTGGCA
AACAGCTGGCG -> ACAGCTGGCGA
AACATACATAG -> ACATACATAGC
AACATATAAAG -> ACATATAAAGG
AACATGTGTTT -> ACATGTGTTTC
AACATTAGGTC -> ACATTAGGTCT
AACCAAGGGGG -> ACCAAGGGGGG
AACCATCGATC -> ACCATCGATCG
AACCCACTAGA -> ACCCACTAGAA
AACCGCGCGTA -> ACCGCGCGTAT
AACCGCTTAGT -> ACCGCTTAGTA
AACCGGTAAAA -> ACCGGTAAAAG
AACCTATTTCC -> ACCTATTTCCA
AACGAACACCA -> ACGAACACCAC
AACGCTTTGAC -> ACGCTTTGACC
AACGGGGCCAC -> ACGGGGCCACT
AACGGGGTCTG -> ACGGGGTCTGC
AACGGTTCCAC -> ACGGTTCCACG
AACGTGGTCCG -> ACGTGGTCCGA
AACTATGAGTG -> ACTATGAGTGC
AACTCACCGAA -> ACTCACCGAAT
AACTCCGGATC -> ACTCCGGATCG
AACTGCGATTC -> ACTGCGATTCG
AACTGGGGGGA -> ACTGGGGGGAC
AACTTGCAAAT -> ACTTGCAAATA
AACTTGTGGGG -> ACTTGTGGGGG
AAGAAACGAAC -> AGAAACGAACA
AAGAAGTAAAC -> AGAAGTAAACC
AAGACGTACTT -> AGACGTACTTC
AAGAGATTGTC -> AGAGATTGTCT
AAGAGCACAAC -> AGAGCACAACT
AAGAGGAGTGA -> AGAGGAGTGAC
AAGAGGGACTT -> AGAGGGACTTA
AAGATACCTAC -> AGATACCTACC
AAGCACCTAAC -> AGCACCTAACT
AAGCCAGTACT -> AGCCAGTACTG
AAGCCCGTTTC -> AGCCCGTTTCC
AAGCCGGAGCG -> AGCCGGAGCGG
AAGCGCAACAC -> AGCGCAACACC
AAGCTGAAGGC -> AGCTGAAGGCA
AAGCTGCAATC -> AGCTGCAATCC
AAGGAGTGTTC -> AGGAGTGTTCT
AAGGCAAGGGG -> AGGCAAGGGGT
AAGGCTTATCG -> AGGCTTATCGG
AAGGGACGGTT -> AGGGACGGTTA
AAGGGGGGTCG -> AGGGGGGTCGC
AAGGGGTTAGG -> AGGGGTTAGGA
AAGGGTACGGT -> AGGGTACGGTA
AAGGGTCCTCG -> AGGGTCCTCGT
AAGGGTGAAAG -> AGGGTGAAAGT
AAGGTCTGTCG -> AGGTCTGTCGA
AAGTAAACCAA -> AGTAAACCAAG
AAGTCCCGAAC -> AGTCCCGAACA
AAGTCCCTCAA -> AGTCCCTCAAG
AAGTCGACACC -> AGTCGACACCG
AAGTCTTATCC -> AGTCTTATCCT
AAGTGTTTACG -> AGTGTTTACGT
AAGTTGATAGG -> AGTTGATAGGC
AATAAAGGGTC -> ATAAAGGGTCC
AATAGTGGGAC -> ATAGTGGGACG
AATATACCGGT -> ATATACCGGTT
AATATAGCCCT -> ATATAGCCCTA
AATATTCATTT -> ATATTCATTTA
AATATTCGAAA -> ATATTCGAAAC
AATATTGGCTT -> ATATTGGCTTT
AATCAAACTGC -> ATCAAACTGCG
AATCAAGCACC -> ATCAAGCACCT
AATCAGTGCCG -> ATCAGTGCCGC
AATCATCGGTA -> ATCATCGGTAA
AATCCGTTCGC -> ATCCGTTCGCG
AATCGTCTTGA -> ATCGTCTTGAA
AATCTCAATTT -> ATCTCAATTTC
AATCTGTCCAC -> ATCTGTCCACC
AATGAACACCG -> ATGAACACCGT
AATGAACGGGG -> ATGAACGGGGC
AATGAGAGAGT -> ATGAGAGAGTA
AATGCAGAAAC -> ATGCAGAAACA
AATGCGGGCCG -> ATGCGGGCCGT
AATGGTAAACC -> ATGGTAAACCG
AATGTAGCAGG -> ATGTAGCAGGA
AATGTATCGAC -> ATGTATCGACG
AATGTCGGTAA -> ATGTCGGTAAT
AATTAGAGACA -> ATTAGAGACAT
AATTATTCGGC -> ATTATTCGGCC
AATTCATAAGA -> ATTCATAAGAA
AATTCGTTTCC -> ATTCGTTTCCG
AATTGGTCTGA -> ATTGGTCTGAT
AATTTACAAGC -> ATTTACAAGCC
AATTTATCTGG -> ATTTATCTGGA
AATTTCAATCA -> ATTTCAATCAG
ACAAAGTCCCG -> CAAAGTCCCGA
ACAAATGGTAA -> CAAATGGTAAA
ACAACCGGTAA -> CAACCGGTAAA
ACAACGGTTCC -> CAACGGTTCCA
ACAACTATGAG -> CAACTATGAGT
ACAAGCCGGAG -> CAAGCCGGAGC
ACACATCTTCT -> CACATCTTCTA
ACACCACGATG -> CACCACGATGC
ACACCCCCATG -> CACCCCCATGC
ACACCCGCCGG -> CACCCGCCGGT
ACACCGGAAGC -> CACCGGAAGCT
ACACCGTTAAA -> CACCGTTAAAA
ACACCTACCTA -> CACCTACCTAA
ACACGATGGCT -> CACGATGGCTG
ACACGGCACTC -> CACGGCACTCC
ACACTACCACG -> CACTACCACGG
ACACTCCGGTT -> CACTCCGGTTG
ACAGACCATAT -> CAGACCATATT
ACAGATCGAAC -> CAGATCGAACC
ACAGCGTGGCA -> CAGCGTGGCAA
ACAGCTGGCGA -> CAGCTGGCGAT
ACAGGAATATA -> CAGGAATATAC
ACAGTACCGGT -> CAGTACCGGTC
ACAGTGGCACT -> CAGTGGCACTA
ACAGTGTACTC -> CAGTGTACTCA
ACAGTTCTGTC -> CAGTTCTGTCT
ACATACATAGC -> CATACATAGCC
ACATAGCCGCA -> CATAGCCGCAG
ACATATAAAGG -> CATATAAAGGG
ACATCGCAGAC -> CATCGCAGACC
ACATCTTCTAA -> CATCTTCTAAA
ACATGTGTTTC -> CATGTGTTTCT
ACATTAGGTCT -> CATTAGGTCTC
ACATTCTTTGT -> CATTCTTTGTA
ACATTGCTACC -> CATTGCTACCA
ACCAACTGGGG -> CCAACTGGGGG
ACCAAGAGATT -> CCAAGAGATTG
ACCAAGCTGAA -> CCAAGCTGAAG
ACCAAGGGGGG -> CCAAGGGGGGT
ACCAATCATCG -> CCAATCATCGG
ACCAATGTAGC -> CCAATGTAGCA
ACCACCTGTAT -> CCACCTGTATA
ACCACGATGCT -> CCACGATGCTA
ACCACGGAGTG -> CCACGGAGTGG
ACCACTTATGC -> CCACTTATGCC
ACCAGAATTAG -> CCAGAATTAGA
ACCAGCATACC -> CCAGCATACCG
ACCATAAGGAG -> CCATAAGGAGT
ACCATAATCAA -> CCATAATCAAA
ACCATATTGCA -> CCATATTGCAG
ACCATCGATCG -> CCATCGATCGC
ACCCACGTTAT -> CCCACGTTATT
ACCCACTAGAA -> CCCACTAGAAA
ACCCAGCACCG -> CCCAGCACCGA
ACCCAGTGTAG -> CCCAGTGTAGA
ACCCATTTTAC -> CCCATTTTACA
ACCCCCATGCC -> CCCCCATGCCT
ACCCCTTCGTA -> CCCCTTCGTAC
ACCCGACTCGA -> CCCGACTCGAA
ACCCGCCGGTT -> CCCGCCGGTTG
ACCCTAAGCCA -> CCCTAAGCCAG
ACCCTCAGAGA -> CCCTCAGAGAT
ACCGAATTCGT -> CCGAATTCGTT
ACCGACCAACT -> CCGACCAACTG
ACCGATGGTTC -> CCGATGGTTCC
ACCGCGCGTAT -> CCGCGCGTATT
ACCGCGGAGCG -> CCGCGGAGCGG
ACCGCTTAGTA -> CCGCTTAGTAG
ACCGGAAGCTG -> CCGGAAGCTGC
ACCGGAGTCAT -> CCGGAGTCATG
ACCGGTAAAAG -> CCGGTAAAAGT
ACCGGTCTGCT -> CCGGTCTGCTC
ACCGGTGGGCG -> CCGGTGGGCGA
ACCGGTTAGTA -> CCGGTTAGTAA
ACCGTTAAAAA -> CCGTTAAAAAC
ACCTAAACTTG -> CCTAAACTTGC
ACCTAACTTGT -> CCTAACTTGTG
ACCTACCAATC -> CCTACCAATCA
ACCTACCTAAA -> CCTACCTAAAC
ACCTAGGGACA -> CCTAGGGACAC
ACCTATTTCCA -> CCTATTTCCAC
ACCTCTCTAAG -> CCTCTCTAAGA
ACCTGCTCGTA -> CCTGCTCGTAC
ACCTGTATATG -> CCTGTATATGA
ACCTTTGGCGC -> CCTTTGGCGCT
ACGAACACCAC -> CGAACACCACG
ACGACCAATGT -> CGACCAATGTA
ACGACGTAGCC -> CGACGTAGCCT
ACGAGACCGGT -> CGAGACCGGTG
ACGAGGCAAAG -> CGAGGCAAAGG
ACGAGGGCTGA -> CGAGGGCTGAA
ACGATAAGGGA -> CGATAAGGGAC
ACGATGCTACA -> CGATGCTACAA
ACGATGGCTGG -> CGATGGCTGGC
ACGCGACCTCT -> CGCGACCTCTC
ACGCGGCTGCT -> CGCGGCTGCTG
ACGCTTTGACC -> CGCTTTGACCT
ACGGAGTGGCG -> CGGAGTGGCGC
ACGGAGTTGGC -> CGGAGTTGGCG
ACGGCACTCCG -> CGGCACTCCGA
ACGGCCTGAAA -> CGGCCTGAAAC
ACGGGGCCACT -> CGGGGCCACTT
ACGGGGTCTGC -> CGGGGTCTGCT
ACGGTAATTGG -> CGGTAATTGGT
ACGGTACCAAG -> CGGTACCAAGC
ACGGTGAATGA -> CGGTGAATGAA
ACGGTGGTGCT -> CGGTGGTGCTT
ACGGTTAAATC -> CGGTTAAATCA
ACGGTTAACAT -> CGGTTAACATA
ACGGTTCCACG -> CGGTTCCACGA
ACGTACCCTAA -> CGTACCCTAAG
ACGTACTTCCA -> CGTACTTCCAG
ACGTAGCCTGA -> CGTAGCCTGAT
ACGTCTCCCGC -> CGTCTCCCGCA
ACGTCTGACGT -> CGTCTGACGTT
ACGTGCCTTCC -> CGTGCCTTCCT
ACGTGGTCCGA -> CGTGGTCCGAA
ACGTTATTCGC -> CGTTATTCGCT
ACGTTTAGATC -> CGTTTAGATCT
ACTACAGGAAT -> CTACAGGAATA
ACTACCACGGA -> CTACCACGGAG
ACTAGAAAGAT -> CTAGAAAGATA
ACTATCTTGAG -> CTATCTTGAGC
ACTATGAGTGC -> CTATGAGTGCA
ACTCAATTTAT -> CTCAATTTATC
ACTCACCGAAT -> CTCACCGAATT
ACTCCAGAGAC -> CTCCAGAGACA
ACTCCGAATAT -> CTCCGAATATA
ACTCCGGATCG -> CTCCGGATCGT
ACTCCGGTTGT -> CTCCGGTTGTT
ACTCGAAATCT -> CTCGAAATCTG
ACTGCGATTCG -> CTGCGATTCGC
ACTGGGGGGAC -> CTGGGGGGACG
ACTGGTCGTTG -> CTGGTCGTTGG
ACTGTAATTAT -> CTGTAATTATT
ACTTACACTAC -> CTTACACTACC
ACTTAGCGCAC -> CTTAGCGCACC
ACTTATGCCGT -> CTTATGCCGTG
ACTTCCAGTTT -> CTTCCAGTTTT
ACTTCGCGAAC -> CTTCGCGAACC
ACTTGAGGGCG -> CTTGAGGGCGC
ACTTGCAAATA -> CTTGCAAATAG
ACTTGCCCGCT -> CTTGCCCGCTC
ACTTGTGGGGG -> CTTGTGGGGGG
AGAAACAACCG -> GAAACAACCGG
AGAAACGAACA -> GAAACGAACAC
AGAAAGATACC -> GAAAGATACCT
AGAAGTAAACC -> GAAGTAAACCA
AGAATATTCGA -> GAATATTCGAA
AGAATTAGAGA -> GAATTAGAGAC
AGACACTCCGG -> GACACTCCGGT
AGACATTGCTA -> GACATTGCTAC
AGACCATAATC -> GACCATAATCA
AGACCATATTG -> GACCATATTGC
AGACCCTCAGA -> GACCCTCAGAG
AGACCGGTGGG -> GACCGGTGGGC
AGACGCGGCTG -> GACGCGGCTGC
AGACGTACTTC -> GACGTACTTCC
AGAGACACTCC -> GAGACACTCCG
AGAGACATTGC -> GAGACATTGCT
AGAGAGTAAGA -> GAGAGTAAGAG
AGAGATTCATC -> GAGATTCATCC
AGAGATTGTCT -> GAGATTGTCTC
AGAGCACAACT -> GAGCACAACTA
AGAGCGTCACC -> GAGCGTCACCG
AGAGGAGTGAC -> GAGGAGTGACA
AGAGGGACTTA -> GAGGGACTTAC
AGAGTAAGAGG -> GAGTAAGAGGG
AGAGTTACGGC -> GAGTTACGGCC
AGAGTTTCACG -> GAGTTTCACGG
AGATACCTACC -> GATACCTACCA
AGATCGAACCC -> GATCGAACCCA
AGATCTAAGAG -> GATCTAAGAGG
AGATTATGCCT -> GATTATGCCTC
AGATTCATCCC -> GATTCATCCCG
AGATTGCGCTT -> GATTGCGCTTA
AGATTGTCTCA -> GATTGTCTCAT
AGCAATGAGAG -> GCAATGAGAGA
AGCACAACTAT -> GCACAACTATG
AGCACCGACCA -> GCACCGACCAA
AGCACCTAACT -> GCACCTAACTT
AGCACCTGCTC -> GCACCTGCTCG
AGCACGGTGAA -> GCACGGTGAAT
AGCAGGATCCA -> GCAGGATCCAC
AGCAGGTCGCA -> GCAGGTCGCAC
AGCATACCGAT -> GCATACCGATG
AGCATTGGGTG -> GCATTGGGTGC
AGCCACGCGAC -> GCCACGCGACC
AGCCAGTACTG -> GCCAGTACTGT
AGCCCGTTTCC -> GCCCGTTTCCT
AGCCCTAGATT -> GCCCTAGATTA
AGCCGCAGGTG -> GCCGCAGGTGC
AGCCGGAGCGG -> GCCGGAGCGGA
AGCCTGATTGT -> GCCTGATTGTG
AGCGCAACACC -> GCGCAACACCC
AGCGCACCAGC -> GCGCACCAGCA
AGCGCCTGTAC -> GCGCCTGTACA
AGCGCGCAAGT -> GCGCGCAAGTC
AGCGGACTATC -> GCGGACTATCT
AGCGGTGTGAC -> GCGGTGTGACT
AGCGTCACCGG -> GCGTCACCGGA
AGCGTGGCAAT -> GCGTGGCAATC
AGCTCATAAAT -> GCTCATAAATG
AGCTGAAGGCA -> GCTGAAGGCAA
AGCTGCAATCC -> GCTGCAATCCG
AGCTGGCGATG -> GCTGGCGATGC
AGGAATATACC -> GGAATATACCG
AGGACGACCAA -> GGACGACCAAT
AGGAGCACCTG -> GGAGCACCTGC
AGGAGTGACAG -> GGAGTGACAGT
AGGAGTGTTCT -> GGAGTGTTCTC
AGGATCCACTT -> GGATCCACTTG
AGGATTGACGA -> GGATTGACGAG
AGGCAAAGGTC -> GGCAAAGGTCT
AGGCAAGGGGT -> GGCAAGGGGTT
AGGCCAAGCGC -> GGCCAAGCGCA
AGGCTTATCGG -> GGCTTATCGGA
AGGGACACCTA -> GGGACACCTAC
AGGGACGGTTA -> GGGACGGTTAA
AGGGACTTACA -> GGGACTTACAC
AGGGCGCGTGT -> GGGCGCGTGTG
AGGGCTGAATT -> GGGCTGAATTT
AGGGCTTCCAT -> GGGCTTCCATT
AGGGGGGTCGC -> GGGGGGTCGCA
AGGGGTTAGGA -> GGGGTTAGGAG
AGGGTACGGTA -> GGGTACGGTAA
AGGGTCCTCGT -> GGGTCCTCGTG
AGGGTGAAAGT -> GGGTGAAAGTG
AGGTCCCGAGC -> GGTCCCGAGCG
AGGTCGCACCC -> GGTCGCACCCC
AGGTCTCAACC -> GGTCTCAACCT
AGGTCTGTCGA -> GGTCTGTCGAT
AGGTGCAATGC -> GGTGCAATGCG
AGTAAACCAAG -> GTAAACCAAGG
AGTAAGAGGGA -> GTAAGAGGGAC
AGTAATATTCA -> GTAATATTCAT
AGTACCGGTCT -> GTACCGGTCTG
AGTACTGTAAT -> GTACTGTAATT
AGTAGAATATT -> GTAGAATATTC
AGTAGCCACGC -> GTAGCCACGCG
AGTCATGGGAA -> GTCATGGGAAA
AGTCCCGAACA -> GTCCCGAACAT
AGTCCCTCAAG -> GTCCCTCAAGA
AGTCGACACCG -> GTCGACACCGG
AGTCGTCTTCA -> GTCGTCTTCAC
AGTCTCGGTCC -> GTCTCGGTCCG
AGTCTTATCCT -> GTCTTATCCTT
AGTGACAGTAC -> GTGACAGTACC
AGTGCATCACG -> GTGCATCACGT
AGTGCCACGTC -> GTGCCACGTCT
AGTGCCGCCTG -> GTGCCGCCTGT
AGTGGATGCCA -> GTGGATGCCAG
AGTGGCACTAC -> GTGGCACTACA
AGTGGCGCGAA -> GTGGCGCGAAC
AGTGGGACGGA -> GTGGGACGGAG
AGTGTACTCAA -> GTGTACTCAAT
AGTGTAGACCA -> GTGTAGACCAT
AGTGTTCTCGC -> GTGTTCTCGCT
AGTGTTTACGT -> GTGTTTACGTG
AGTTAATAAAG -> GTTAATAAAGG
AGTTACGGCCT -> GTTACGGCCTG
AGTTCTGTCTG -> GTTCTGTCTGC
AGTTGATAGGC -> GTTGATAGGCC
AGTTGGCGTTT -> GTTGGCGTTTC
AGTTTCACGGT -> GTTTCACGGTA
AGTTTTTGTAA -> GTTTTTGTAAC
ATAAAGGGTAC -> TAAAGGGTACG
ATAAAGGGTCC -> TAAAGGGTCCT
ATAAATGTATC -> TAAATGTATCG
ATAAGAAACGA -> TAAGAAACGAA
ATAAGGAGTGT -> TAAGGAGTGTT
ATAAGGGACGG -> TAAGGGACGGT
ATAATCAAACT -> TAATCAAACTG
ATACACGATGG -> TACACGATGGC
ATACATAGCCG -> TACATAGCCGC
ATACCGATGGT -> TACCGATGGTT
ATACCGGTTAG -> TACCGGTTAGT
ATACCTACCAA -> TACCTACCAAT
ATAGCCCTAGA -> TAGCCCTAGAT
ATAGCCGCAGG -> TAGCCGCAGGT
ATAGGCCAAGC -> TAGGCCAAGCG
ATAGTGGATGC -> TAGTGGATGCC
ATAGTGGGACG -> TAGTGGGACGG
ATATAAAGGGT -> TATAAAGGGTA
ATATACCGGTT -> TATACCGGTTA
ATATAGCCCTA -> TATAGCCCTAG
ATATGAAAAAC -> TATGAAAAACA
ATATTCATTTA -> TATTCATTTAG
ATATTCGAAAC -> TATTCGAAACA
ATATTGCAGGG -> TATTGCAGGGC
ATATTGGCTTT -> TATTGGCTTTA
ATCAAACTGCG -> TCAAACTGCGA
ATCAAGCACCT -> TCAAGCACCTA
ATCACGTCTCC -> TCACGTCTCCC
ATCAGTGCCGC -> TCAGTGCCGCC
ATCATCGGTAA -> TCATCGGTAAG
ATCCACAAATG -> TCCACAAATGG
ATCCACTTGCC -> TCCACTTGCCC
ATCCCGACTGG -> TCCCGACTGGT
ATCCGTTCGCG -> TCCGTTCGCGA
ATCCTTGGCTT -> TCCTTGGCTTA
ATCGAACCCAC -> TCGAACCCACT
ATCGACGAGGC -> TCGACGAGGCA
ATCGATCGCAT -> TCGATCGCATG
ATCGCAGACCC -> TCGCAGACCCT
ATCGCATGGAC -> TCGCATGGACG
ATCGGACACGG -> TCGGACACGGC
ATCGGTAAGAC -> TCGGTAAGACG
ATCGTCTTCAC -> TCGTCTTCACC
ATCGTCTTGAA -> TCGTCTTGAAT
ATCTAAGAGGA -> TCTAAGAGGAG
ATCTCAATTTC -> TCTCAATTTCA
ATCTGGAGGTC -> TCTGGAGGTCC
ATCTGTCCACC -> TCTGTCCACCC
ATCTTCTAAAC -> TCTTCTAAACC
ATCTTGAGCAT -> TCTTGAGCATT
ATGAAAAACAG -> TGAAAAACAGC
ATGAACACCGT -> TGAACACCGTT
ATGAACGGGGC -> TGAACGGGGCC
ATGAGAGAGTA -> TGAGAGAGTAA
ATGAGTGCATC -> TGAGTGCATCA
ATGCAGAAACA -> TGCAGAAACAA
ATGCCAGTCTC -> TGCCAGTCTCG
ATGCCGTGCCA -> TGCCGTGCCAC
ATGCCTAGAGT -> TGCCTAGAGTT
ATGCCTCACCC -> TGCCTCACCCA
ATGCGGGCCGT -> TGCGGGCCGTC
ATGCTACAAAG -> TGCTACAAAGT
ATGGACGAGAC -> TGGACGAGACC
ATGGCTGGCCA -> TGGCTGGCCAA
ATGGGAAAGGG -> TGGGAAAGGGT
ATGGTAAACCG -> TGGTAAACCGC
ATGGTTCCGTC -> TGGTTCCGTCA
ATGTAGCAGGA -> TGTAGCAGGAT
ATGTATCGACG -> TGTATCGACGA
ATGTCGGTAAT -> TGTCGGTAATC
ATGTGACTTGA -> TGTGACTTGAG
ATGTGTAACAT -> TGTGTAACATA
ATGTGTTTCTA -> TGTGTTTCTAG
ATTAAAACAGC -> TTAAAACAGCG
ATTAATGTCGG -> TTAATGTCGGT
ATTAGAGACAT -> TTAGAGACATT
ATTAGGTCTCA -> TTAGGTCTCAA
ATTATGCCTCA -> TTATGCCTCAC
ATTATTCGGCC -> TTATTCGGCCT
ATTCACCACCT -> TTCACCACCTG
ATTCATAAGAA -> TTCATAAGAAA
ATTCATCCCGA -> TTCATCCCGAC
ATTCATTTAGT -> TTCATTTAGTC
ATTCGAAACAT -> TTCGAAACATG
ATTCGCAGAGT -> TTCGCAGAGTT
ATTCGCTCCCG -> TTCGCTCCCGG
ATTCGGCCTCA -> TTCGGCCTCAC
ATTCGTTTCCG -> TTCGTTTCCGG
ATTCTTTGTAA -> TTCTTTGTAAG
ATTGACGAGGG -> TTGACGAGGGC
ATTGCAGGGCT -> TTGCAGGGCTT
ATTGCGCTTAC -> TTGCGCTTACC
ATTGCTACCAC -> TTGCTACCACT
ATTGGCTTTAG -> TTGGCTTTAGC
ATTGGGTGCAA -> TTGGGTGCAAC
ATTGGTCTGAT -> TTGGTCTGATA
ATTGTCTCATT -> TTGTCTCATTA
ATTGTGGGACC -> TTGTGGGACCT
ATTTACAAGCC -> TTTACAAGCCG
ATTTAGCAATG -> TTTAGCAATGA
ATTTAGTCGTC -> TTTAGTCGTCT
ATTTATCTGGA -> TTTATCTGGAG
ATTTCAATCAG -> TTTCAATCAGT
ATTTCCACAGT -> TTTCCACAGTT
ATTTCCCTTCG -> TTTCCCTTCGT
ATTTGAGTGCC -> TTTGAGTGCCA
ATTTTACAACG -> TTTTACAACGG
CAAAATTCATA -> AAAATTCATAA
CAAACACCCCC -> AAACACCCCCA
CAAACTGCGAT -> AAACTGCGATT
CAAAGGTCTGT -> AAAGGTCTGTC
CAAAGTCCCGA -> AAAGTCCCGAA
CAAATAGTGGG -> AAATAGTGGGA
CAAATGGTAAA -> AAATGGTAAAC
CAACACCCGCC -> AACACCCGCCG
CAACAGACCAT -> AACAGACCATA
CAACCGGTAAA -> AACCGGTAAAA
CAACCTATTTC -> AACCTATTTCC
CAACGGGGTCT -> AACGGGGTCTG
CAACGGTTCCA -> AACGGTTCCAC
CAACTATGAGT -> AACTATGAGTG
CAACTGGGGGG -> AACTGGGGGGA
CAAGAAGTAAA -> AAGAAGTAAAC
CAAGAGATTGT -> AAGAGATTGTC
CAAGCACCTAA -> AAGCACCTAAC
CAAGCCGGAGC -> AAGCCGGAGCG
CAAGCGCAACA -> AAGCGCAACAC
CAAGCTGAAGG -> AAGCTGAAGGC
CAAGGCTTATC -> AAGGCTTATCG
CAAGGGGGGTC -> AAGGGGGGTCG
CAAGGGGTTAG -> AAGGGGTTAGG
CAAGTCCCTCA -> AAGTCCCTCAA
CAAGTCTTATC -> AAGTCTTATCC
CAATCAGTGCC -> AATCAGTGCCG
CAATCATCGGT -> AATCATCGGTA
CAATCCGTTCG -> AATCCGTTCGC
CAATCTCAATT -> AATCTCAATTT
CAATGAGAGAG -> AATGAGAGAGT
CAATGCAGAAA -> AATGCAGAAAC
CAATGCGGGCC -> AATGCGGGCCG
CAATGTAGCAG -> AATGTAGCAGG
CAATTTATCTG -> AATTTATCTGG
CAATTTCAATC -> AATTTCAATCA
CACAAATGGTA -> ACAAATGGTAA
CACAACTATGA -> ACAACTATGAG
CACAGTGTACT -> ACAGTGTACTC
CACAGTTCTGT -> ACAGTTCTGTC
CACATCTTCTA -> ACATCTTCTAA
CACCACCTGTA -> ACCACCTGTAT
CACCACGATGC -> ACCACGATGCT
CACCAGAATTA -> ACCAGAATTAG
CACCAGCATAC -> ACCAGCATACC
CACCCAGCACC -> ACCCAGCACCG
CACCCAGTGTA -> ACCCAGTGTAG
CACCCATTTTA -> ACCCATTTTAC
CACCCCCATGC -> ACCCCCATGCC
CACCCCTTCGT -> ACCCCTTCGTA
CACCCGACTCG -> ACCCGACTCGA
CACCCGCCGGT -> ACCCGCCGGTT
CACCGAATTCG -> ACCGAATTCGT
CACCGACCAAC -> ACCGACCAACT
CACCGGAAGCT -> ACCGGAAGCTG
CACCGGAGTCA -> ACCGGAGTCAT
CACCGTTAAAA -> ACCGTTAAAAA
CACCTAACTTG -> ACCTAACTTGT
CACCTACCTAA -> ACCTACCTAAA
CACCTGCTCGT -> ACCTGCTCGTA
CACCTGTATAT -> ACCTGTATATG
CACGATAAGGG -> ACGATAAGGGA
CACGATGCTAC -> ACGATGCTACA
CACGATGGCTG -> ACGATGGCTGG
CACGCGACCTC -> ACGCGACCTCT
CACGGAGTGGC -> ACGGAGTGGCG
CACGGCACTCC -> ACGGCACTCCG
CACGGTACCAA -> ACGGTACCAAG
CACGGTGAATG -> ACGGTGAATGA
CACGGTTAACA -> ACGGTTAACAT
CACGTCTCCCG -> ACGTCTCCCGC
CACGTCTGACG -> ACGTCTGACGT
CACGTTATTCG -> ACGTTATTCGC
CACTACAGGAA -> ACTACAGGAAT
CACTACCACGG -> ACTACCACGGA
CACTAGAAAGA -> ACTAGAAAGAT
CACTCCGAATA -> ACTCCGAATAT
CACTCCGGTTG -> ACTCCGGTTGT
CACTTAGCGCA -> ACTTAGCGCAC
CACTTATGCCG -> ACTTATGCCGT
CACTTGCCCGC -> ACTTGCCCGCT
CAGAAACAACC -> AGAAACAACCG
CAGAATTAGAG -> AGAATTAGAGA
CAGACCATATT -> AGACCATATTG
CAGACCCTCAG -> AGACCCTCAGA
CAGAGACACTC -> AGAGACACTCC
CAGAGATTCAT -> AGAGATTCATC
CAGAGTTACGG -> AGAGTTACGGC
CAGATCGAACC -> AGATCGAACCC
CAGCACCGACC -> AGCACCGACCA
CAGCATACCGA -> AGCATACCGAT
CAGCGTGGCAA -> AGCGTGGCAAT
CAGCTGGCGAT -> AGCTGGCGATG
CAGGAATATAC -> AGGAATATACC
CAGGATCCACT -> AGGATCCACTT
CAGGATTGACG -> AGGATTGACGA
CAGGGCTTCCA -> AGGGCTTCCAT
CAGGTCGCACC -> AGGTCGCACCC
CAGGTGCAATG -> AGGTGCAATGC
CAGTACCGGTC -> AGTACCGGTCT
CAGTACTGTAA -> AGTACTGTAAT
CAGTCTCGGTC -> AGTCTCGGTCC
CAGTGCCGCCT -> AGTGCCGCCTG
CAGTGGCACTA -> AGTGGCACTAC
CAGTGTACTCA -> AGTGTACTCAA
CAGTGTAGACC -> AGTGTAGACCA
CAGTTAATAAA -> AGTTAATAAAG
CAGTTCTGTCT -> AGTTCTGTCTG
CAGTTTTTGTA -> AGTTTTTGTAA
CATAAATGTAT -> ATAAATGTATC
CATAAGAAACG -> ATAAGAAACGA
CATAAGGAGTG -> ATAAGGAGTGT
CATAATCAAAC -> ATAATCAAACT
CATACATAGCC -> ATACATAGCCG
CATACCGATGG -> ATACCGATGGT
CATAGCCGCAG -> ATAGCCGCAGG
CATATAAAGGG -> ATATAAAGGGT
CATATTGCAGG -> ATATTGCAGGG
CATCACGTCTC -> ATCACGTCTCC
CATCCACAAAT -> ATCCACAAATG
CATCCCGACTG -> ATCCCGACTGG
CATCGATCGCA -> ATCGATCGCAT
CATCGCAGACC -> ATCGCAGACCC
CATCGGTAAGA -> ATCGGTAAGAC
CATCTTCTAAA -> ATCTTCTAAAC
CATGCCTAGAG -> ATGCCTAGAGT
CATGGACGAGA -> ATGGACGAGAC
CATGGGAAAGG -> ATGGGAAAGGG
CATGTGACTTG -> ATGTGACTTGA
CATGTGTTTCT -> ATGTGTTTCTA
CATTAAAACAG -> ATTAAAACAGC
CATTAGGTCTC -> ATTAGGTCTCA
CATTCTTTGTA -> ATTCTTTGTAA
CATTGCTACCA -> ATTGCTACCAC
CATTGGGTGCA -> ATTGGGTGCAA
CATTTAGCAAT -> ATTTAGCAATG
CATTTAGTCGT -> ATTTAGTCGTC
CATTTGAGTGC -> ATTTGAGTGCC
CATTTTACAAC -> ATTTTACAACG
CCAACGGGGTC -> CAACGGGGTCT
CCAACTGGGGG -> CAACTGGGGGG
CCAAGAGATTG -> CAAGAGATTGT
CCAAGCGCAAC -> CAAGCGCAACA
CCAAGCTGAAG -> CAAGCTGAAGG
CCAAGGGGGGT -> CAAGGGGGGTC
CCAATCATCGG -> CAATCATCGGT
CCAATGCAGAA -> CAATGCAGAAA
CCAATGTAGCA -> CAATGTAGCAG
CCACAAATGGT -> CACAAATGGTA
CCACAGTTCTG -> CACAGTTCTGT
CCACCCAGCAC -> CACCCAGCACC
CCACCCGACTC -> CACCCGACTCG
CCACCTGTATA -> CACCTGTATAT
CCACGATAAGG -> CACGATAAGGG
CCACGATGCTA -> CACGATGCTAC
CCACGCGACCT -> CACGCGACCTC
CCACGGAGTGG -> CACGGAGTGGC
CCACGTCTGAC -> CACGTCTGACG
CCACGTTATTC -> CACGTTATTCG
CCACTAGAAAG -> CACTAGAAAGA
CCACTTAGCGC -> CACTTAGCGCA
CCACTTATGCC -> CACTTATGCCG
CCACTTGCCCG -> CACTTGCCCGC
CCAGAATTAGA -> CAGAATTAGAG
CCAGAGACACT -> CAGAGACACTC
CCAGCACCGAC -> CAGCACCGACC
CCAGCATACCG -> CAGCATACCGA
CCAGGATTGAC -> CAGGATTGACG
CCAGTACTGTA -> CAGTACTGTAA
CCAGTCTCGGT -> CAGTCTCGGTC
CCAGTGTAGAC -> CAGTGTAGACC
CCAGTTTTTGT -> CAGTTTTTGTA
CCATAAGGAGT -> CATAAGGAGTG
CCATAATCAAA -> CATAATCAAAC
CCATATTGCAG -> CATATTGCAGG
CCATCGATCGC -> CATCGATCGCA
CCATGCCTAGA -> CATGCCTAGAG
CCATTTAGCAA -> CATTTAGCAAT
CCATTTGAGTG -> CATTTGAGTGC
CCATTTTACAA -> CATTTTACAAC
CCCACGTTATT -> CCACGTTATTC
CCCACTAGAAA -> CCACTAGAAAG
CCCAGCACCGA -> CCAGCACCGAC
CCCAGTGTAGA -> CCAGTGTAGAC
CCCATGCCTAG -> CCATGCCTAGA
CCCATTTGAGT -> CCATTTGAGTG
CCCATTTTACA -> CCATTTTACAA
CCCCATGCCTA -> CCCATGCCTAG
CCCCCATGCCT -> CCCCATGCCTA
CCCCTTCGTAC -> CCCTTCGTACT
CCCGAACATTA -> CCGAACATTAG
CCCGACTCGAA -> CCGACTCGAAA
CCCGACTGGTC -> CCGACTGGTCG
CCCGAGCGCCT -> CCGAGCGCCTG
CCCGCAAAATT -> CCGCAAAATTC
CCCGCCGGTTG -> CCGCCGGTTGC
CCCGCTCGAGA -> CCGCTCGAGAG
CCCGGCCGTCA -> CCGGCCGTCAT
CCCGTTTCCTC -> CCGTTTCCTCG
CCCTAAGCCAG -> CCTAAGCCAGT
CCCTAGATTAT -> CCTAGATTATG
CCCTCAAGAAG -> CCTCAAGAAGT
CCCTCAGAGAT -> CCTCAGAGATT
CCCTTCGTACG -> CCTTCGTACGT
CCCTTCGTACT -> CCTTCGTACTC
CCGAACATTAG -> CGAACATTAGG
CCGAATATAGC -> CGAATATAGCC
CCGAATGAACG -> CGAATGAACGG
CCGAATTCGTT -> CGAATTCGTTT
CCGACCAACTG -> CGACCAACTGG
CCGACTCGAAA -> CGACTCGAAAT
CCGACTGGTCG -> CGACTGGTCGT
CCGAGCGCCTG -> CGAGCGCCTGT
CCGATGGTTCC -> CGATGGTTCCG
CCGCAAAATTC -> CGCAAAATTCA
CCGCAGGTGCA -> CGCAGGTGCAA
CCGCCAACGGG -> CGCCAACGGGG
CCGCCGGTTGC -> CGCCGGTTGCA
CCGCCTGTTAG -> CGCCTGTTAGT
CCGCGCGTATT -> CGCGCGTATTA
CCGCGGAGCGG -> CGCGGAGCGGT
CCGCTCGAGAG -> CGCTCGAGAGC
CCGCTTAGTAG -> CGCTTAGTAGA
CCGGAAGCTGC -> CGGAAGCTGCA
CCGGAGCGGAC -> CGGAGCGGACT
CCGGAGTCATG -> CGGAGTCATGG
CCGGATCGTCT -> CGGATCGTCTT
CCGGCCGTCAT -> CGGCCGTCATC
CCGGCGGTTGG -> CGGCGGTTGGC
CCGGTAAAAGT -> CGGTAAAAGTT
CCGGTCTGCTC -> CGGTCTGCTCG
CCGGTGGGCGA -> CGGTGGGCGAA
CCGGTTAGTAA -> CGGTTAGTAAT
CCGGTTGCACA -> CGGTTGCACAG
CCGGTTGTTCT -> CGGTTGTTCTT
CCGTCAGTTAA -> CGTCAGTTAAT
CCGTCATCCAC -> CGTCATCCACA
CCGTCCAGGAT -> CGTCCAGGATT
CCGTGCCACCC -> CGTGCCACCCG
CCGTTAAAAAC -> CGTTAAAAACT
CCGTTCGCGAG -> CGTTCGCGAGA
CCGTTTCCTCG -> CGTTTCCTCGA
CCTAAACTTGC -> CTAAACTTGCA
CCTAACTTGTG -> CTAACTTGTGG
CCTAAGCCAGT -> CTAAGCCAGTA
CCTACCAATCA -> CTACCAATCAT
CCTACCTAAAC -> CTACCTAAACT
CCTAGAGTTTC -> CTAGAGTTTCA
CCTAGATTATG -> CTAGATTATGC
CCTAGCAGGTC -> CTAGCAGGTCG
CCTAGGGACAC -> CTAGGGACACC
CCTATTTCCAC -> CTATTTCCACA
CCTCAAGAAGT -> CTCAAGAAGTA
CCTCACCCATT -> CTCACCCATTT
CCTCACGGTTA -> CTCACGGTTAA
CCTCAGAGATT -> CTCAGAGATTC
CCTCGAGCACG -> CTCGAGCACGG
CCTCGTGTTCT -> CTCGTGTTCTC
CCTCTCTAAGA -> CTCTCTAAGAG
CCTGAAACTCA -> CTGAAACTCAC
CCTGATTGTGG -> CTGATTGTGGG
CCTGCTCGTAC -> CTGCTCGTACA
CCTGTACACAT -> CTGTACACATC
CCTGTATATGA -> CTGTATATGAA
CCTGTTAGTAG -> CTGTTAGTAGC
CCTTCCTTGAC -> CTTCCTTGACC
CCTTCGTACGT -> CTTCGTACGTA
CCTTCGTACTC -> CTTCGTACTCC
CCTTGACCAAG -> CTTGACCAAGA
CCTTGGCTTAG -> CTTGGCTTAGC
CCTTTGGCGCT -> CTTTGGCGCTC
CGAAACATGTG -> GAAACATGTGT
CGAAATCTGTC -> GAAATCTGTCC
CGAACACCACG -> GAACACCACGA
CGAACATTAGG -> GAACATTAGGT
CGAACCATCGA -> GAACCATCGAT
CGAACCCACTA -> GAACCCACTAG
CGAACGCTTTG -> GAACGCTTTGA
CGAAGCCCGTT -> GAAGCCCGTTT
CGAATATAGCC -> GAATATAGCCC
CGAATGAACGG -> GAATGAACGGG
CGAATTCGTTT -> GAATTCGTTTC
CGACACCGGAA -> GACACCGGAAG
CGACCAACTGG -> GACCAACTGGG
CGACCAATGTA -> GACCAATGTAG
CGACCTCTCTA -> GACCTCTCTAA
CGACGAGGCAA -> GACGAGGCAAA
CGACGTAGCCT -> GACGTAGCCTG
CGACTCGAAAT -> GACTCGAAATC
CGACTGGTCGT -> GACTGGTCGTT
CGAGACCGGTG -> GAGACCGGTGG
CGAGACGCGGC -> GAGACGCGGCT
CGAGAGCGTCA -> GAGAGCGTCAC
CGAGCACGGTG -> GAGCACGGTGA
CGAGCGCCTGT -> GAGCGCCTGTA
CGAGGACGACC -> GAGGACGACCA
CGAGGCAAAGG -> GAGGCAAAGGT
CGAGGGCTGAA -> GAGGGCTGAAT
CGATAAGGGAC -> GATAAGGGACG
CGATAGTGGAT -> GATAGTGGATG
CGATCGCATGG -> GATCGCATGGA
CGATGCACTCG -> GATGCACTCGC
CGATGCTACAA -> GATGCTACAAA
CGATGGCTGGC -> GATGGCTGGCC
CGATGGTTCCG -> GATGGTTCCGT
CGATTCGCAGA -> GATTCGCAGAG
CGCAAAATTCA -> GCAAAATTCAT
CGCAAACACCC -> GCAAACACCCC
CGCAACACCCG -> GCAACACCCGC
CGCAAGTCTTA -> GCAAGTCTTAT
CGCACCAGCAT -> GCACCAGCATA
CGCACCCCTTC -> GCACCCCTTCG
CGCAGACCCTC -> GCAGACCCTCA
CGCAGAGTTAC -> GCAGAGTTACG
CGCAGGTGCAA -> GCAGGTGCAAT
CGCATGGACGA -> GCATGGACGAG
CGCCAACGGGG -> GCCAACGGGGT
CGCCGGTTGCA -> GCCGGTTGCAC
CGCCTGTACAC -> GCCTGTACACA
CGCCTGTTAGT -> GCCTGTTAGTA
CGCGAACCATC -> GCGAACCATCG
CGCGAACGCTT -> GCGAACGCTTT
CGCGACCTCTC -> GCGACCTCTCT
CGCGAGACGCG -> GCGAGACGCGG
CGCGCAAGTCT -> GCGCAAGTCTT
CGCGCGTATTA -> GCGCGTATTAA
CGCGGAGCGGT -> GCGGAGCGGTG
CGCGGCTGCTG -> GCGGCTGCTGG
CGCGTATTAAT -> GCGTATTAATG
CGCGTGTGTAC -> GCGTGTGTACC
CGCTCCCGGCC -> GCTCCCGGCCG
CGCTCGAGAGC -> GCTCGAGAGCG
CGCTCTGACAT -> GCTCTGACATC
CGCTGGGATTC -> GCTGGGATTCA
CGCTTACCATA -> GCTTACCATAA
CGCTTAGTAGA -> GCTTAGTAGAA
CGCTTTGACCT -> GCTTTGACCTT
CGGAAGCTGCA -> GGAAGCTGCAA
CGGACACGGCA -> GGACACGGCAC
CGGACTATCTT -> GGACTATCTTG
CGGAGCGGACT -> GGAGCGGACTA
CGGAGCGGTGT -> GGAGCGGTGTG
CGGAGTCATGG -> GGAGTCATGGG
CGGAGTGGCGC -> GGAGTGGCGCG
CGGAGTTGGCG -> GGAGTTGGCGT
CGGATCGTCTT -> GGATCGTCTTC
CGGCACTCCGA -> GGCACTCCGAA
CGGCCGTCATC -> GGCCGTCATCC
CGGCCTCACGG -> GGCCTCACGGT
CGGCCTGAAAC -> GGCCTGAAACT
CGGCGGTTGGC -> GGCGGTTGGCA
CGGCTGCTGGG -> GGCTGCTGGGA
CGGGCCGTCCA -> GGGCCGTCCAG
CGGGGCCACTT -> GGGGCCACTTA
CGGGGTCTGCT -> GGGGTCTGCTC
CGGTAAAAGTT -> GGTAAAAGTTG
CGGTAAGACGT -> GGTAAGACGTA
CGGTAATCGTC -> GGTAATCGTCT
CGGTAATTGGT -> GGTAATTGGTC
CGGTACCAAGC -> GGTACCAAGCT
CGGTCCGCCAA -> GGTCCGCCAAC
CGGTCTGCTCG -> GGTCTGCTCGT
CGGTGAATGAA -> GGTGAATGAAC
CGGTGGGCGAA -> GGTGGGCGAAG
CGGTGGTGCTT -> GGTGGTGCTTG
CGGTGTGACTT -> GGTGTGACTTC
CGGTTAAATCA -> GGTTAAATCAA
CGGTTAACATA -> GGTTAACATAC
CGGTTAGTAAT -> GGTTAGTAATA
CGGTTCCACGA -> GGTTCCACGAT
CGGTTGCACAG -> GGTTGCACAGT
CGGTTGGCAAG -> GGTTGGCAAGG
CGGTTGTTCTT -> GGTTGTTCTTT
CGTACAGATCG -> GTACAGATCGA
CGTACATTCTT -> GTACATTCTTT
CGTACCCTAAG -> GTACCCTAAGC
CGTACGTACCC -> GTACGTACCCT
CGTACTCCAGA -> GTACTCCAGAG
CGTACTTCCAG -> GTACTTCCAGT
CGTAGCCTGAT -> GTAGCCTGATT
CGTATTAATGT -> GTATTAATGTC
CGTCACCGGAG -> GTCACCGGAGT
CGTCAGTTAAT -> GTCAGTTAATA
CGTCATCCACA -> GTCATCCACAA
CGTCCAGGATT -> GTCCAGGATTG
CGTCTCCCGCA -> GTCTCCCGCAA
CGTCTGACGTT -> GTCTGACGTTT
CGTCTTCACCA -> GTCTTCACCAG
CGTCTTCACCC -> GTCTTCACCCA
CGTCTTGAATA -> GTCTTGAATAT
CGTGCCACCCG -> GTGCCACCCGA
CGTGCCTTCCT -> GTGCCTTCCTT
CGTGGCAATCT -> GTGGCAATCTC
CGTGGTCCGAA -> GTGGTCCGAAT
CGTGTGTACCG -> GTGTGTACCGC
CGTGTTCTCAT -> GTGTTCTCATG
CGTTAAAAACT -> GTTAAAAACTC
CGTTATTCGCT -> GTTATTCGCTC
CGTTCGCGAGA -> GTTCGCGAGAC
CGTTGGACAGT -> GTTGGACAGTG
CGTTTAGATCT -> GTTTAGATCTA
CGTTTCCCATT -> GTTTCCCATTT
CGTTTCCGGCG -> GTTTCCGGCGG
CGTTTCCTCGA -> GTTTCCTCGAG
CTAAACCGCTT -> TAAACCGCTTA
CTAAACTTGCA -> TAAACTTGCAA
CTAACTTGTGG -> TAACTTGTGGG
CTAAGAGCACA -> TAAGAGCACAA
CTAAGAGGAGT -> TAAGAGGAGTG
CTAAGCCAGTA -> TAAGCCAGTAC
CTACAAAGTCC -> TACAAAGTCCC
CTACAGGAATA -> TACAGGAATAT
CTACCAATCAT -> TACCAATCATC
CTACCACGGAG -> TACCACGGAGT
CTACCACTTAT -> TACCACTTATG
CTACCTAAACT -> TACCTAAACTT
CTAGAAAGATA -> TAGAAAGATAC
CTAGAGTTTCA -> TAGAGTTTCAC
CTAGATTATGC -> TAGATTATGCC
CTAGATTGCGC -> TAGATTGCGCT
CTAGCAGGTCG -> TAGCAGGTCGC
CTAGGGACACC -> TAGGGACACCT
CTATCTTGAGC -> TATCTTGAGCA
CTATGAGTGCA -> TATGAGTGCAT
CTATTTCCACA -> TATTTCCACAG
CTCAACCTATT -> TCAACCTATTT
CTCAAGAAGTA -> TCAAGAAGTAA
CTCAATTTATC -> TCAATTTATCT
CTCAATTTCAA -> TCAATTTCAAT
CTCACCCATTT -> TCACCCATTTT
CTCACCGAATT -> TCACCGAATTC
CTCACGGTTAA -> TCACGGTTAAC
CTCAGAGATTC -> TCAGAGATTCA
CTCATAAATGT -> TCATAAATGTA
CTCATGTGACT -> TCATGTGACTT
CTCATTAAAAC -> TCATTAAAACA
CTCCAGAGACA -> TCCAGAGACAC
CTCCCGCAAAA -> TCCCGCAAAAT
CTCCCGGCCGT -> TCCCGGCCGTC
CTCCGAATATA -> TCCGAATATAG
CTCCGGATCGT -> TCCGGATCGTC
CTCCGGTTGTT -> TCCGGTTGTTC
CTCCTAGCAGG -> TCCTAGCAGGT
CTCGAAATCTG -> TCGAAATCTGT
CTCGAGAGCGT -> TCGAGAGCGTC
CTCGAGCACGG -> TCGAGCACGGT
CTCGCTGGGAT -> TCGCTGGGATT
CTCGGTCCGCC -> TCGGTCCGCCA
CTCGTACAGAT -> TCGTACAGATC
CTCGTACATTC -> TCGTACATTCT
CTCGTGTTCTC -> TCGTGTTCTCA
CTCTAAGAGCA -> TCTAAGAGCAC
CTCTCTAAGAG -> TCTCTAAGAGC
CTCTGACATCG -> TCTGACATCGC
CTGAAACTCAC -> TGAAACTCACC
CTGAAGGCAAG -> TGAAGGCAAGG
CTGAATTTACA -> TGAATTTACAA
CTGACATCGCA -> TGACATCGCAG
CTGACGTTTAG -> TGACGTTTAGA
CTGATACACGA -> TGATACACGAT
CTGATTGTGGG -> TGATTGTGGGA
CTGCAAGTCCC -> TGCAAGTCCCT
CTGCAATCCGT -> TGCAATCCGTT
CTGCGATTCGC -> TGCGATTCGCA
CTGCTCCTAGC -> TGCTCCTAGCA
CTGCTCGTACA -> TGCTCGTACAG,TGCTCGTACAT
CTGCTGGGATG -> TGCTGGGATGT
CTGGAGGTCCC -> TGGAGGTCCCG
CTGGCCAATGC -> TGGCCAATGCA
CTGGCGATGCA -> TGGCGATGCAC
CTGGGATGTGT -> TGGGATGTGTA
CTGGGATTCAC -> TGGGATTCACC
CTGGGGGGACG -> TGGGGGGACGA
CTGGTCGTTGG -> TGGTCGTTGGA
CTGTAATTATT -> TGTAATTATTC
CTGTACACATC -> TGTACACATCT
CTGTATATGAA -> TGTATATGAAA
CTGTCCACCCA -> TGTCCACCCAG
CTGTCGATAGT -> TGTCGATAGTG
CTGTCTGCAAG -> TGTCTGCAAGT
CTGTTAGTAGC -> TGTTAGTAGCC
CTGTTTTCGAG -> TGTTTTCGAGG
CTTACACTACC -> TTACACTACCA
CTTACCATAAG -> TTACCATAAGG
CTTAGCGCACC -> TTAGCGCACCA
CTTAGCTCATA -> TTAGCTCATAA
CTTAGTAGAAT -> TTAGTAGAATA
CTTATCCTTGG -> TTATCCTTGGC
CTTATCGGACA -> TTATCGGACAC
CTTATGCCGTG -> TTATGCCGTGC
CTTCACCAGAA -> TTCACCAGAAT
CTTCACCCAGT -> TTCACCCAGTG
CTTCCAGTTTT -> TTCCAGTTTTT
CTTCCATTTAG -> TTCCATTTAGC
CTTCCTTGACC -> TTCCTTGACCA
CTTCGCGAACC -> TTCGCGAACCA
CTTCGTACGTA -> TTCGTACGTAC
CTTCGTACTCC -> TTCGTACTCCA
CTTCTAAACCG -> TTCTAAACCGC
CTTGAATATTG -> TTGAATATTGG
CTTGACCAAGA -> TTGACCAAGAG
CTTGAGCATTG -> TTGAGCATTGG
CTTGAGGGCGC -> TTGAGGGCGCG
CTTGCAAATAG -> TTGCAAATAGT
CTTGCCCGCTC -> TTGCCCGCTCG
CTTGGCTTAGC -> TTGGCTTAGCT
CTTGGTACCCA -> TTGGTACCCAC
CTTGTGGGGGG -> TTGTGGGGGGG
CTTTAGCGCGC -> TTTAGCGCGCA
CTTTATTTCCC -> TTTATTTCCCT
CTTTGACCTTT -> TTTGACCTTTG
CTTTGGCGCTC -> TTTGGCGCTCT
CTTTGTAAGTC -> TTTGTAAGTCG
GAAAAACAGCT -> AAAAACAGCTG
GAAACAACCGG -> AAACAACCGGT
GAAACATGTGT -> AAACATGTGTT
GAAACGAACAC -> AAACGAACACC
GAAACTCACCG -> AAACTCACCGA
GAAAGATACCT -> AAAGATACCTA
GAAAGGGTGAA -> AAAGGGTGAAA
GAAAGTGTTTA -> AAAGTGTTTAC
GAAATCTGTCC -> AAATCTGTCCA
GAACACCACGA -> AACACCACGAT
GAACACCGTTA -> AACACCGTTAA
GAACATTAGGT -> AACATTAGGTC
GAACCATCGAT -> AACCATCGATC
GAACCCACTAG -> AACCCACTAGA
GAACGCTTTGA -> AACGCTTTGAC
GAACGGGGCCA -> AACGGGGCCAC
GAAGCCCGTTT -> AAGCCCGTTTC
GAAGCTGCAAT -> AAGCTGCAATC
GAAGGCAAGGG -> AAGGCAAGGGG
GAAGTAAACCA -> AAGTAAACCAA
GAATATACCGG -> AATATACCGGT
GAATATAGCCC -> AATATAGCCCT
GAATATTCGAA -> AATATTCGAAA
GAATATTGGCT -> AATATTGGCTT
GAATGAACACC -> AATGAACACCG
GAATGAACGGG -> AATGAACGGGG
GAATTAGAGAC -> AATTAGAGACA
GAATTCGTTTC -> AATTCGTTTCC
GAATTTACAAG -> AATTTACAAGC
GACACCGGAAG -> ACACCGGAAGC
GACACCTACCT -> ACACCTACCTA
GACACGGCACT -> ACACGGCACTC
GACACTCCGGT -> ACACTCCGGTT
GACAGTACCGG -> ACAGTACCGGT
GACAGTGGCAC -> ACAGTGGCACT
GACATCGCAGA -> ACATCGCAGAC
GACATTGCTAC -> ACATTGCTACC
GACCAACTGGG -> ACCAACTGGGG
GACCAAGAGAT -> ACCAAGAGATT
GACCAATGTAG -> ACCAATGTAGC
GACCATAATCA -> ACCATAATCAA
GACCATATTGC -> ACCATATTGCA
GACCCTCAGAG -> ACCCTCAGAGA
GACCGGTGGGC -> ACCGGTGGGCG
GACCTAGGGAC -> ACCTAGGGACA
GACCTCTCTAA -> ACCTCTCTAAG
GACCTTTGGCG -> ACCTTTGGCGC
GACGACCAATG -> ACGACCAATGT
GACGACGTAGC -> ACGACGTAGCC
GACGAGACCGG -> ACGAGACCGGT
GACGAGGCAAA -> ACGAGGCAAAG
GACGAGGGCTG -> ACGAGGGCTGA
GACGCGGCTGC -> ACGCGGCTGCT
GACGGAGTTGG -> ACGGAGTTGGC
GACGGTGGTGC -> ACGGTGGTGCT
GACGGTTAAAT -> ACGGTTAAATC
GACGTACTTCC -> ACGTACTTCCA
GACGTAGCCTG -> ACGTAGCCTGA
GACGTTTAGAT -> ACGTTTAGATC
GACTATCTTGA -> ACTATCTTGAG
GACTCGAAATC -> ACTCGAAATCT
GACTGGTCGTT -> ACTGGTCGTTG
GACTTACACTA -> ACTTACACTAC
GACTTCGCGAA -> ACTTCGCGAAC
GACTTGAGGGC -> ACTTGAGGGCG
GAGACACTCCG -> AGACACTCCGG
GAGACATTGCT -> AGACATTGCTA
GAGACCGGTGG -> AGACCGGTGGG
GAGACGCGGCT -> AGACGCGGCTG
GAGAGAGTAAG -> AGAGAGTAAGA
GAGAGCGTCAC -> AGAGCGTCACC
GAGAGTAAGAG -> AGAGTAAGAGG
GAGATTCATCC -> AGATTCATCCC
GAGATTGTCTC -> AGATTGTCTCA
GAGCACAACTA -> AGCACAACTAT
GAGCACCTGCT -> AGCACCTGCTC
GAGCACGGTGA -> AGCACGGTGAA
GAGCATTGGGT -> AGCATTGGGTG
GAGCGCCTGTA -> AGCGCCTGTAC
GAGCGGACTAT -> AGCGGACTATC
GAGCGGTGTGA -> AGCGGTGTGAC
GAGCGTCACCG -> AGCGTCACCGG
GAGGACGACCA -> AGGACGACCAA
GAGGAGTGACA -> AGGAGTGACAG
GAGGCAAAGGT -> AGGCAAAGGTC
GAGGGACTTAC -> AGGGACTTACA
GAGGGCGCGTG -> AGGGCGCGTGT
GAGGGCTGAAT -> AGGGCTGAATT
GAGGTCCCGAG -> AGGTCCCGAGC
GAGTAAGAGGG -> AGTAAGAGGGA
GAGTCATGGGA -> AGTCATGGGAA
GAGTGACAGTA -> AGTGACAGTAC
GAGTGCATCAC -> AGTGCATCACG
GAGTGCCACGT -> AGTGCCACGTC
GAGTGGCGCGA -> AGTGGCGCGAA
GAGTGTTCTCG -> AGTGTTCTCGC
GAGTTACGGCC -> AGTTACGGCCT
GAGTTGGCGTT -> AGTTGGCGTTT
GAGTTTCACGG -> AGTTTCACGGT
GATAAGGGACG -> ATAAGGGACGG
GATACACGATG -> ATACACGATGG
GATACCTACCA -> ATACCTACCAA
GATAGGCCAAG -> ATAGGCCAAGC
GATAGTGGATG -> ATAGTGGATGC
GATCCACTTGC -> ATCCACTTGCC
GATCGAACCCA -> ATCGAACCCAC
GATCGCATGGA -> ATCGCATGGAC
GATCGTCTTCA -> ATCGTCTTCAC
GATCTAAGAGG -> ATCTAAGAGGA
GATGCCAGTCT -> ATGCCAGTCTC
GATGCTACAAA -> ATGCTACAAAG
GATGGCTGGCC -> ATGGCTGGCCA
GATGGTTCCGT -> ATGGTTCCGTC
GATGTGTAACA -> ATGTGTAACAT
GATTATGCCTC -> ATTATGCCTCA
GATTCACCACC -> ATTCACCACCT
GATTCATCCCG -> ATTCATCCCGA
GATTCGCAGAG -> ATTCGCAGAGT
GATTGACGAGG -> ATTGACGAGGG
GATTGCGCTTA -> ATTGCGCTTAC
GATTGTCTCAT -> ATTGTCTCATT
GATTGTGGGAC -> ATTGTGGGACC
GCAAAATTCAT -> CAAAATTCATA
GCAAACACCCC -> CAAACACCCCC
GCAAAGGTCTG -> CAAAGGTCTGT
GCAAATAGTGG -> CAAATAGTGGG
GCAACACCCGC -> CAACACCCGCC
GCAACAGACCA -> CAACAGACCAT
GCAAGGCTTAT -> CAAGGCTTATC
GCAAGGGGTTA -> CAAGGGGTTAG
GCAAGTCCCTC -> CAAGTCCCTCA
GCAAGTCTTAT -> CAAGTCTTATC
GCAATCCGTTC -> CAATCCGTTCG
GCAATCTCAAT -> CAATCTCAATT
GCAATGAGAGA -> CAATGAGAGAG
GCAATGCGGGC -> CAATGCGGGCC
GCACAACTATG -> CACAACTATGA
GCACAGTGTAC -> CACAGTGTACT
GCACCAGCATA -> CACCAGCATAC
GCACCCCTTCG -> CACCCCTTCGT
GCACCGACCAA -> CACCGACCAAC
GCACCTAACTT -> CACCTAACTTG
GCACCTGCTCG -> CACCTGCTCGT
GCACGGTGAAT -> CACGGTGAATG
GCACTACAGGA -> CACTACAGGAA
GCACTCCGAAT -> CACTCCGAATA
GCAGAAACAAC -> CAGAAACAACC
GCAGACCCTCA -> CAGACCCTCAG
GCAGAGTTACG -> CAGAGTTACGG
GCAGGATCCAC -> CAGGATCCACT
GCAGGGCTTCC -> CAGGGCTTCCA
GCAGGTCGCAC -> CAGGTCGCACC
GCAGGTGCAAT -> CAGGTGCAATG
GCATACCGATG -> CATACCGATGG
GCATCACGTCT -> CATCACGTCTC
GCATGGACGAG -> CATGGACGAGA
GCATTGGGTGC -> CATTGGGTGCA
GCCAACGGGGT -> CCAACGGGGTC
GCCAAGCGCAA -> CCAAGCGCAAC
GCCAATGCAGA -> CCAATGCAGAA
GCCACCCGACT -> CCACCCGACTC
GCCACGCGACC -> CCACGCGACCT
GCCACGTCTGA -> CCACGTCTGAC
GCCACTTAGCG -> CCACTTAGCGC
GCCAGTACTGT -> CCAGTACTGTA
GCCAGTCTCGG -> CCAGTCTCGGT
GCCCGCTCGAG -> CCCGCTCGAGA
GCCCGTTTCCT -> CCCGTTTCCTC
GCCCTAGATTA -> CCCTAGATTAT
GCCGCAGGTGC -> CCGCAGGTGCA
GCCGCCTGTTA -> CCGCCTGTTAG
GCCGGAGCGGA -> CCGGAGCGGAC
GCCGGTTGCAC -> CCGGTTGCACA
GCCGTCATCCA -> CCGTCATCCAC
GCCGTCCAGGA -> CCGTCCAGGAT
GCCGTGCCACC -> CCGTGCCACCC
GCCTAGAGTTT -> CCTAGAGTTTC
GCCTCACCCAT -> CCTCACCCATT
GCCTCACGGTT -> CCTCACGGTTA
GCCTGAAACTC -> CCTGAAACTCA
GCCTGATTGTG -> CCTGATTGTGG
GCCTGTACACA -> CCTGTACACAT
GCCTGTTAGTA -> CCTGTTAGTAG
GCCTTCCTTGA -> CCTTCCTTGAC
GCGAACCATCG -> CGAACCATCGA
GCGAACGCTTT -> CGAACGCTTTG
GCGAAGCCCGT -> CGAAGCCCGTT
GCGACCTCTCT -> CGACCTCTCTA
GCGAGACGCGG -> CGAGACGCGGC
GCGATGCACTC -> CGATGCACTCG
GCGATTCGCAG -> CGATTCGCAGA
GCGCAACACCC -> CGCAACACCCG
GCGCAAGTCTT -> CGCAAGTCTTA
GCGCACCAGCA -> CGCACCAGCAT
GCGCCTGTACA -> CGCCTGTACAC
GCGCGAACGCT -> CGCGAACGCTT
GCGCGCAAGTC -> CGCGCAAGTCT
GCGCGTATTAA -> CGCGTATTAAT
GCGCGTGTGTA -> CGCGTGTGTAC
GCGCTCTGACA -> CGCTCTGACAT
GCGCTTACCAT -> CGCTTACCATA
GCGGACTATCT -> CGGACTATCTT
GCGGAGCGGTG -> CGGAGCGGTGT
GCGGCTGCTGG -> CGGCTGCTGGG
GCGGGCCGTCC -> CGGGCCGTCCA
GCGGTGTGACT -> CGGTGTGACTT
GCGGTTGGCAA -> CGGTTGGCAAG
GCGTATTAATG -> CGTATTAATGT
GCGTCACCGGA -> CGTCACCGGAG
GCGTGGCAATC -> CGTGGCAATCT
GCGTGTGTACC -> CGTGTGTACCG
GCGTTTCCCAT -> CGTTTCCCATT
GCTACAAAGTC -> CTACAAAGTCC
GCTACCACTTA -> CTACCACTTAT
GCTCATAAATG -> CTCATAAATGT
GCTCCCGGCCG -> CTCCCGGCCGT
GCTCCTAGCAG -> CTCCTAGCAGG
GCTCGAGAGCG -> CTCGAGAGCGT
GCTCGTACAGA -> CTCGTACAGAT
GCTCGTACATT -> CTCGTACATTC
GCTCTGACATC -> CTCTGACATCG
GCTGAAGGCAA -> CTGAAGGCAAG
GCTGAATTTAC -> CTGAATTTACA
GCTGCAATCCG -> CTGCAATCCGT
GCTGCTGGGAT -> CTGCTGGGATG
GCTGGCCAATG -> CTGGCCAATGC
GCTGGCGATGC -> CTGGCGATGCA
GCTGGGATGTG -> CTGGGATGTGT
GCTGGGATTCA -> CTGGGATTCAC
GCTGTTTTCGA -> CTGTTTTCGAG
GCTTACCATAA -> CTTACCATAAG
GCTTAGCTCAT -> CTTAGCTCATA
GCTTAGTAGAA -> CTTAGTAGAAT
GCTTATCGGAC -> CTTATCGGACA
GCTTCCATTTA -> CTTCCATTTAG
GCTTGGTACCC -> CTTGGTACCCA
GCTTTAGCGCG -> CTTTAGCGCGC
GCTTTGACCTT -> CTTTGACCTTT
GGAAAGGGTGA -> GAAAGGGTGAA
GGAAGCTGCAA -> GAAGCTGCAAT
GGAATATACCG -> GAATATACCGG
GGACACCTACC -> GACACCTACCT
GGACACGGCAC -> GACACGGCACT
GGACAGTGGCA -> GACAGTGGCAC
GGACCTAGGGA -> GACCTAGGGAC
GGACGACCAAT -> GACGACCAATG
GGACGACGTAG -> GACGACGTAGC
GGACGAGACCG -> GACGAGACCGG
GGACGGAGTTG -> GACGGAGTTGG
GGACGGTTAAA -> GACGGTTAAAT
GGACTATCTTG -> GACTATCTTGA
GGACTTACACT -> GACTTACACTA
GGAGCACCTGC -> GAGCACCTGCT
GGAGCGGACTA -> GAGCGGACTAT
GGAGCGGTGTG -> GAGCGGTGTGA
GGAGGTCCCGA -> GAGGTCCCGAG
GGAGTCATGGG -> GAGTCATGGGA
GGAGTGACAGT -> GAGTGACAGTA
GGAGTGGCGCG -> GAGTGGCGCGA
GGAGTGTTCTC -> GAGTGTTCTCG
GGAGTTGGCGT -> GAGTTGGCGTT
GGATCCACTTG -> GATCCACTTGC
GGATCGTCTTC -> GATCGTCTTCA
GGATGCCAGTC -> GATGCCAGTCT
GGATGTGTAAC -> GATGTGTAACA
GGATTCACCAC -> GATTCACCACC
GGATTGACGAG -> GATTGACGAGG
GGCAAAGGTCT -> GCAAAGGTCTG
GGCAAGGCTTA -> GCAAGGCTTAT
GGCAAGGGGTT -> GCAAGGGGTTA
GGCAATCTCAA -> GCAATCTCAAT
GGCACTACAGG -> GCACTACAGGA
GGCACTCCGAA -> GCACTCCGAAT
GGCCAAGCGCA -> GCCAAGCGCAA
GGCCAATGCAG -> GCCAATGCAGA
GGCCACTTAGC -> GCCACTTAGCG
GGCCGTCATCC -> GCCGTCATCCA
GGCCGTCCAGG -> GCCGTCCAGGA
GGCCTCACGGT -> GCCTCACGGTT
GGCCTGAAACT -> GCCTGAAACTC
GGCGAAGCCCG -> GCGAAGCCCGT
GGCGATGCACT -> GCGATGCACTC
GGCGCGAACGC -> GCGCGAACGCT
GGCGCGTGTGT -> GCGCGTGTGTA
GGCGCTCTGAC -> GCGCTCTGACA
GGCGGTTGGCA -> GCGGTTGGCAA
GGCGTTTCCCA -> GCGTTTCCCAT
GGCTGAATTTA -> GCTGAATTTAC
GGCTGCTGGGA -> GCTGCTGGGAT
GGCTGGCCAAT -> GCTGGCCAATG
GGCTTAGCTCA -> GCTTAGCTCAT
GGCTTATCGGA -> GCTTATCGGAC
GGCTTCCATTT -> GCTTCCATTTA
GGCTTTAGCGC -> GCTTTAGCGCG
GGGAAAGGGTG -> GGAAAGGGTGA
GGGACACCTAC -> GGACACCTACC
GGGACCTAGGG -> GGACCTAGGGA
GGGACGACGTA -> GGACGACGTAG
GGGACGGAGTT -> GGACGGAGTTG
GGGACGGTTAA -> GGACGGTTAAA
GGGACTTACAC -> GGACTTACACT
GGGATGTGTAA -> GGATGTGTAAC
GGGATTCACCA -> GGATTCACCAC
GGGCCACTTAG -> GGCCACTTAGC
GGGCCGTCCAG -> GGCCGTCCAGG
GGGCGAAGCCC -> GGCGAAGCCCG
GGGCGCGTGTG -> GGCGCGTGTGT
GGGCTGAATTT -> GGCTGAATTTA
GGGCTTCCATT -> GGCTTCCATTT
GGGGACGACGT -> GGGACGACGTA
GGGGCCACTTA -> GGGCCACTTAG
GGGGGACGACG -> GGGGACGACGT
GGGGGGACGAC -> GGGGGACGACG
GGGGGGGTGCT -> GGGGGGTGCTG
GGGGGGTCGCA -> GGGGGTCGCAA
GGGGGGTGCTG -> GGGGGTGCTGT
GGGGGTCGCAA -> GGGGTCGCAAA
GGGGGTGCTGT -> GGGGTGCTGTT
GGGGTCGCAAA -> GGGTCGCAAAC
GGGGTCTGCTC -> GGGTCTGCTCC
GGGGTGCTGTT -> GGGTGCTGTTT
GGGGTTAGGAG -> GGGTTAGGAGC
GGGTACGGTAA -> GGTACGGTAAT
GGGTCCTCGTG -> GGTCCTCGTGT
GGGTCGCAAAC -> GGTCGCAAACA
GGGTCTGCTCC -> GGTCTGCTCCT
GGGTGAAAGTG -> GGTGAAAGTGT
GGGTGCAACAG -> GGTGCAACAGA
GGGTGCTGTTT -> GGTGCTGTTTT
GGGTTAGGAGC -> GGTTAGGAGCA
GGTAAAAGTTG -> GTAAAAGTTGA
GGTAAACCGCG -> GTAAACCGCGC
GGTAAGACGTA -> GTAAGACGTAC
GGTAATCGTCT -> GTAATCGTCTT
GGTAATTGGTC -> GTAATTGGTCT
GGTACCAAGCT -> GTACCAAGCTG
GGTACCCACGT -> GTACCCACGTT
GGTACGGTAAT -> GTACGGTAATT
GGTCCCGAGCG -> GTCCCGAGCGC
GGTCCGAATGA -> GTCCGAATGAA
GGTCCGCCAAC -> GTCCGCCAACG
GGTCCTCGTGT -> GTCCTCGTGTT
GGTCGCAAACA -> GTCGCAAACAC
GGTCGCACCCC -> GTCGCACCCCT
GGTCGTTGGAC -> GTCGTTGGACA
GGTCTCAACCT -> GTCTCAACCTA
GGTCTGATACA -> GTCTGATACAC
GGTCTGCTCCT -> GTCTGCTCCTA
GGTCTGCTCGT -> GTCTGCTCGTA
GGTCTGTCGAT -> GTCTGTCGATA
GGTGAAAGTGT -> GTGAAAGTGTT
GGTGAATGAAC -> GTGAATGAACA
GGTGCAACAGA -> GTGCAACAGAC
GGTGCAATGCG -> GTGCAATGCGG
GGTGCTGTTTT -> GTGCTGTTTTC
GGTGCTTGGTA -> GTGCTTGGTAC
GGTGGGCGAAG -> GTGGGCGAAGC
GGTGGTGCTTG -> GTGGTGCTTGG
GGTGTGACTTC -> GTGTGACTTCG
GGTTAAATCAA -> GTTAAATCAAG
GGTTAACATAC -> GTTAACATACA
GGTTAGGAGCA -> GTTAGGAGCAC
GGTTAGTAATA -> GTTAGTAATAT
GGTTCCACGAT -> GTTCCACGATA
GGTTCCGTCAG -> GTTCCGTCAGT
GGTTGCACAGT -> GTTGCACAGTG
GGTTGGCAAGG -> GTTGGCAAGGC
GGTTGTTCTTT -> GTTGTTCTTTA
GTAAAAGTTGA -> TAAAAGTTGAT
GTAAACCAAGG -> TAAACCAAGGG
GTAAACCGCGC -> TAAACCGCGCG
GTAACATATAA -> TAACATATAAA
GTAACGTGGTC -> TAACGTGGTCC
GTAAGACGTAC -> TAAGACGTACT
GTAAGAGGGAC -> TAAGAGGGACT
GTAAGTCGACA -> TAAGTCGACAC
GTAATATTCAT -> TAATATTCATT
GTAATCGTCTT -> TAATCGTCTTG
GTAATTATTCG -> TAATTATTCGG
GTAATTGGTCT -> TAATTGGTCTG
GTACACATCTT -> TACACATCTTC
GTACAGATCGA -> TACAGATCGAA
GTACATTCTTT -> TACATTCTTTG
GTACCAAGCTG -> TACCAAGCTGA
GTACCCACGTT -> TACCCACGTTA
GTACCCTAAGC -> TACCCTAAGCC
GTACCGCGGAG -> TACCGCGGAGC
GTACCGGTCTG -> TACCGGTCTGC
GTACGGTAATT -> TACGGTAATTG
GTACGTACCCT -> TACGTACCCTA
GTACTCAATTT -> TACTCAATTTA
GTACTCCAGAG -> TACTCCAGAGA
GTACTGTAATT -> TACTGTAATTA
GTACTTCCAGT -> TACTTCCAGTT
GTAGAATATTC -> TAGAATATTCG
GTAGACCATAA -> TAGACCATAAT
GTAGCAGGATC -> TAGCAGGATCC
GTAGCCACGCG -> TAGCCACGCGA
GTAGCCTGATT -> TAGCCTGATTG
GTATATGAAAA -> TATATGAAAAA
GTATCGACGAG -> TATCGACGAGG
GTATTAATGTC -> TATTAATGTCG
GTCACCGGAGT -> TCACCGGAGTC
GTCAGTTAATA -> TCAGTTAATAA
GTCATCCACAA -> TCATCCACAAA
GTCATGGGAAA -> TCATGGGAAAG
GTCCACCCAGC -> TCCACCCAGCA
GTCCAGGATTG -> TCCAGGATTGA
GTCCCGAACAT -> TCCCGAACATT
GTCCCGAGCGC -> TCCCGAGCGCC
GTCCCTCAAGA -> TCCCTCAAGAA
GTCCGAATGAA -> TCCGAATGAAC
GTCCGCCAACG -> TCCGCCAACGG
GTCCTCGTGTT -> TCCTCGTGTTC
GTCGACACCGG -> TCGACACCGGA
GTCGATAGTGG -> TCGATAGTGGA
GTCGCAAACAC -> TCGCAAACACC
GTCGCACCCCT -> TCGCACCCCTT
GTCGGTAATCG -> TCGGTAATCGT
GTCGTCTTCAC -> TCGTCTTCACC
GTCGTTGGACA -> TCGTTGGACAG
GTCTCAACCTA -> TCTCAACCTAT
GTCTCATTAAA -> TCTCATTAAAA
GTCTCCCGCAA -> TCTCCCGCAAA
GTCTCGGTCCG -> TCTCGGTCCGC
GTCTGACGTTT -> TCTGACGTTTA
GTCTGATACAC -> TCTGATACACG
GTCTGCAAGTC -> TCTGCAAGTCC
GTCTGCTCCTA -> TCTGCTCCTAG
GTCTGCTCGTA -> TCTGCTCGTAC
GTCTGTCGATA -> TCTGTCGATAG
GTCTTATCCTT -> TCTTATCCTTG
GTCTTCACCAG -> TCTTCACCAGA
GTCTTCACCCA -> TCTTCACCCAG
GTCTTGAATAT -> TCTTGAATATT
GTGAAAGTGTT -> TGAAAGTGTTT
GTGAATGAACA -> TGAATGAACAC
GTGACAGTACC -> TGACAGTACCG
GTGACTTCGCG -> TGACTTCGCGA
GTGACTTGAGG -> TGACTTGAGGG
GTGCAACAGAC -> TGCAACAGACC
GTGCAATGCGG -> TGCAATGCGGG
GTGCATCACGT -> TGCATCACGTC
GTGCCACCCGA -> TGCCACCCGAC
GTGCCACGTCT -> TGCCACGTCTG
GTGCCGCCTGT -> TGCCGCCTGTT
GTGCCTTCCTT -> TGCCTTCCTTG
GTGCTGTTTTC -> TGCTGTTTTCG
GTGCTTGGTAC -> TGCTTGGTACC
GTGGATGCCAG -> TGGATGCCAGT
GTGGCAATCTC -> TGGCAATCTCA
GTGGCACTACA -> TGGCACTACAG
GTGGCGCGAAC -> TGGCGCGAACG
GTGGGACCTAG -> TGGGACCTAGG
GTGGGACGGAG -> TGGGACGGAGT
GTGGGCGAAGC -> TGGGCGAAGCC
GTGGGGGGGTG -> TGGGGGGGTGC
GTGGTCCGAAT -> TGGTCCGAATG
GTGGTGCTTGG -> TGGTGCTTGGT
GTGTAACATAT -> TGTAACATATA
GTGTACCGCGG -> TGTACCGCGGA
GTGTACTCAAT -> TGTACTCAATT
GTGTAGACCAT -> TGTAGACCATA
GTGTGACTTCG -> TGTGACTTCGC
GTGTGTACCGC -> TGTGTACCGCG
GTGTTCTCATG -> TGTTCTCATGT
GTGTTCTCGCT -> TGTTCTCGCTG
GTGTTTACGTG -> TGTTTACGTGC
GTGTTTCTAGA -> TGTTTCTAGAT
GTTAAAAACTC -> TTAAAAACTCC
GTTAAATCAAG -> TTAAATCAAGC
GTTAACATACA -> TTAACATACAT
GTTAATAAAGG -> TTAATAAAGGG
GTTACGGCCTG -> TTACGGCCTGA
GTTAGGAGCAC -> TTAGGAGCACC
GTTAGTAATAT -> TTAGTAATATT
GTTAGTAGCCA -> TTAGTAGCCAC
GTTATTCGCTC -> TTATTCGCTCC
GTTCCACGATA -> TTCCACGATAA
GTTCCGTCAGT -> TTCCGTCAGTT
GTTCGCGAGAC -> TTCGCGAGACG
GTTCTCATGTG -> TTCTCATGTGA
GTTCTCGCTGG -> TTCTCGCTGGG
GTTCTGTCTGC -> TTCTGTCTGCA
GTTCTTTATTT -> TTCTTTATTTC
GTTGATAGGCC -> TTGATAGGCCA
GTTGCACAGTG -> TTGCACAGTGT
GTTGGACAGTG -> TTGGACAGTGG
GTTGGCAAGGC -> TTGGCAAGGCT
GTTGGCGTTTC -> TTGGCGTTTCC
GTTGTTCTTTA -> TTGTTCTTTAT
GTTTACGTGCC -> TTTACGTGCCT
GTTTAGATCTA -> TTTAGATCTAA
GTTTCACGGTA -> TTTCACGGTAC
GTTTCCCATTT -> TTTCCCATTTG
GTTTCCGGCGG -> TTTCCGGCGGT
GTTTCCTCGAG -> TTTCCTCGAGC
GTTTCTAGATT -> TTTCTAGATTG
GTTTTCGAGGA -> TTTTCGAGGAC
GTTTTTGTAAC -> TTTTTGTAACG
TAAAAACTCCG -> AAAAACTCCGG
TAAAACAGCGT -> AAAACAGCGTG
TAAAAGTTGAT -> AAAAGTTGATA
TAAACCAAGGG -> AAACCAAGGGG
TAAACCGCGCG -> AAACCGCGCGT
TAAACCGCTTA -> AAACCGCTTAG
TAAACTTGCAA -> AAACTTGCAAA
TAAAGGGTACG -> AAAGGGTACGG
TAAAGGGTCCT -> AAAGGGTCCTC
TAAATCAAGCA -> AAATCAAGCAC
TAAATGTATCG -> AAATGTATCGA
TAACATACATA -> AACATACATAG
TAACATATAAA -> AACATATAAAG
TAACGTGGTCC -> AACGTGGTCCG
TAACTTGTGGG -> AACTTGTGGGG
TAAGAAACGAA -> AAGAAACGAAC
TAAGACGTACT -> AAGACGTACTT
TAAGAGCACAA -> AAGAGCACAAC
TAAGAGGAGTG -> AAGAGGAGTGA
TAAGAGGGACT -> AAGAGGGACTT
TAAGCCAGTAC -> AAGCCAGTACT
TAAGGAGTGTT -> AAGGAGTGTTC
TAAGGGACGGT -> AAGGGACGGTT
TAAGTCGACAC -> AAGTCGACACC
TAATAAAGGGT -> AATAAAGGGTC
TAATATTCATT -> AATATTCATTT
TAATCAAACTG -> AATCAAACTGC
TAATCGTCTTG -> AATCGTCTTGA
TAATGTCGGTA -> AATGTCGGTAA
TAATTATTCGG -> AATTATTCGGC
TAATTGGTCTG -> AATTGGTCTGA
TACAAAGTCCC -> ACAAAGTCCCG
TACAACGGTTC -> ACAACGGTTCC
TACAAGCCGGA -> ACAAGCCGGAG
TACACATCTTC -> ACACATCTTCT
TACACGATGGC -> ACACGATGGCT
TACACTACCAC -> ACACTACCACG
TACAGATCGAA -> ACAGATCGAAC
TACAGGAATAT -> ACAGGAATATA
TACATAGCCGC -> ACATAGCCGCA
TACATTCTTTG -> ACATTCTTTGT
TACCAAGCTGA -> ACCAAGCTGAA
TACCAATCATC -> ACCAATCATCG
TACCACGGAGT -> ACCACGGAGTG
TACCACTTATG -> ACCACTTATGC
TACCATAAGGA -> ACCATAAGGAG
TACCCACGTTA -> ACCCACGTTAT
TACCCTAAGCC -> ACCCTAAGCCA
TACCGATGGTT -> ACCGATGGTTC
TACCGCGGAGC -> ACCGCGGAGCG
TACCGGTCTGC -> ACCGGTCTGCT
TACCGGTTAGT -> ACCGGTTAGTA
TACCTAAACTT -> ACCTAAACTTG
TACCTACCAAT -> ACCTACCAATC
TACGGCCTGAA -> ACGGCCTGAAA
TACGGTAATTG -> ACGGTAATTGG
TACGTACCCTA -> ACGTACCCTAA
TACGTGCCTTC -> ACGTGCCTTCC
TACTCAATTTA -> ACTCAATTTAT
TACTCCAGAGA -> ACTCCAGAGAC
TACTGTAATTA -> ACTGTAATTAT
TACTTCCAGTT -> ACTTCCAGTTT
TAGAAAGATAC -> AGAAAGATACC
TAGAATATTCG -> AGAATATTCGA
TAGACCATAAT -> AGACCATAATC
TAGAGACATTG -> AGAGACATTGC
TAGAGTTTCAC -> AGAGTTTCACG
TAGATCTAAGA -> AGATCTAAGAG
TAGATTATGCC -> AGATTATGCCT
TAGATTGCGCT -> AGATTGCGCTT
TAGCAATGAGA -> AGCAATGAGAG
TAGCAGGATCC -> AGCAGGATCCA
TAGCAGGTCGC -> AGCAGGTCGCA
TAGCCACGCGA -> AGCCACGCGAC
TAGCCCTAGAT -> AGCCCTAGATT
TAGCCGCAGGT -> AGCCGCAGGTG
TAGCCTGATTG -> AGCCTGATTGT
TAGCGCACCAG -> AGCGCACCAGC
TAGCGCGCAAG -> AGCGCGCAAGT
TAGCTCATAAA -> AGCTCATAAAT
TAGGAGCACCT -> AGGAGCACCTG
TAGGCCAAGCG -> AGGCCAAGCGC
TAGGGACACCT -> AGGGACACCTA
TAGGTCTCAAC -> AGGTCTCAACC
TAGTAATATTC -> AGTAATATTCA
TAGTAGAATAT -> AGTAGAATATT
TAGTAGCCACG -> AGTAGCCACGC
TAGTCGTCTTC -> AGTCGTCTTCA
TAGTGGATGCC -> AGTGGATGCCA
TAGTGGGACGG -> AGTGGGACGGA
TATAAAGGGTA -> ATAAAGGGTAC
TATACCGGTTA -> ATACCGGTTAG
TATAGCCCTAG -> ATAGCCCTAGA
TATATGAAAAA -> ATATGAAAAAC
TATCCTTGGCT -> ATCCTTGGCTT
TATCGACGAGG -> ATCGACGAGGC
TATCGGACACG -> ATCGGACACGG
TATCTGGAGGT -> ATCTGGAGGTC
TATCTTGAGCA -> ATCTTGAGCAT
TATGAAAAACA -> ATGAAAAACAG
TATGAGTGCAT -> ATGAGTGCATC
TATGCCGTGCC -> ATGCCGTGCCA
TATGCCTCACC -> ATGCCTCACCC
TATTAATGTCG -> ATTAATGTCGG
TATTCATTTAG -> ATTCATTTAGT
TATTCGAAACA -> ATTCGAAACAT
TATTCGCTCCC -> ATTCGCTCCCG
TATTCGGCCTC -> ATTCGGCCTCA
TATTGCAGGGC -> ATTGCAGGGCT
TATTGGCTTTA -> ATTGGCTTTAG
TATTTCCACAG -> ATTTCCACAGT
TATTTCCCTTC -> ATTTCCCTTCG
TCAAACTGCGA -> CAAACTGCGAT
TCAACCTATTT -> CAACCTATTTC
TCAAGAAGTAA -> CAAGAAGTAAA
TCAAGCACCTA -> CAAGCACCTAA
TCAATCAGTGC -> CAATCAGTGCC
TCAATTTATCT -> CAATTTATCTG
TCAATTTCAAT -> CAATTTCAATC
TCACCACCTGT -> CACCACCTGTA
TCACCAGAATT -> CACCAGAATTA
TCACCCAGTGT -> CACCCAGTGTA
TCACCCATTTT -> CACCCATTTTA
TCACCGAATTC -> CACCGAATTCG
TCACCGGAGTC -> CACCGGAGTCA
TCACGGTACCA -> CACGGTACCAA
TCACGGTTAAC -> CACGGTTAACA
TCACGTCTCCC -> CACGTCTCCCG
TCAGAGATTCA -> CAGAGATTCAT
TCAGTGCCGCC -> CAGTGCCGCCT
TCAGTTAATAA -> CAGTTAATAAA
TCATAAATGTA -> CATAAATGTAT
TCATAAGAAAC -> CATAAGAAACG
TCATCCACAAA -> CATCCACAAAT
TCATCCCGACT -> CATCCCGACTG
TCATCGGTAAG -> CATCGGTAAGA
TCATGGGAAAG -> CATGGGAAAGG
TCATGTGACTT -> CATGTGACTTG
TCATTAAAACA -> CATTAAAACAG
TCATTTAGTCG -> CATTTAGTCGT
TCCACAAATGG -> CCACAAATGGT
TCCACAGTTCT -> CCACAGTTCTG
TCCACCCAGCA -> CCACCCAGCAC
TCCACGATAAG -> CCACGATAAGG
TCCACTTGCCC -> CCACTTGCCCG
TCCAGAGACAC -> CCAGAGACACT
TCCAGGATTGA -> CCAGGATTGAC
TCCAGTTTTTG -> CCAGTTTTTGT
TCCATTTAGCA -> CCATTTAGCAA
TCCCATTTGAG -> CCCATTTGAGT
TCCCGAACATT -> CCCGAACATTA
TCCCGACTGGT -> CCCGACTGGTC
TCCCGAGCGCC -> CCCGAGCGCCT
TCCCGCAAAAT -> CCCGCAAAATT
TCCCGGCCGTC -> CCCGGCCGTCA
TCCCTCAAGAA -> CCCTCAAGAAG
TCCCTTCGTAC -> CCCTTCGTACG
TCCGAATATAG -> CCGAATATAGC
TCCGAATGAAC -> CCGAATGAACG
TCCGCCAACGG -> CCGCCAACGGG
TCCGGATCGTC -> CCGGATCGTCT
TCCGGCGGTTG -> CCGGCGGTTGG
TCCGGTTGTTC -> CCGGTTGTTCT
TCCGTCAGTTA -> CCGTCAGTTAA
TCCGTTCGCGA -> CCGTTCGCGAG
TCCTAGCAGGT -> CCTAGCAGGTC
TCCTCGAGCAC -> CCTCGAGCACG
TCCTCGTGTTC -> CCTCGTGTTCT
TCCTTGACCAA -> CCTTGACCAAG
TCCTTGGCTTA -> CCTTGGCTTAG
TCGAAACATGT -> CGAAACATGTG
TCGAAATCTGT -> CGAAATCTGTC
TCGAACCCACT -> CGAACCCACTA
TCGACACCGGA -> CGACACCGGAA
TCGACGAGGCA -> CGACGAGGCAA
TCGAGAGCGTC -> CGAGAGCGTCA
TCGAGCACGGT -> CGAGCACGGTG
TCGAGGACGAC -> CGAGGACGACC
TCGATAGTGGA -> CGATAGTGGAT
TCGATCGCATG -> CGATCGCATGG
TCGCAAACACC -> CGCAAACACCC
TCGCACCCCTT -> CGCACCCCTTC
TCGCAGACCCT -> CGCAGACCCTC
TCGCAGAGTTA -> CGCAGAGTTAC
TCGCATGGACG -> CGCATGGACGA
TCGCGAACCAT -> CGCGAACCATC
TCGCGAGACGC -> CGCGAGACGCG
TCGCTCCCGGC -> CGCTCCCGGCC
TCGCTGGGATT -> CGCTGGGATTC
TCGGACACGGC -> CGGACACGGCA
TCGGCCTCACG -> CGGCCTCACGG
TCGGTAAGACG -> CGGTAAGACGT
TCGGTAATCGT -> CGGTAATCGTC
TCGGTCCGCCA -> CGGTCCGCCAA
TCGTACAGATC -> CGTACAGATCG
TCGTACATTCT -> CGTACATTCTT
TCGTACGTACC -> CGTACGTACCC
TCGTACTCCAG -> CGTACTCCAGA
TCGTCTTCACC -> CGTCTTCACCA,CGTCTTCACCC
TCGTCTTGAAT -> CGTCTTGAATA
TCGTGTTCTCA -> CGTGTTCTCAT
TCGTTGGACAG -> CGTTGGACAGT
TCGTTTCCGGC -> CGTTTCCGGCG
TCTAAACCGCT -> CTAAACCGCTT
TCTAAGAGCAC -> CTAAGAGCACA
TCTAAGAGGAG -> CTAAGAGGAGT
TCTAGATTGCG -> CTAGATTGCGC
TCTCAACCTAT -> CTCAACCTATT
TCTCAATTTCA -> CTCAATTTCAA
TCTCATGTGAC -> CTCATGTGACT
TCTCATTAAAA -> CTCATTAAAAC
TCTCCCGCAAA -> CTCCCGCAAAA
TCTCGCTGGGA -> CTCGCTGGGAT
TCTCGGTCCGC -> CTCGGTCCGCC
TCTCTAAGAGC -> CTCTAAGAGCA
TCTGACATCGC -> CTGACATCGCA
TCTGACGTTTA -> CTGACGTTTAG
TCTGATACACG -> CTGATACACGA
TCTGCAAGTCC -> CTGCAAGTCCC
TCTGCTCCTAG -> CTGCTCCTAGC
TCTGCTCGTAC -> CTGCTCGTACA
TCTGGAGGTCC -> CTGGAGGTCCC
TCTGTCCACCC -> CTGTCCACCCA
TCTGTCGATAG -> CTGTCGATAGT
TCTGTCTGCAA -> CTGTCTGCAAG
TCTTATCCTTG -> CTTATCCTTGG
TCTTCACCAGA -> CTTCACCAGAA
TCTTCACCCAG -> CTTCACCCAGT
TCTTCTAAACC -> CTTCTAAACCG
TCTTGAATATT -> CTTGAATATTG
TCTTGAGCATT -> CTTGAGCATTG
TCTTTATTTCC -> CTTTATTTCCC
TCTTTGTAAGT -> CTTTGTAAGTC
TGAAAAACAGC -> GAAAAACAGCT
TGAAACTCACC -> GAAACTCACCG
TGAAAGTGTTT -> GAAAGTGTTTA
TGAACACCGTT -> GAACACCGTTA
TGAACGGGGCC -> GAACGGGGCCA
TGAAGGCAAGG -> GAAGGCAAGGG
TGAATATTGGC -> GAATATTGGCT
TGAATGAACAC -> GAATGAACACC
TGAATTTACAA -> GAATTTACAAG
TGACAGTACCG -> GACAGTACCGG
TGACATCGCAG -> GACATCGCAGA
TGACCAAGAGA -> GACCAAGAGAT
TGACCTTTGGC -> GACCTTTGGCG
TGACGAGGGCT -> GACGAGGGCTG
TGACGTTTAGA -> GACGTTTAGAT
TGACTTCGCGA -> GACTTCGCGAA
TGACTTGAGGG -> GACTTGAGGGC
TGAGAGAGTAA -> GAGAGAGTAAG
TGAGCATTGGG -> GAGCATTGGGT
TGAGGGCGCGT -> GAGGGCGCGTG
TGAGTGCATCA -> GAGTGCATCAC
TGAGTGCCACG -> GAGTGCCACGT
TGATACACGAT -> GATACACGATG
TGATAGGCCAA -> GATAGGCCAAG
TGATTGTGGGA -> GATTGTGGGAC
TGCAAATAGTG -> GCAAATAGTGG
TGCAACAGACC -> GCAACAGACCA
TGCAAGTCCCT -> GCAAGTCCCTC
TGCAATCCGTT -> GCAATCCGTTC
TGCAATGCGGG -> GCAATGCGGGC
TGCACAGTGTA -> GCACAGTGTAC
TGCAGAAACAA -> GCAGAAACAAC
TGCAGGGCTTC -> GCAGGGCTTCC
TGCATCACGTC -> GCATCACGTCT
TGCCACCCGAC -> GCCACCCGACT
TGCCACGTCTG -> GCCACGTCTGA
TGCCAGTCTCG -> GCCAGTCTCGG
TGCCCGCTCGA -> GCCCGCTCGAG
TGCCGCCTGTT -> GCCGCCTGTTA
TGCCGTGCCAC -> GCCGTGCCACC
TGCCTAGAGTT -> GCCTAGAGTTT
TGCCTCACCCA -> GCCTCACCCAT
TGCCTTCCTTG -> GCCTTCCTTGA
TGCGATTCGCA -> GCGATTCGCAG
TGCGCTTACCA -> GCGCTTACCAT
TGCGGGCCGTC -> GCGGGCCGTCC
TGCTACAAAGT -> GCTACAAAGTC
TGCTACCACTT -> GCTACCACTTA
TGCTCCTAGCA -> GCTCCTAGCAG
TGCTCGTACAG -> GCTCGTACAGA
TGCTCGTACAT -> GCTCGTACATT
TGCTGGGATGT -> GCTGGGATGTG
TGCTGTTTTCG -> GCTGTTTTCGA
TGCTTGGTACC -> GCTTGGTACCC
TGGACAGTGGC -> GGACAGTGGCA
TGGACGAGACC -> GGACGAGACCG
TGGAGGTCCCG -> GGAGGTCCCGA
TGGATGCCAGT -> GGATGCCAGTC
TGGCAAGGCTT -> GGCAAGGCTTA
TGGCAATCTCA -> GGCAATCTCAA
TGGCACTACAG -> GGCACTACAGG
TGGCCAATGCA -> GGCCAATGCAG
TGGCGATGCAC -> GGCGATGCACT
TGGCGCGAACG -> GGCGCGAACGC
TGGCGCTCTGA -> GGCGCTCTGAC
TGGCGTTTCCC -> GGCGTTTCCCA
TGGCTGGCCAA -> GGCTGGCCAAT
TGGCTTAGCTC -> GGCTTAGCTCA
TGGCTTTAGCG -> GGCTTTAGCGC
TGGGAAAGGGT -> GGGAAAGGGTG
TGGGACCTAGG -> GGGACCTAGGG
TGGGACGGAGT -> GGGACGGAGTT
TGGGATGTGTA -> GGGATGTGTAA
TGGGATTCACC -> GGGATTCACCA
TGGGCGAAGCC -> GGGCGAAGCCC
TGGGGGGACGA -> GGGGGGACGAC
TGGGGGGGTGC -> GGGGGGGTGCT
TGGGTGCAACA -> GGGTGCAACAG
TGGTAAACCGC -> GGTAAACCGCG
TGGTACCCACG -> GGTACCCACGT
TGGTCCGAATG -> GGTCCGAATGA
TGGTCGTTGGA -> GGTCGTTGGAC
TGGTCTGATAC -> GGTCTGATACA
TGGTGCTTGGT -> GGTGCTTGGTA
TGGTTCCGTCA -> GGTTCCGTCAG
TGTAACATATA -> GTAACATATAA
TGTAACGTGGT -> GTAACGTGGTC
TGTAAGTCGAC -> GTAAGTCGACA
TGTAATTATTC -> GTAATTATTCG
TGTACACATCT -> GTACACATCTT
TGTACCGCGGA -> GTACCGCGGAG
TGTACTCAATT -> GTACTCAATTT
TGTAGACCATA -> GTAGACCATAA
TGTAGCAGGAT -> GTAGCAGGATC
TGTATATGAAA -> GTATATGAAAA
TGTATCGACGA -> GTATCGACGAG
TGTCCACCCAG -> GTCCACCCAGC
TGTCGATAGTG -> GTCGATAGTGG
TGTCGGTAATC -> GTCGGTAATCG
TGTCTCATTAA -> GTCTCATTAAA
TGTCTGCAAGT -> GTCTGCAAGTC
TGTGACTTCGC -> GTGACTTCGCG
TGTGACTTGAG -> GTGACTTGAGG
TGTGGGACCTA -> GTGGGACCTAG
TGTGGGGGGGT -> GTGGGGGGGTG
TGTGTAACATA -> GTGTAACATAT
TGTGTACCGCG -> GTGTACCGCGG
TGTGTTTCTAG -> GTGTTTCTAGA
TGTTAGTAGCC -> GTTAGTAGCCA
TGTTCTCATGT -> GTTCTCATGTG
TGTTCTCGCTG -> GTTCTCGCTGG
TGTTCTTTATT -> GTTCTTTATTT
TGTTTACGTGC -> GTTTACGTGCC
TGTTTCTAGAT -> GTTTCTAGATT
TGTTTTCGAGG -> GTTTTCGAGGA
TTAAAAACTCC -> TAAAAACTCCG
TTAAAACAGCG -> TAAAACAGCGT
TTAAATCAAGC -> TAAATCAAGCA
TTAACATACAT -> TAACATACATA
TTAATAAAGGG -> TAATAAAGGGT
TTAATGTCGGT -> TAATGTCGGTA
TTACAACGGTT -> TACAACGGTTC
TTACAAGCCGG -> TACAAGCCGGA
TTACACTACCA -> TACACTACCAC
TTACCATAAGG -> TACCATAAGGA
TTACGGCCTGA -> TACGGCCTGAA
TTACGTGCCTT -> TACGTGCCTTC
TTAGAGACATT -> TAGAGACATTG
TTAGATCTAAG -> TAGATCTAAGA
TTAGCAATGAG -> TAGCAATGAGA
TTAGCGCACCA -> TAGCGCACCAG
TTAGCGCGCAA -> TAGCGCGCAAG
TTAGCTCATAA -> TAGCTCATAAA
TTAGGAGCACC -> TAGGAGCACCT
TTAGGTCTCAA -> TAGGTCTCAAC
TTAGTAATATT -> TAGTAATATTC
TTAGTAGAATA -> TAGTAGAATAT
TTAGTAGCCAC -> TAGTAGCCACG
TTAGTCGTCTT -> TAGTCGTCTTC
TTATCCTTGGC -> TATCCTTGGCT
TTATCGGACAC -> TATCGGACACG
TTATCTGGAGG -> TATCTGGAGGT
TTATGCCGTGC -> TATGCCGTGCC
TTATGCCTCAC -> TATGCCTCACC
TTATTCGCTCC -> TATTCGCTCCC
TTATTCGGCCT -> TATTCGGCCTC
TTATTTCCCTT -> TATTTCCCTTC
TTCAATCAGTG -> TCAATCAGTGC
TTCACCACCTG -> TCACCACCTGT
TTCACCAGAAT -> TCACCAGAATT
TTCACCCAGTG -> TCACCCAGTGT
TTCACGGTACC -> TCACGGTACCA
TTCATAAGAAA -> TCATAAGAAAC
TTCATCCCGAC -> TCATCCCGACT
TTCATTTAGTC -> TCATTTAGTCG
TTCCACAGTTC -> TCCACAGTTCT
TTCCACGATAA -> TCCACGATAAG
TTCCAGTTTTT -> TCCAGTTTTTG
TTCCATTTAGC -> TCCATTTAGCA
TTCCCATTTGA -> TCCCATTTGAG
TTCCCTTCGTA -> TCCCTTCGTAC
TTCCGGCGGTT -> TCCGGCGGTTG
TTCCGTCAGTT -> TCCGTCAGTTA
TTCCTCGAGCA -> TCCTCGAGCAC
TTCCTTGACCA -> TCCTTGACCAA
TTCGAAACATG -> TCGAAACATGT
TTCGAGGACGA -> TCGAGGACGAC
TTCGCAGAGTT -> TCGCAGAGTTA
TTCGCGAACCA -> TCGCGAACCAT
TTCGCGAGACG -> TCGCGAGACGC
TTCGCTCCCGG -> TCGCTCCCGGC
TTCGGCCTCAC -> TCGGCCTCACG
TTCGTACGTAC -> TCGTACGTACC
TTCGTACTCCA -> TCGTACTCCAG
TTCGTTTCCGG -> TCGTTTCCGGC
TTCTAAACCGC -> TCTAAACCGCT
TTCTAGATTGC -> TCTAGATTGCG
TTCTCATGTGA -> TCTCATGTGAC
TTCTCGCTGGG -> TCTCGCTGGGA
TTCTGTCTGCA -> TCTGTCTGCAA
TTCTTTATTTC -> TCTTTATTTCC
TTCTTTGTAAG -> TCTTTGTAAGT
TTGAATATTGG -> TGAATATTGGC
TTGACCAAGAG -> TGACCAAGAGA
TTGACCTTTGG -> TGACCTTTGGC
TTGACGAGGGC -> TGACGAGGGCT
TTGAGCATTGG -> TGAGCATTGGG
TTGAGGGCGCG -> TGAGGGCGCGT
TTGAGTGCCAC -> TGAGTGCCACG
TTGATAGGCCA -> TGATAGGCCAA
TTGCAAATAGT -> TGCAAATAGTG
TTGCACAGTGT -> TGCACAGTGTA
TTGCAGGGCTT -> TGCAGGGCTTC
TTGCCCGCTCG -> TGCCCGCTCGA
TTGCGCTTACC -> TGCGCTTACCA
TTGCTACCACT -> TGCTACCACTT
TTGGACAGTGG -> TGGACAGTGGC
TTGGCAAGGCT -> TGGCAAGGCTT
TTGGCGCTCTG -> TGGCGCTCTGA
TTGGCGTTTCC -> TGGCGTTTCCC
TTGGCTTAGCT -> TGGCTTAGCTC
TTGGCTTTAGC -> TGGCTTTAGCG
TTGGGTGCAAC -> TGGGTGCAACA
TTGGTACCCAC -> TGGTACCCACG
TTGGTCTGATA -> TGGTCTGATAC
TTGTAACGTGG -> TGTAACGTGGT
TTGTAAGTCGA -> TGTAAGTCGAC
TTGTCTCATTA -> TGTCTCATTAA
TTGTGGGACCT -> TGTGGGACCTA
TTGTGGGGGGG -> TGTGGGGGGGT
TTGTTCTTTAT -> TGTTCTTTATT
TTTACAACGGT -> TTACAACGGTT
TTTACAAGCCG -> TTACAAGCCGG
TTTACGTGCCT -> TTACGTGCCTT
TTTAGATCTAA -> TTAGATCTAAG
TTTAGCAATGA -> TTAGCAATGAG
TTTAGCGCGCA -> TTAGCGCGCAA
TTTAGTCGTCT -> TTAGTCGTCTT
TTTATCTGGAG -> TTATCTGGAGG
TTTATTTCCCT -> TTATTTCCCTT
TTTCAATCAGT -> TTCAATCAGTG
TTTCACGGTAC -> TTCACGGTACC
TTTCCACAGTT -> TTCCACAGTTC
TTTCCCATTTG -> TTCCCATTTGA
TTTCCCTTCGT -> TTCCCTTCGTA
TTTCCGGCGGT -> TTCCGGCGGTT
TTTCCTCGAGC -> TTCCTCGAGCA
TTTCGAGGACG -> TTCGAGGACGA
TTTCTAGATTG -> TTCTAGATTGC
TTTGACCTTTG -> TTGACCTTTGG
TTTGAGTGCCA -> TTGAGTGCCAC
TTTGGCGCTCT -> TTGGCGCTCTG
TTTGTAACGTG -> TTGTAACGTGG
TTTGTAAGTCG -> TTGTAAGTCGA
TTTTACAACGG -> TTTACAACGGT
TTTTCGAGGAC -> TTTCGAGGACG
TTTTGTAACGT -> TTTGTAACGTG
TTTTTGTAACG -> TTTTGTAACGT
