AAAAACGTAATAAGTCTAG -> AAAACGTAATAAGTCTAGT
AAAAAGCTGTGATCTGCTG -> AAAAGCTGTGATCTGCTGC
AAAACGAACTATAGCCTCC -> AAACGAACTATAGCCTCCT
AAAACGTAATAAGTCTAGT -> AAACGTAATAAGTCTAGTG
AAAACTTTATGTTGTACGT -> AAACTTTATGTTGTACGTC
AAAAGAAACGCCCCTAGCG -> AAAGAAACGCCCCTAGCGG
AAAAGACTGATCTTGTGCA -> AAAGACTGATCTTGTGCAG
AAAAGCTGTGATCTGCTGC -> AAAGCTGTGATCTGCTGCC
AAAAGTACAACGCACTCCT -> AAAGTACAACGCACTCCTG
AAAAGTTCGTCGATGAGAC -> AAAGTTCGTCGATGAGACA
AAACAAGTTGGGATTCAGG -> AACAAGTTGGGATTCAGGT
AAACCCTATTGAGTCTTAA -> AACCCTATTGAGTCTTAAA
AAACCGAACGCGTTTGACG -> AACCGAACGCGTTTGACGG
AAACGAACTATAGCCTCCT -> AACGAACTATAGCCTCCTA
AAACGCCCCTAGCGGGCGA -> AACGCCCCTAGCGGGCGAC
AAACGTAATAAGTCTAGTG -> AACGTAATAAGTCTAGTGA
AAACTACCACACTCGAGCC -> AACTACCACACTCGAGCCG
AAACTCTTCATGGGTACGA -> AACTCTTCATGGGTACGAC
AAACTTTATGTTGTACGTC -> AACTTTATGTTGTACGTCC
AAAGAAACGCCCCTAGCGG -> AAGAAACGCCCCTAGCGGG
AAAGACTGATCTTGTGCAG -> AAGACTGATCTTGTGCAGA
AAAGACTGGAGTGCATGCG -> AAGACTGGAGTGCATGCGG
AAAGAGATGATGATAGGCT -> AAGAGATGATGATAGGCTC
AAAGCTGTGATCTGCTGCC -> AAGCTGTGATCTGCTGCCA
AAAGTACAACGCACTCCTG -> AAGTACAACGCACTCCTGA
AAAGTTCGTCGATGAGACA -> AAGTTCGTCGATGAGACAA
AAATACCTACGGGTAAGTT -> AATACCTACGGGTAAGTTC
AAATAGTGAAGACGGCGAC -> AATAGTGAAGACGGCGACC
AAATCGTTATTGCCGTGTA -> AATCGTTATTGCCGTGTAC
AAATTACTGGTTTGGAGAC -> AATTACTGGTTTGGAGACT
AAATTTCTGACAGTACTTT -> AATTTCTGACAGTACTTTT
AACAAGTTGGGATTCAGGT -> ACAAGTTGGGATTCAGGTG
AACAGGCGTATGTTCACCG -> ACAGGCGTATGTTCACCGT
AACCAATCCCTGTAACGCT -> ACCAATCCCTGTAACGCTT
AACCATGAATGGACCTGAC -> ACCATGAATGGACCTGACT
AACCCCGTTTTCCTGGTCA -> ACCCCGTTTTCCTGGTCAG
AACCCTATTGAGTCTTAAA -> ACCCTATTGAGTCTTAAAA
AACCGAACGCGTTTGACGG -> ACCGAACGCGTTTGACGGA
AACCGACAAGTAATTGATG -> ACCGACAAGTAATTGATGT
AACCTCTCAAGGCCTACCC -> ACCTCTCAAGGCCTACCCA
AACGAACTATAGCCTCCTA -> ACGAACTATAGCCTCCTAT
AACGCACTCCTGATTCAGA -> ACGCACTCCTGATTCAGAA
AACGCCCCTAGCGGGCGAC -> ACGCCCCTAGCGGGCGACG
AACGCGTTTGACGGATCGA -> ACGCGTTTGACGGATCGAC
AACGCTTCTCGATCGGCCG -> ACGCTTCTCGATCGGCCGA
AACGGCACGTAGTTGGCTC -> ACGGCACGTAGTTGGCTCT
AACGTAATAAGTCTAGTGA -> ACGTAATAAGTCTAGTGAT
AACTACCACACTCGAGCCG -> ACTACCACACTCGAGCCGC
AACTATAGCCTCCTATACT -> ACTATAGCCTCCTATACTC
AACTCTTCATGGGTACGAC -> ACTCTTCATGGGTACGACG
AACTTTATGTTGTACGTCC -> ACTTTATGTTGTACGTCCT
AAGAAACGCCCCTAGCGGG -> AGAAACGCCCCTAGCGGGC
AAGAAGGACTGCTACGGTC -> AGAAGGACTGCTACGGTCT
AAGAAGGGCCCCTTCGCGC -> AGAAGGGCCCCTTCGCGCT
AAGAAGTTTGAGTATTTGT -> AGAAGTTTGAGTATTTGTT
AAGAATTGAGACCGGGAAG -> AGAATTGAGACCGGGAAGC
AAGAATTTAGAATGTAGAT -> AGAATTTAGAATGTAGATT
AAGACCGACCTCTTTGTGT -> AGACCGACCTCTTTGTGTC
AAGACGGCGACCAACCGAC -> AGACGGCGACCAACCGACA
AAGACGTCCGACCGGGCAT -> AGACGTCCGACCGGGCATG
AAGACTGATCTTGTGCAGA -> AGACTGATCTTGTGCAGAT
AAGACTGGAGTGCATGCGG -> AGACTGGAGTGCATGCGGA
AAGACTTGTGCCCCTGGGT -> AGACTTGTGCCCCTGGGTT
AAGAGATGATGATAGGCTC -> AGAGATGATGATAGGCTCG
AAGAGGACTGCACGGACTC -> AGAGGACTGCACGGACTCG
AAGAGGGAGTTCTCACATG -> AGAGGGAGTTCTCACATGG
AAGATTACCATGGGGCGTC -> AGATTACCATGGGGCGTCG
AAGCAAAGACTGGAGTGCA -> AGCAAAGACTGGAGTGCAT
AAGCCCGCAGCGTCGTAAC -> AGCCCGCAGCGTCGTAACC
AAGCGCACCTCTTAATGAT -> AGCGCACCTCTTAATGATG
AAGCTCCACTCTTGATGTG -> AGCTCCACTCTTGATGTGC
AAGCTGTGATCTGCTGCCA -> AGCTGTGATCTGCTGCCAG
AAGGACTGCTACGGTCTAT -> AGGACTGCTACGGTCTATG
AAGGACTTTTAAATACCTA -> AGGACTTTTAAATACCTAC
AAGGAGGCAAGGCACGCGT -> AGGAGGCAAGGCACGCGTA
AAGGAGGCACTGTACGATC -> AGGAGGCACTGTACGATCA
AAGGAGGCATCATTTTCGC -> AGGAGGCATCATTTTCGCG
AAGGAGGCTCTGGCACGCC -> AGGAGGCTCTGGCACGCCT
AAGGCACGCGTATCATAAG -> AGGCACGCGTATCATAAGA
AAGGCCGCTAGGGACTAGT -> AGGCCGCTAGGGACTAGTT
AAGGCCTACCCACGGATAA -> AGGCCTACCCACGGATAAG
AAGGGCCCCTTCGCGCTGC -> AGGGCCCCTTCGCGCTGCC
AAGGTAGGCGACCCAAATT -> AGGTAGGCGACCCAAATTA
AAGTAATTGATGTCGTTTA -> AGTAATTGATGTCGTTTAA
AAGTACAACGCACTCCTGA -> AGTACAACGCACTCCTGAT
AAGTCTAGTGATGCGGCCC -> AGTCTAGTGATGCGGCCCT
AAGTCTCAATGTTCTAGCT -> AGTCTCAATGTTCTAGCTT
AAGTGTAGGCCGTCAAGAC -> AGTGTAGGCCGTCAAGACC
AAGTTCCTGAGCAGCCCGT -> AGTTCCTGAGCAGCCCGTC
AAGTTCGTCATCCAAGCCC -> AGTTCGTCATCCAAGCCCG
AAGTTCGTCGATGAGACAA -> AGTTCGTCGATGAGACAAA
AAGTTGGGATTCAGGTGTA -> AGTTGGGATTCAGGTGTAA
AAGTTTGAGTATTTGTTGG -> AGTTTGAGTATTTGTTGGG
AATAAAAGAAACGCCCCTA -> ATAAAAGAAACGCCCCTAG
AATAAGTCTAGTGATGCGG -> ATAAGTCTAGTGATGCGGC
AATAATTTGACTCGAGATG -> ATAATTTGACTCGAGATGT
AATACCTACGGGTAAGTTC -> ATACCTACGGGTAAGTTCC
AATAGACTATGCTCGGGTG -> ATAGACTATGCTCGGGTGG
AATAGCATTAGCACCAAGA -> ATAGCATTAGCACCAAGAA
AATAGTCACCCTACACATA -> ATAGTCACCCTACACATAT
AATAGTGAAGACGGCGACC -> ATAGTGAAGACGGCGACCA
AATATAGTCCATTAGCTAT -> ATATAGTCCATTAGCTATC
AATATGTCCCATAGGCTCT -> ATATGTCCCATAGGCTCTT
AATCACCCTCCTTAGACGG -> ATCACCCTCCTTAGACGGT
AATCCCTGTAACGCTTCTC -> ATCCCTGTAACGCTTCTCG
AATCCTATCATGCTTCGCA -> ATCCTATCATGCTTCGCAC
AATCCTCCACAGCAGAGGT -> ATCCTCCACAGCAGAGGTA
AATCGTTATTGCCGTGTAC -> ATCGTTATTGCCGTGTACG
AATCTCTGGATAATCCTAT -> ATCTCTGGATAATCCTATC
AATGATGAATGATGGATTT -> ATGATGAATGATGGATTTC
AATGATGGATTTCATGACG -> ATGATGGATTTCATGACGG
AATGGACCTGACTCCGGAA -> ATGGACCTGACTCCGGAAT
AATGGACGGGCGCTATCTA -> ATGGACGGGCGCTATCTAA
AATGTAGATTATAATAGTC -> ATGTAGATTATAATAGTCA
AATGTGCTCATCGGTAGAG -> ATGTGCTCATCGGTAGAGT
AATGTTCTAGCTTTCACGT -> ATGTTCTAGCTTTCACGTC
AATTAATAGACTATGCTCG -> ATTAATAGACTATGCTCGG
AATTACCGCCGTAAACCCT -> ATTACCGCCGTAAACCCTA
AATTACTGGTTTGGAGACT -> ATTACTGGTTTGGAGACTA
AATTCTACGTGTGTTTCCT -> ATTCTACGTGTGTTTCCTG
AATTGAGACCGGGAAGCAA -> ATTGAGACCGGGAAGCAAA
AATTGATGTCGTTTAATTA -> ATTGATGTCGTTTAATTAC
AATTGTAGCTAATCACCCT -> ATTGTAGCTAATCACCCTC
AATTTAAAACTTTATGTTG -> ATTTAAAACTTTATGTTGT
AATTTAGAATGTAGATTAT -> ATTTAGAATGTAGATTATA
AATTTCTGACAGTACTTTT -> ATTTCTGACAGTACTTTTG
AATTTGACTCGAGATGTAG -> ATTTGACTCGAGATGTAGT
ACAAATAGTGAAGACGGCG -> CAAATAGTGAAGACGGCGA
ACAACGCACTCCTGATTCA -> CAACGCACTCCTGATTCAG
ACAAGCGCACCTCTTAATG -> CAAGCGCACCTCTTAATGA
ACAAGTAATTGATGTCGTT -> CAAGTAATTGATGTCGTTT
ACAAGTTGGGATTCAGGTG -> CAAGTTGGGATTCAGGTGT
ACACACGGGTTGGCTCTGG -> CACACGGGTTGGCTCTGGA
ACACATATCCGGATTGTGG -> CACATATCCGGATTGTGGA
ACACGGGTTGGCTCTGGAA -> CACGGGTTGGCTCTGGAAG
ACACTCGAGCCGCCTCTGG -> CACTCGAGCCGCCTCTGGG
ACAGCAGAGGTAATATGTC -> CAGCAGAGGTAATATGTCC
ACAGGCGTATGTTCACCGT -> CAGGCGTATGTTCACCGTT
ACAGGGCATGGAGCCTCTC -> CAGGGCATGGAGCCTCTCC
ACAGTACTTTTGAGTGGTT -> CAGTACTTTTGAGTGGTTA
ACATATCCGGATTGTGGAA -> CATATCCGGATTGTGGAAG
ACATGCATCTTGCGGAAGT -> CATGCATCTTGCGGAAGTT
ACATGGGTAAATTTCTGAC -> CATGGGTAAATTTCTGACA
ACATTTCCTGGTCAGGAGA -> CATTTCCTGGTCAGGAGAG
ACCAACCGACAAGTAATTG -> CCAACCGACAAGTAATTGA
ACCAAGAAGGGCCCCTTCG -> CCAAGAAGGGCCCCTTCGC
ACCAATCCCTGTAACGCTT -> CCAATCCCTGTAACGCTTC
ACCAATGGACGGGCGCTAT -> CCAATGGACGGGCGCTATC
ACCACACTCGAGCCGCCTC -> CCACACTCGAGCCGCCTCT
ACCATGAATGGACCTGACT -> CCATGAATGGACCTGACTC
ACCATGGGGCGTCGTCGTC -> CCATGGGGCGTCGTCGTCG
ACCCAAATTACTGGTTTGG -> CCCAAATTACTGGTTTGGA
ACCCACGGATAAGGCCGCT -> CCCACGGATAAGGCCGCTA
ACCCAGGTGCGAAATCGTT -> CCCAGGTGCGAAATCGTTA
ACCCCGTTTTCCTGGTCAG -> CCCCGTTTTCCTGGTCAGG
ACCCTACACATATCCGGAT -> CCCTACACATATCCGGATT
ACCCTATTGAGTCTTAAAA -> CCCTATTGAGTCTTAAAAC
ACCCTCCTTAGACGGTACT -> CCCTCCTTAGACGGTACTA
ACCGAACGCGTTTGACGGA -> CCGAACGCGTTTGACGGAT
ACCGACAAGTAATTGATGT -> CCGACAAGTAATTGATGTC
ACCGACCTCTTTGTGTCTA -> CCGACCTCTTTGTGTCTAA
ACCGACGCCGCGCTCCCTA -> CCGACGCCGCGCTCCCTAC
ACCGACTTCCATGTACAAG -> CCGACTTCCATGTACAAGC
ACCGAGCGGGTTTTTCGCG -> CCGAGCGGGTTTTTCGCGC
ACCGCCGTAAACCCTATTG -> CCGCCGTAAACCCTATTGA
ACCGGGAAGCAAAGACTGG -> CCGGGAAGCAAAGACTGGA
ACCGGGCATGGAGCGAGCC -> CCGGGCATGGAGCGAGCCT
ACCGTAAACTACCACACTC -> CCGTAAACTACCACACTCG
ACCGTTCCTGGACTAGTGT -> CCGTTCCTGGACTAGTGTT
ACCTAAGAAGGACTGCTAC -> CCTAAGAAGGACTGCTACG
ACCTACGGGTAAGTTCCTG -> CCTACGGGTAAGTTCCTGA
ACCTAGAGTACATTTCCTG -> CCTAGAGTACATTTCCTGG
ACCTCTCAAGGCCTACCCA -> CCTCTCAAGGCCTACCCAC
ACCTCTTAATGATGAATGA -> CCTCTTAATGATGAATGAT
ACCTCTTAGGCATGATAGC -> CCTCTTAGGCATGATAGCT
ACCTCTTTGTGTCTAAACT -> CCTCTTTGTGTCTAAACTC
ACCTGACTCCGGAATTCTA -> CCTGACTCCGGAATTCTAC
ACCTGGGTGCTAGCAAGAC -> CCTGGGTGCTAGCAAGACG
ACGAAAAGTACAACGCACT -> CGAAAAGTACAACGCACTC
ACGAACAGGCGTATGTTCA -> CGAACAGGCGTATGTTCAC
ACGAACTATAGCCTCCTAT -> CGAACTATAGCCTCCTATA
ACGACGAACAGGCGTATGT -> CGACGAACAGGCGTATGTT
ACGACGAGTGAGCAATGTG -> CGACGAGTGAGCAATGTGC
ACGACGTCTGCGTTAATCT -> CGACGTCTGCGTTAATCTC
ACGAGTGAGCAATGTGCTC -> CGAGTGAGCAATGTGCTCA
ACGATCATGACATGCATCT -> CGATCATGACATGCATCTT
ACGATGGTATAGTGTTGGT -> CGATGGTATAGTGTTGGTT
ACGCACTCCTGATTCAGAA -> CGCACTCCTGATTCAGAAT
ACGCCCCTAGCGGGCGACG -> CGCCCCTAGCGGGCGACGG
ACGCCCTCCTGCTGTGTCC -> CGCCCTCCTGCTGTGTCCA
ACGCCGCGCTCCCTACTAT -> CGCCGCGCTCCCTACTATA
ACGCCTTTCAATCCTCCAC -> CGCCTTTCAATCCTCCACA
ACGCGTATCATAAGATTAC -> CGCGTATCATAAGATTACC
ACGCGTTTGACGGATCGAC -> CGCGTTTGACGGATCGACT
ACGCTTCTCGATCGGCCGA -> CGCTTCTCGATCGGCCGAA
ACGGACTCGCCGGGGCTGT -> CGGACTCGCCGGGGCTGTG
ACGGATAAGGCCGCTAGGG -> CGGATAAGGCCGCTAGGGA
ACGGATCGACTGTAGACGA -> CGGATCGACTGTAGACGAA
ACGGCACGTAGTTGGCTCT -> CGGCACGTAGTTGGCTCTG
ACGGCCGGCTTAAAAGTTC -> CGGCCGGCTTAAAAGTTCG
ACGGCGACCAACCGACAAG -> CGGCGACCAACCGACAAGT
ACGGCGTGGGCTGGAAAAG -> CGGCGTGGGCTGGAAAAGA
ACGGGAGGACTGACCTCTT -> CGGGAGGACTGACCTCTTA
ACGGGCGCTATCTAATAAT -> CGGGCGCTATCTAATAATT
ACGGGTAAGTTCCTGAGCA -> CGGGTAAGTTCCTGAGCAG
ACGGGTACGATGGTATAGT -> CGGGTACGATGGTATAGTG
ACGGGTTGGCTCTGGAAGG -> CGGGTTGGCTCTGGAAGGA
ACGGTACTATTTCGGAAAA -> CGGTACTATTTCGGAAAAA
ACGGTATATCATCTATCGG -> CGGTATATCATCTATCGGC
ACGGTCTATGACTAGCTAC -> CGGTCTATGACTAGCTACC
ACGTAATAAGTCTAGTGAT -> CGTAATAAGTCTAGTGATG
ACGTAGTTGGCTCTGGAAG -> CGTAGTTGGCTCTGGAAGG
ACGTCAAGCTCCACTCTTG -> CGTCAAGCTCCACTCTTGA
ACGTCACCAATGGACGGGC -> CGTCACCAATGGACGGGCG
ACGTCCGACCGGGCATGGA -> CGTCCGACCGGGCATGGAG
ACGTCCTAGTTCTTTGAAA -> CGTCCTAGTTCTTTGAAAG
ACGTCTGCGTTAATCTCTG -> CGTCTGCGTTAATCTCTGG
ACGTGTGTTTCCTGGTCAG -> CGTGTGTTTCCTGGTCAGG
ACTACCACACTCGAGCCGC -> CTACCACACTCGAGCCGCC
ACTACGACGAACAGGCGTA -> CTACGACGAACAGGCGTAT
ACTAGCTACCTAGAGTACA -> CTAGCTACCTAGAGTACAT
ACTAGTGTTGAGTGGTGCC -> CTAGTGTTGAGTGGTGCCT
ACTAGTTATCCTGGCACCG -> CTAGTTATCCTGGCACCGT
ACTATACTTCGATGACGGC -> CTATACTTCGATGACGGCC
ACTATAGCCTCCTATACTC -> CTATAGCCTCCTATACTCG
ACTATGCTCGGGTGGAGTG -> CTATGCTCGGGTGGAGTGT
ACTATTTCGGAAAAACGTA -> CTATTTCGGAAAAACGTAA
ACTCCGGAATTCTACGTGT -> CTCCGGAATTCTACGTGTG
ACTCCTGATTCAGAATTGT -> CTCCTGATTCAGAATTGTA
ACTCGAGATGTAGTGATAG -> CTCGAGATGTAGTGATAGA
ACTCGAGCCGCCTCTGGGT -> CTCGAGCCGCCTCTGGGTT
ACTCGCACCTGGGTGCTAG -> CTCGCACCTGGGTGCTAGC
ACTCGCCGGGGCTGTGTCC -> CTCGCCGGGGCTGTGTCCG
ACTCGGTACTTGAGATGCG -> CTCGGTACTTGAGATGCGA
ACTCTTCATGGGTACGACG -> CTCTTCATGGGTACGACGA
ACTCTTGATGTGCATGACT -> CTCTTGATGTGCATGACTT
ACTGACCTCTTAGGCATGA -> CTGACCTCTTAGGCATGAT
ACTGATCTTGTGCAGATTT -> CTGATCTTGTGCAGATTTC
ACTGCACGGACTCGCCGGG -> CTGCACGGACTCGCCGGGG
ACTGCTACGGTCTATGACT -> CTGCTACGGTCTATGACTA
ACTGGAGTGCATGCGGAGC -> CTGGAGTGCATGCGGAGCG
ACTGGTTTGGAGACTACGA -> CTGGTTTGGAGACTACGAC
ACTGTACGATCATGACATG -> CTGTACGATCATGACATGC
ACTGTAGACGAAAAGTACA -> CTGTAGACGAAAAGTACAA
ACTTCCATGTACAAGCGCA -> CTTCCATGTACAAGCGCAC
ACTTCCGGGAACCAATCCC -> CTTCCGGGAACCAATCCCT
ACTTCGATGACGGCCGGCT -> CTTCGATGACGGCCGGCTT
ACTTGAATAAAAGAAACGC -> CTTGAATAAAAGAAACGCC
ACTTGAGATGCGAGGTATC -> CTTGAGATGCGAGGTATCA
ACTTGTGCCCCTGGGTTAT -> CTTGTGCCCCTGGGTTATG
ACTTTATGTTGTACGTCCT -> CTTTATGTTGTACGTCCTA
ACTTTCCTGGTCAGGAGAG -> CTTTCCTGGTCAGGAGAGG
ACTTTTAAATACCTACGGG -> CTTTTAAATACCTACGGGT
ACTTTTAGCGCCGTACCCA -> CTTTTAGCGCCGTACCCAG
ACTTTTGAGTGGTTAAGAA -> CTTTTGAGTGGTTAAGAAT
AGAAACGCCCCTAGCGGGC -> GAAACGCCCCTAGCGGGCG
AGAAGGACTGCTACGGTCT -> GAAGGACTGCTACGGTCTA
AGAAGGGCCCCTTCGCGCT -> GAAGGGCCCCTTCGCGCTG
AGAAGTTTGAGTATTTGTT -> GAAGTTTGAGTATTTGTTG
AGAATGTAGATTATAATAG -> GAATGTAGATTATAATAGT
AGAATTGAGACCGGGAAGC -> GAATTGAGACCGGGAAGCA
AGAATTGTAGCTAATCACC -> GAATTGTAGCTAATCACCC
AGAATTTAGAATGTAGATT -> GAATTTAGAATGTAGATTA
AGACAAATAGTGAAGACGG -> GACAAATAGTGAAGACGGC
AGACCGACCTCTTTGTGTC -> GACCGACCTCTTTGTGTCT
AGACCGGGAAGCAAAGACT -> GACCGGGAAGCAAAGACTG
AGACGAAAAGTACAACGCA -> GACGAAAAGTACAACGCAC
AGACGACGTCTGCGTTAAT -> GACGACGTCTGCGTTAATC
AGACGGCGACCAACCGACA -> GACGGCGACCAACCGACAA
AGACGGTACTATTTCGGAA -> GACGGTACTATTTCGGAAA
AGACGTCCGACCGGGCATG -> GACGTCCGACCGGGCATGG
AGACTACGACGAACAGGCG -> GACTACGACGAACAGGCGT
AGACTATGCTCGGGTGGAG -> GACTATGCTCGGGTGGAGT
AGACTGATCTTGTGCAGAT -> GACTGATCTTGTGCAGATT
AGACTGGAGTGCATGCGGA -> GACTGGAGTGCATGCGGAG
AGACTTGTGCCCCTGGGTT -> GACTTGTGCCCCTGGGTTA
AGAGACGACGTCTGCGTTA -> GAGACGACGTCTGCGTTAA
AGAGATGATGATAGGCTCG -> GAGATGATGATAGGCTCGA
AGAGGAACGGCACGTAGTT -> GAGGAACGGCACGTAGTTG
AGAGGACTGCACGGACTCG -> GAGGACTGCACGGACTCGC
AGAGGCCCACACACGGGTT -> GAGGCCCACACACGGGTTG
AGAGGGAGTCCCTATAGTT -> GAGGGAGTCCCTATAGTTG
AGAGGGAGTTCTCACATGG -> GAGGGAGTTCTCACATGGG
AGAGGTAATATGTCCCATA -> GAGGTAATATGTCCCATAG
AGAGGTAGGTTGCATGGTT -> GAGGTAGGTTGCATGGTTG
AGAGGTCGCATCCTCTGCC -> GAGGTCGCATCCTCTGCCC
AGAGTACATTTCCTGGTCA -> GAGTACATTTCCTGGTCAG
AGAGTCGGACTTTTAGCGC -> GAGTCGGACTTTTAGCGCC
AGATGATGATAGGCTCGAC -> GATGATGATAGGCTCGACG
AGATGCGAGGTATCAAGTG -> GATGCGAGGTATCAAGTGT
AGATGTAGTGATAGAGGTC -> GATGTAGTGATAGAGGTCG
AGATTACCATGGGGCGTCG -> GATTACCATGGGGCGTCGT
AGATTATAATAGTCACCCT -> GATTATAATAGTCACCCTA
AGATTTCAAGACTTGTGCC -> GATTTCAAGACTTGTGCCC
AGCAAAGACTGGAGTGCAT -> GCAAAGACTGGAGTGCATG
AGCAAGACGTCCGACCGGG -> GCAAGACGTCCGACCGGGC
AGCAATGTGCTCATCGGTA -> GCAATGTGCTCATCGGTAG
AGCACCAAGAAGGGCCCCT -> GCACCAAGAAGGGCCCCTT
AGCAGAGGTAATATGTCCC -> GCAGAGGTAATATGTCCCA
AGCAGCCCGTCGCCTACTT -> GCAGCCCGTCGCCTACTTG
AGCATTAGCACCAAGAAGG -> GCATTAGCACCAAGAAGGG
AGCCCGCAGCGTCGTAACC -> GCCCGCAGCGTCGTAACCC
AGCCCGTCGCCTACTTGAA -> GCCCGTCGCCTACTTGAAT
AGCCGCCTCTGGGTTCCAT -> GCCGCCTCTGGGTTCCATC
AGCCTAAGGTAGGCGACCC -> GCCTAAGGTAGGCGACCCA
AGCCTCCTATACTCGGTAC -> GCCTCCTATACTCGGTACT
AGCCTCTCCTAATATAGTC -> GCCTCTCCTAATATAGTCC
AGCGAAACCGAACGCGTTT -> GCGAAACCGAACGCGTTTG
AGCGAGCCTAAGGTAGGCG -> GCGAGCCTAAGGTAGGCGA
AGCGAGGATCCAGCGAAAC -> GCGAGGATCCAGCGAAACC
AGCGCACCTCTTAATGATG -> GCGCACCTCTTAATGATGA
AGCGCCGTACCCAGGTGCG -> GCGCCGTACCCAGGTGCGA
AGCGGGCGACGGTATATCA -> GCGGGCGACGGTATATCAT
AGCGGGTTTTTCGCGCGCT -> GCGGGTTTTTCGCGCGCTC
AGCGTCGTAACCCCGTTTT -> GCGTCGTAACCCCGTTTTC
AGCTAATCACCCTCCTTAG -> GCTAATCACCCTCCTTAGA
AGCTACCTAGAGTACATTT -> GCTACCTAGAGTACATTTC
AGCTATCTAACCATGAATG -> GCTATCTAACCATGAATGG
AGCTCCACTCTTGATGTGC -> GCTCCACTCTTGATGTGCA
AGCTGTGATCTGCTGCCAG -> GCTGTGATCTGCTGCCAGT
AGCTTAAGAGGGAGTTCTC -> GCTTAAGAGGGAGTTCTCA
AGCTTTCACGTCAAGCTCC -> GCTTTCACGTCAAGCTCCA
AGGAACGGCACGTAGTTGG -> GGAACGGCACGTAGTTGGC
AGGACTGACCTCTTAGGCA -> GGACTGACCTCTTAGGCAT
AGGACTGCACGGACTCGCC -> GGACTGCACGGACTCGCCG
AGGACTGCTACGGTCTATG -> GGACTGCTACGGTCTATGA
AGGACTTTTAAATACCTAC -> GGACTTTTAAATACCTACG
AGGAGAGGAACGGCACGTA -> GGAGAGGAACGGCACGTAG
AGGAGAGGCCCACACACGG -> GGAGAGGCCCACACACGGG
AGGAGAGGGAGTCCCTATA -> GGAGAGGGAGTCCCTATAG
AGGAGAGGTAGGTTGCATG -> GGAGAGGTAGGTTGCATGG
AGGAGGCAAGGCACGCGTA -> GGAGGCAAGGCACGCGTAT
AGGAGGCACTGTACGATCA -> GGAGGCACTGTACGATCAT
AGGAGGCATCATTTTCGCG -> GGAGGCATCATTTTCGCGA
AGGAGGCTCTGGCACGCCT -> GGAGGCTCTGGCACGCCTT
AGGATCCAGCGAAACCGAA -> GGATCCAGCGAAACCGAAC
AGGCAAGGCACGCGTATCA -> GGCAAGGCACGCGTATCAT
AGGCACGCGTATCATAAGA -> GGCACGCGTATCATAAGAT
AGGCACTGTACGATCATGA -> GGCACTGTACGATCATGAC
AGGCATCATTTTCGCGAGG -> GGCATCATTTTCGCGAGGG
AGGCATGATAGCTTAAGAG -> GGCATGATAGCTTAAGAGG
AGGCCCACACACGGGTTGG -> GGCCCACACACGGGTTGGC
AGGCCGCTAGGGACTAGTT -> GGCCGCTAGGGACTAGTTA
AGGCCGTCAAGACCGACCT -> GGCCGTCAAGACCGACCTC
AGGCCTACCCACGGATAAG -> GGCCTACCCACGGATAAGG
AGGCGACCCAAATTACTGG -> GGCGACCCAAATTACTGGT
AGGCGGACGCCCTCCTGCT -> GGCGGACGCCCTCCTGCTG
AGGCGTATGTTCACCGTTC -> GGCGTATGTTCACCGTTCC
AGGCTCGACGGCGTGGGCT -> GGCTCGACGGCGTGGGCTG
AGGCTCTGGCACGCCTTTC -> GGCTCTGGCACGCCTTTCA
AGGCTCTTAATTTAAAACT -> GGCTCTTAATTTAAAACTT
AGGGACTAGTTATCCTGGC -> GGGACTAGTTATCCTGGCA
AGGGAGTCCCTATAGTTGG -> GGGAGTCCCTATAGTTGGC
AGGGAGTTCTCACATGGGT -> GGGAGTTCTCACATGGGTA
AGGGATCTCCACAGGGCAT -> GGGATCTCCACAGGGCATG
AGGGCATGGAGCCTCTCCT -> GGGCATGGAGCCTCTCCTA
AGGGCCCCTTCGCGCTGCC -> GGGCCCCTTCGCGCTGCCC
AGGGGTCTGCTGTGACTTT -> GGGGTCTGCTGTGACTTTC
AGGTAATATGTCCCATAGG -> GGTAATATGTCCCATAGGC
AGGTAGGCGACCCAAATTA -> GGTAGGCGACCCAAATTAC
AGGTAGGTTGCATGGTTGG -> GGTAGGTTGCATGGTTGGC
AGGTATCAAGTGTAGGCCG -> GGTATCAAGTGTAGGCCGT
AGGTCGCATCCTCTGCCCA -> GGTCGCATCCTCTGCCCAG
AGGTGCGAAATCGTTATTG -> GGTGCGAAATCGTTATTGC
AGGTGTAAGTCTCAATGTT -> GGTGTAAGTCTCAATGTTC
AGGTTGCATGGTTGGCTCT -> GGTTGCATGGTTGGCTCTG
AGTAATTGATGTCGTTTAA -> GTAATTGATGTCGTTTAAT
AGTACAACGCACTCCTGAT -> GTACAACGCACTCCTGATT
AGTACATTTCCTGGTCAGG -> GTACATTTCCTGGTCAGGA
AGTACTTTTGAGTGGTTAA -> GTACTTTTGAGTGGTTAAG
AGTAGAGACGACGTCTGCG -> GTAGAGACGACGTCTGCGT
AGTATCTAAGAAGTTTGAG -> GTATCTAAGAAGTTTGAGT
AGTATTTGTTGGGGGGATA -> GTATTTGTTGGGGGGATAT
AGTCACCCTACACATATCC -> GTCACCCTACACATATCCG
AGTCCATTAGCTATCTAAC -> GTCCATTAGCTATCTAACC
AGTCCCTATAGTTGGCTCT -> GTCCCTATAGTTGGCTCTG
AGTCGGACTTTTAGCGCCG -> GTCGGACTTTTAGCGCCGT
AGTCTAGTGATGCGGCCCT -> GTCTAGTGATGCGGCCCTC
AGTCTCAATGTTCTAGCTT -> GTCTCAATGTTCTAGCTTT
AGTCTTAAAACGAACTATA -> GTCTTAAAACGAACTATAG
AGTGAAGACGGCGACCAAC -> GTGAAGACGGCGACCAACC
AGTGAGCAATGTGCTCATC -> GTGAGCAATGTGCTCATCG
AGTGATAGAGGTCGCATCC -> GTGATAGAGGTCGCATCCT
AGTGCATGCGGAGCGAGGA -> GTGCATGCGGAGCGAGGAT
AGTGGTGCCTGATGGAGGG -> GTGGTGCCTGATGGAGGGA
AGTGGTTAAGAATTTAGAA -> GTGGTTAAGAATTTAGAAT
AGTGTAGGCCGTCAAGACC -> GTGTAGGCCGTCAAGACCG
AGTGTCATGTGCCACTCGC -> GTGTCATGTGCCACTCGCA
AGTGTTGAGTGGTGCCTGA -> GTGTTGAGTGGTGCCTGAT
AGTGTTGGTTAAACAAGTT -> GTGTTGGTTAAACAAGTTG
AGTTATCCTGGCACCGTAA -> GTTATCCTGGCACCGTAAA
AGTTCCTGAGCAGCCCGTC -> GTTCCTGAGCAGCCCGTCG
AGTTCGTCATCCAAGCCCG -> GTTCGTCATCCAAGCCCGC
AGTTCGTCGATGAGACAAA -> GTTCGTCGATGAGACAAAT
AGTTCTCACATGGGTAAAT -> GTTCTCACATGGGTAAATT
AGTTCTGGCAACCTCTCAA -> GTTCTGGCAACCTCTCAAG
AGTTCTTTGAAAGAGATGA -> GTTCTTTGAAAGAGATGAT
AGTTGGCTCTGGAAGGAGG -> GTTGGCTCTGGAAGGAGGC,GTTGGCTCTGGAAGGAGGC
AGTTGGGATTCAGGTGTAA -> GTTGGGATTCAGGTGTAAG
AGTTTGAGTATTTGTTGGG -> GTTTGAGTATTTGTTGGGG
ATAAAAAGCTGTGATCTGC -> TAAAAAGCTGTGATCTGCT
ATAAAAGAAACGCCCCTAG -> TAAAAGAAACGCCCCTAGC
ATAAGATTACCATGGGGCG -> TAAGATTACCATGGGGCGT
ATAAGGCCGCTAGGGACTA -> TAAGGCCGCTAGGGACTAG
ATAAGTCTAGTGATGCGGC -> TAAGTCTAGTGATGCGGCC
ATAATAGTCACCCTACACA -> TAATAGTCACCCTACACAT
ATAATCCTATCATGCTTCG -> TAATCCTATCATGCTTCGC
ATAATTTGACTCGAGATGT -> TAATTTGACTCGAGATGTA
ATACCGACGCCGCGCTCCC -> TACCGACGCCGCGCTCCCT
ATACCTACGGGTAAGTTCC -> TACCTACGGGTAAGTTCCT
ATACTCGGTACTTGAGATG -> TACTCGGTACTTGAGATGC
ATACTTCGATGACGGCCGG -> TACTTCGATGACGGCCGGC
ATAGACTATGCTCGGGTGG -> TAGACTATGCTCGGGTGGA
ATAGAGGTCGCATCCTCTG -> TAGAGGTCGCATCCTCTGC
ATAGCATTAGCACCAAGAA -> TAGCATTAGCACCAAGAAG
ATAGCCTCCTATACTCGGT -> TAGCCTCCTATACTCGGTA
ATAGCTTAAGAGGGAGTTC -> TAGCTTAAGAGGGAGTTCT
ATAGGCTCGACGGCGTGGG -> TAGGCTCGACGGCGTGGGC
ATAGGCTCTTAATTTAAAA -> TAGGCTCTTAATTTAAAAC
ATAGTCACCCTACACATAT -> TAGTCACCCTACACATATC
ATAGTCCATTAGCTATCTA -> TAGTCCATTAGCTATCTAA
ATAGTGAAGACGGCGACCA -> TAGTGAAGACGGCGACCAA
ATAGTGTTGGTTAAACAAG -> TAGTGTTGGTTAAACAAGT
ATAGTTGGCTCTGGAAGGA -> TAGTTGGCTCTGGAAGGAG
ATATACCGACGCCGCGCTC -> TATACCGACGCCGCGCTCC
ATATAGTCCATTAGCTATC -> TATAGTCCATTAGCTATCT
ATATCATCTATCGGCTCTT -> TATCATCTATCGGCTCTTA
ATATCCGGATTGTGGAAGA -> TATCCGGATTGTGGAAGAG
ATATGTCCCATAGGCTCTT -> TATGTCCCATAGGCTCTTA
ATCAAGTGTAGGCCGTCAA -> TCAAGTGTAGGCCGTCAAG
ATCACCCTCCTTAGACGGT -> TCACCCTCCTTAGACGGTA
ATCATAAGATTACCATGGG -> TCATAAGATTACCATGGGG
ATCATCTATCGGCTCTTAT -> TCATCTATCGGCTCTTATT
ATCATGACATGCATCTTGC -> TCATGACATGCATCTTGCG
ATCATGCTTCGCACCGACT -> TCATGCTTCGCACCGACTT
ATCATTTTCGCGAGGGGTC -> TCATTTTCGCGAGGGGTCT
ATCCAAGCCCGCAGCGTCG -> TCCAAGCCCGCAGCGTCGT
ATCCAGCGAAACCGAACGC -> TCCAGCGAAACCGAACGCG
ATCCCTGTAACGCTTCTCG -> TCCCTGTAACGCTTCTCGA
ATCCGGATTGTGGAAGAGG -> TCCGGATTGTGGAAGAGGA
ATCCTATCATGCTTCGCAC -> TCCTATCATGCTTCGCACC
ATCCTCCACAGCAGAGGTA -> TCCTCCACAGCAGAGGTAA
ATCCTCTGCCCAGGCGGAC -> TCCTCTGCCCAGGCGGACG
ATCCTGGCACCGTAAACTA -> TCCTGGCACCGTAAACTAC
ATCGACTGTAGACGAAAAG -> TCGACTGTAGACGAAAAGT
ATCGCCCGGCATTCGATAA -> TCGCCCGGCATTCGATAAA
ATCGCTCTCAGTTCTGGCA -> TCGCTCTCAGTTCTGGCAA
ATCGGCCGAATAGCATTAG -> TCGGCCGAATAGCATTAGC
ATCGGCTCTTATTTCATCG -> TCGGCTCTTATTTCATCGC
ATCGGTAGAGTCGGACTTT -> TCGGTAGAGTCGGACTTTT
ATCGTTATTGCCGTGTACG -> TCGTTATTGCCGTGTACGG
ATCTAACCATGAATGGACC -> TCTAACCATGAATGGACCT
ATCTAAGAAGTTTGAGTAT -> TCTAAGAAGTTTGAGTATT
ATCTAATAATTTGACTCGA -> TCTAATAATTTGACTCGAG
ATCTATCGGCTCTTATTTC -> TCTATCGGCTCTTATTTCA
ATCTCCACAGGGCATGGAG -> TCTCCACAGGGCATGGAGC
ATCTCTGGATAATCCTATC -> TCTCTGGATAATCCTATCA
ATCTGCTGCCAGTATCTAA -> TCTGCTGCCAGTATCTAAG
ATCTTGCGGAAGTTCGTCA -> TCTTGCGGAAGTTCGTCAT
ATCTTGTGCAGATTTCAAG -> TCTTGTGCAGATTTCAAGA
ATGAATGATGGATTTCATG -> TGAATGATGGATTTCATGA
ATGAATGGACCTGACTCCG -> TGAATGGACCTGACTCCGG
ATGACATGCATCTTGCGGA -> TGACATGCATCTTGCGGAA
ATGACGGCCGGCTTAAAAG -> TGACGGCCGGCTTAAAAGT
ATGACGGGAGGACTGACCT -> TGACGGGAGGACTGACCTC
ATGACTAGCTACCTAGAGT -> TGACTAGCTACCTAGAGTA
ATGACTTCCGGGAACCAAT -> TGACTTCCGGGAACCAATC
ATGAGACAAATAGTGAAGA -> TGAGACAAATAGTGAAGAC
ATGATAGCTTAAGAGGGAG -> TGATAGCTTAAGAGGGAGT
ATGATAGGCTCGACGGCGT -> TGATAGGCTCGACGGCGTG
ATGATGAATGATGGATTTC -> TGATGAATGATGGATTTCA
ATGATGATAGGCTCGACGG -> TGATGATAGGCTCGACGGC
ATGATGGATTTCATGACGG -> TGATGGATTTCATGACGGG
ATGCATCTTGCGGAAGTTC -> TGCATCTTGCGGAAGTTCG
ATGCGAGGTATCAAGTGTA -> TGCGAGGTATCAAGTGTAG
ATGCGGAGCGAGGATCCAG -> TGCGGAGCGAGGATCCAGC
ATGCTCCCGATTGCGCAAG -> TGCTCCCGATTGCGCAAGA
ATGCTCGGGTGGAGTGTCA -> TGCTCGGGTGGAGTGTCAT
ATGCTTCGCACCGACTTCC -> TGCTTCGCACCGACTTCCA
ATGGACCTGACTCCGGAAT -> TGGACCTGACTCCGGAATT
ATGGACGGGCGCTATCTAA -> TGGACGGGCGCTATCTAAT
ATGGAGCCTCTCCTAATAT -> TGGAGCCTCTCCTAATATA
ATGGAGCGAGCCTAAGGTA -> TGGAGCGAGCCTAAGGTAG
ATGGAGGGATCTCCACAGG -> TGGAGGGATCTCCACAGGG
ATGGATTTCATGACGGGAG -> TGGATTTCATGACGGGAGG
ATGGGGCGTCGTCGTCGAC -> TGGGGCGTCGTCGTCGACG
ATGGGTAAATTTCTGACAG -> TGGGTAAATTTCTGACAGT
ATGGGTACGACGAGTGAGC -> TGGGTACGACGAGTGAGCA
ATGGTATAGTGTTGGTTAA -> TGGTATAGTGTTGGTTAAA
ATGGTTGGCTCTGGAAGGA -> TGGTTGGCTCTGGAAGGAG
ATGTACAAGCGCACCTCTT -> TGTACAAGCGCACCTCTTA
ATGTAGATTATAATAGTCA -> TGTAGATTATAATAGTCAC
ATGTAGTGATAGAGGTCGC -> TGTAGTGATAGAGGTCGCA
ATGTCCCATAGGCTCTTAA -> TGTCCCATAGGCTCTTAAT
ATGTCGTTTAATTACCGCC -> TGTCGTTTAATTACCGCCG
ATGTGCATGACTTCCGGGA -> TGTGCATGACTTCCGGGAA
ATGTGCCACTCGCACCTGG -> TGTGCCACTCGCACCTGGG
ATGTGCTCATCGGTAGAGT -> TGTGCTCATCGGTAGAGTC
ATGTTCACCGTTCCTGGAC -> TGTTCACCGTTCCTGGACT
ATGTTCTAGCTTTCACGTC -> TGTTCTAGCTTTCACGTCA
ATGTTGTACGTCCTAGTTC -> TGTTGTACGTCCTAGTTCT
ATTAATAGACTATGCTCGG -> TTAATAGACTATGCTCGGG
ATTACCATGGGGCGTCGTC -> TTACCATGGGGCGTCGTCG
ATTACCGCCGTAAACCCTA -> TTACCGCCGTAAACCCTAT
ATTACTGGTTTGGAGACTA -> TTACTGGTTTGGAGACTAC
ATTAGCACCAAGAAGGGCC -> TTAGCACCAAGAAGGGCCC
ATTAGCTATCTAACCATGA -> TTAGCTATCTAACCATGAA
ATTATAATAGTCACCCTAC -> TTATAATAGTCACCCTACA
ATTCAGAATTGTAGCTAAT -> TTCAGAATTGTAGCTAATC
ATTCAGGTGTAAGTCTCAA -> TTCAGGTGTAAGTCTCAAT
ATTCGATAAAAAGCTGTGA -> TTCGATAAAAAGCTGTGAT
ATTCTACGTGTGTTTCCTG -> TTCTACGTGTGTTTCCTGG
ATTGAGACCGGGAAGCAAA -> TTGAGACCGGGAAGCAAAG
ATTGAGTCTTAAAACGAAC -> TTGAGTCTTAAAACGAACT
ATTGATGTCGTTTAATTAC -> TTGATGTCGTTTAATTACC
ATTGCCGTGTACGGGTACG -> TTGCCGTGTACGGGTACGA
ATTGCGCAAGAATTGAGAC -> TTGCGCAAGAATTGAGACC
ATTGTAGCTAATCACCCTC -> TTGTAGCTAATCACCCTCC
ATTGTGGAAGAGGACTGCA -> TTGTGGAAGAGGACTGCAC
ATTTAAAACTTTATGTTGT -> TTTAAAACTTTATGTTGTA
ATTTAGAATGTAGATTATA -> TTTAGAATGTAGATTATAA
ATTTCAAGACTTGTGCCCC -> TTTCAAGACTTGTGCCCCT
ATTTCATCGCTCTCAGTTC -> TTTCATCGCTCTCAGTTCT
ATTTCATGACGGGAGGACT -> TTTCATGACGGGAGGACTG
ATTTCCTGGTCAGGAGAGG -> TTTCCTGGTCAGGAGAGGA
ATTTCGGAAAAACGTAATA -> TTTCGGAAAAACGTAATAA
ATTTCTGACAGTACTTTTG -> TTTCTGACAGTACTTTTGA
ATTTGACTCGAGATGTAGT -> TTTGACTCGAGATGTAGTG
ATTTGTTGGGGGGATATAC -> TTTGTTGGGGGGATATACC
ATTTTCGCGAGGGGTCTGC -> TTTTCGCGAGGGGTCTGCT
CAAAGACTGGAGTGCATGC -> AAAGACTGGAGTGCATGCG
CAAATAGTGAAGACGGCGA -> AAATAGTGAAGACGGCGAC
CAAATTACTGGTTTGGAGA -> AAATTACTGGTTTGGAGAC
CAACCGACAAGTAATTGAT -> AACCGACAAGTAATTGATG
CAACCTCTCAAGGCCTACC -> AACCTCTCAAGGCCTACCC
CAACGCACTCCTGATTCAG -> AACGCACTCCTGATTCAGA
CAAGAAGGGCCCCTTCGCG -> AAGAAGGGCCCCTTCGCGC
CAAGAATTGAGACCGGGAA -> AAGAATTGAGACCGGGAAG
CAAGACCGACCTCTTTGTG -> AAGACCGACCTCTTTGTGT
CAAGACGTCCGACCGGGCA -> AAGACGTCCGACCGGGCAT
CAAGACTTGTGCCCCTGGG -> AAGACTTGTGCCCCTGGGT
CAAGCCCGCAGCGTCGTAA -> AAGCCCGCAGCGTCGTAAC
CAAGCGCACCTCTTAATGA -> AAGCGCACCTCTTAATGAT
CAAGCTCCACTCTTGATGT -> AAGCTCCACTCTTGATGTG
CAAGGCACGCGTATCATAA -> AAGGCACGCGTATCATAAG
CAAGGCCTACCCACGGATA -> AAGGCCTACCCACGGATAA
CAAGTAATTGATGTCGTTT -> AAGTAATTGATGTCGTTTA
CAAGTGTAGGCCGTCAAGA -> AAGTGTAGGCCGTCAAGAC
CAAGTTGGGATTCAGGTGT -> AAGTTGGGATTCAGGTGTA
CAATCCCTGTAACGCTTCT -> AATCCCTGTAACGCTTCTC
CAATCCTCCACAGCAGAGG -> AATCCTCCACAGCAGAGGT
CAATGGACGGGCGCTATCT -> AATGGACGGGCGCTATCTA
CAATGTGCTCATCGGTAGA -> AATGTGCTCATCGGTAGAG
CAATGTTCTAGCTTTCACG -> AATGTTCTAGCTTTCACGT
CAATTAATAGACTATGCTC -> AATTAATAGACTATGCTCG
CACACACGGGTTGGCTCTG -> ACACACGGGTTGGCTCTGG
CACACGGGTTGGCTCTGGA -> ACACGGGTTGGCTCTGGAA
CACACTCGAGCCGCCTCTG -> ACACTCGAGCCGCCTCTGG
CACAGCAGAGGTAATATGT -> ACAGCAGAGGTAATATGTC
CACAGGGCATGGAGCCTCT -> ACAGGGCATGGAGCCTCTC
CACATATCCGGATTGTGGA -> ACATATCCGGATTGTGGAA
CACATGGGTAAATTTCTGA -> ACATGGGTAAATTTCTGAC
CACCAAGAAGGGCCCCTTC -> ACCAAGAAGGGCCCCTTCG
CACCAATGGACGGGCGCTA -> ACCAATGGACGGGCGCTAT
CACCCTACACATATCCGGA -> ACCCTACACATATCCGGAT
CACCCTCCTTAGACGGTAC -> ACCCTCCTTAGACGGTACT
CACCGACTTCCATGTACAA -> ACCGACTTCCATGTACAAG
CACCGAGCGGGTTTTTCGC -> ACCGAGCGGGTTTTTCGCG
CACCGTAAACTACCACACT -> ACCGTAAACTACCACACTC
CACCGTTCCTGGACTAGTG -> ACCGTTCCTGGACTAGTGT
CACCTCTTAATGATGAATG -> ACCTCTTAATGATGAATGA
CACCTGGGTGCTAGCAAGA -> ACCTGGGTGCTAGCAAGAC
CACGCCTTTCAATCCTCCA -> ACGCCTTTCAATCCTCCAC
CACGCGTATCATAAGATTA -> ACGCGTATCATAAGATTAC
CACGGACTCGCCGGGGCTG -> ACGGACTCGCCGGGGCTGT
CACGGATAAGGCCGCTAGG -> ACGGATAAGGCCGCTAGGG
CACGGGTTGGCTCTGGAAG -> ACGGGTTGGCTCTGGAAGG
CACGTAGTTGGCTCTGGAA -> ACGTAGTTGGCTCTGGAAG
CACGTCAAGCTCCACTCTT -> ACGTCAAGCTCCACTCTTG
CACTCCTGATTCAGAATTG -> ACTCCTGATTCAGAATTGT
CACTCGAGCCGCCTCTGGG -> ACTCGAGCCGCCTCTGGGT
CACTCGCACCTGGGTGCTA -> ACTCGCACCTGGGTGCTAG
CACTCTTGATGTGCATGAC -> ACTCTTGATGTGCATGACT
CACTGTACGATCATGACAT -> ACTGTACGATCATGACATG
CAGAATTGTAGCTAATCAC -> AGAATTGTAGCTAATCACC
CAGAGGTAATATGTCCCAT -> AGAGGTAATATGTCCCATA
CAGATTTCAAGACTTGTGC -> AGATTTCAAGACTTGTGCC
CAGCAGAGGTAATATGTCC -> AGCAGAGGTAATATGTCCC
CAGCCCGTCGCCTACTTGA -> AGCCCGTCGCCTACTTGAA
CAGCGAAACCGAACGCGTT -> AGCGAAACCGAACGCGTTT
CAGCGTCGTAACCCCGTTT -> AGCGTCGTAACCCCGTTTT
CAGGAGAGGAACGGCACGT -> AGGAGAGGAACGGCACGTA
CAGGAGAGGCCCACACACG -> AGGAGAGGCCCACACACGG
CAGGAGAGGGAGTCCCTAT -> AGGAGAGGGAGTCCCTATA
CAGGAGAGGTAGGTTGCAT -> AGGAGAGGTAGGTTGCATG
CAGGCGGACGCCCTCCTGC -> AGGCGGACGCCCTCCTGCT
CAGGCGTATGTTCACCGTT -> AGGCGTATGTTCACCGTTC
CAGGGCATGGAGCCTCTCC -> AGGGCATGGAGCCTCTCCT
CAGGTGCGAAATCGTTATT -> AGGTGCGAAATCGTTATTG
CAGGTGTAAGTCTCAATGT -> AGGTGTAAGTCTCAATGTT
CAGTACTTTTGAGTGGTTA -> AGTACTTTTGAGTGGTTAA
CAGTAGAGACGACGTCTGC -> AGTAGAGACGACGTCTGCG
CAGTATCTAAGAAGTTTGA -> AGTATCTAAGAAGTTTGAG
CAGTTCTGGCAACCTCTCA -> AGTTCTGGCAACCTCTCAA
CATAAGATTACCATGGGGC -> ATAAGATTACCATGGGGCG
CATAGGCTCTTAATTTAAA -> ATAGGCTCTTAATTTAAAA
CATATCCGGATTGTGGAAG -> ATATCCGGATTGTGGAAGA
CATCATTTTCGCGAGGGGT -> ATCATTTTCGCGAGGGGTC
CATCCAAGCCCGCAGCGTC -> ATCCAAGCCCGCAGCGTCG
CATCCTCTGCCCAGGCGGA -> ATCCTCTGCCCAGGCGGAC
CATCGCCCGGCATTCGATA -> ATCGCCCGGCATTCGATAA
CATCGCTCTCAGTTCTGGC -> ATCGCTCTCAGTTCTGGCA
CATCGGTAGAGTCGGACTT -> ATCGGTAGAGTCGGACTTT
CATCTATCGGCTCTTATTT -> ATCTATCGGCTCTTATTTC
CATCTTGCGGAAGTTCGTC -> ATCTTGCGGAAGTTCGTCA
CATGAATGGACCTGACTCC -> ATGAATGGACCTGACTCCG
CATGACATGCATCTTGCGG -> ATGACATGCATCTTGCGGA
CATGACGGGAGGACTGACC -> ATGACGGGAGGACTGACCT
CATGACTTCCGGGAACCAA -> ATGACTTCCGGGAACCAAT
CATGATAGCTTAAGAGGGA -> ATGATAGCTTAAGAGGGAG
CATGCATCTTGCGGAAGTT -> ATGCATCTTGCGGAAGTTC
CATGCGGAGCGAGGATCCA -> ATGCGGAGCGAGGATCCAG
CATGCTTCGCACCGACTTC -> ATGCTTCGCACCGACTTCC
CATGGAGCCTCTCCTAATA -> ATGGAGCCTCTCCTAATAT
CATGGAGCGAGCCTAAGGT -> ATGGAGCGAGCCTAAGGTA
CATGGGGCGTCGTCGTCGA -> ATGGGGCGTCGTCGTCGAC
CATGGGTAAATTTCTGACA -> ATGGGTAAATTTCTGACAG
CATGGGTACGACGAGTGAG -> ATGGGTACGACGAGTGAGC
CATGGTTGGCTCTGGAAGG -> ATGGTTGGCTCTGGAAGGA
CATGTACAAGCGCACCTCT -> ATGTACAAGCGCACCTCTT
CATGTGCCACTCGCACCTG -> ATGTGCCACTCGCACCTGG
CATTAGCACCAAGAAGGGC -> ATTAGCACCAAGAAGGGCC
CATTAGCTATCTAACCATG -> ATTAGCTATCTAACCATGA
CATTCGATAAAAAGCTGTG -> ATTCGATAAAAAGCTGTGA
CATTTCCTGGTCAGGAGAG -> ATTTCCTGGTCAGGAGAGG
CATTTTCGCGAGGGGTCTG -> ATTTTCGCGAGGGGTCTGC
CCAAATTACTGGTTTGGAG -> CAAATTACTGGTTTGGAGA
CCAACCGACAAGTAATTGA -> CAACCGACAAGTAATTGAT
CCAAGAAGGGCCCCTTCGC -> CAAGAAGGGCCCCTTCGCG
CCAAGCCCGCAGCGTCGTA -> CAAGCCCGCAGCGTCGTAA
CCAATCCCTGTAACGCTTC -> CAATCCCTGTAACGCTTCT
CCAATGGACGGGCGCTATC -> CAATGGACGGGCGCTATCT
CCAATTAATAGACTATGCT -> CAATTAATAGACTATGCTC
CCACACACGGGTTGGCTCT -> CACACACGGGTTGGCTCTG
CCACACTCGAGCCGCCTCT -> CACACTCGAGCCGCCTCTG
CCACAGCAGAGGTAATATG -> CACAGCAGAGGTAATATGT
CCACAGGGCATGGAGCCTC -> CACAGGGCATGGAGCCTCT
CCACCGAGCGGGTTTTTCG -> CACCGAGCGGGTTTTTCGC
CCACGGATAAGGCCGCTAG -> CACGGATAAGGCCGCTAGG
CCACTCGCACCTGGGTGCT -> CACTCGCACCTGGGTGCTA
CCACTCTTGATGTGCATGA -> CACTCTTGATGTGCATGAC
CCAGCGAAACCGAACGCGT -> CAGCGAAACCGAACGCGTT
CCAGGCGGACGCCCTCCTG -> CAGGCGGACGCCCTCCTGC
CCAGGTGCGAAATCGTTAT -> CAGGTGCGAAATCGTTATT
CCAGTAGAGACGACGTCTG -> CAGTAGAGACGACGTCTGC
CCAGTATCTAAGAAGTTTG -> CAGTATCTAAGAAGTTTGA
CCATAGGCTCTTAATTTAA -> CATAGGCTCTTAATTTAAA
CCATCGCCCGGCATTCGAT -> CATCGCCCGGCATTCGATA
CCATGAATGGACCTGACTC -> CATGAATGGACCTGACTCC
CCATGGGGCGTCGTCGTCG -> CATGGGGCGTCGTCGTCGA
CCATGTACAAGCGCACCTC -> CATGTACAAGCGCACCTCT
CCATTAGCTATCTAACCAT -> CATTAGCTATCTAACCATG
CCCAAATTACTGGTTTGGA -> CCAAATTACTGGTTTGGAG
CCCACACACGGGTTGGCTC -> CCACACACGGGTTGGCTCT
CCCACGGATAAGGCCGCTA -> CCACGGATAAGGCCGCTAG
CCCAGGCGGACGCCCTCCT -> CCAGGCGGACGCCCTCCTG
CCCAGGTGCGAAATCGTTA -> CCAGGTGCGAAATCGTTAT
CCCAGTAGAGACGACGTCT -> CCAGTAGAGACGACGTCTG
CCCATAGGCTCTTAATTTA -> CCATAGGCTCTTAATTTAA
CCCCGTTTTCCTGGTCAGG -> CCCGTTTTCCTGGTCAGGA
CCCCTAGCGGGCGACGGTA -> CCCTAGCGGGCGACGGTAT
CCCCTGGGTTATGCTCCCG -> CCCTGGGTTATGCTCCCGA
CCCCTTCGCGCTGCCCAGT -> CCCTTCGCGCTGCCCAGTA
CCCGATTGCGCAAGAATTG -> CCGATTGCGCAAGAATTGA
CCCGCAGCGTCGTAACCCC -> CCGCAGCGTCGTAACCCCG
CCCGGCATTCGATAAAAAG -> CCGGCATTCGATAAAAAGC
CCCGTCGCCTACTTGAATA -> CCGTCGCCTACTTGAATAA
CCCGTTTTCCTGGTCAGGA -> CCGTTTTCCTGGTCAGGAG
CCCTACACATATCCGGATT -> CCTACACATATCCGGATTG
CCCTACTATACTTCGATGA -> CCTACTATACTTCGATGAC
CCCTAGCGGGCGACGGTAT -> CCTAGCGGGCGACGGTATA
CCCTATAGTTGGCTCTGGA -> CCTATAGTTGGCTCTGGAA
CCCTATTGAGTCTTAAAAC -> CCTATTGAGTCTTAAAACG
CCCTCCTGCTGTGTCCACC -> CCTCCTGCTGTGTCCACCG
CCCTCCTTAGACGGTACTA -> CCTCCTTAGACGGTACTAT
CCCTGGGTTATGCTCCCGA -> CCTGGGTTATGCTCCCGAT
CCCTGTAACGCTTCTCGAT -> CCTGTAACGCTTCTCGATC
CCCTTCGCGCTGCCCAGTA -> CCTTCGCGCTGCCCAGTAG
CCGAACGCGTTTGACGGAT -> CGAACGCGTTTGACGGATC
CCGAATAGCATTAGCACCA -> CGAATAGCATTAGCACCAA
CCGACAAGTAATTGATGTC -> CGACAAGTAATTGATGTCG
CCGACCGGGCATGGAGCGA -> CGACCGGGCATGGAGCGAG
CCGACCTCTTTGTGTCTAA -> CGACCTCTTTGTGTCTAAA
CCGACGCCGCGCTCCCTAC -> CGACGCCGCGCTCCCTACT
CCGACTTCCATGTACAAGC -> CGACTTCCATGTACAAGCG
CCGAGCGGGTTTTTCGCGC -> CGAGCGGGTTTTTCGCGCG
CCGATTGCGCAAGAATTGA -> CGATTGCGCAAGAATTGAG
CCGCAGCGTCGTAACCCCG -> CGCAGCGTCGTAACCCCGT
CCGCCGTAAACCCTATTGA -> CGCCGTAAACCCTATTGAG
CCGCCTCTGGGTTCCATCG -> CGCCTCTGGGTTCCATCGC
CCGCGCTCCCTACTATACT -> CGCGCTCCCTACTATACTT
CCGCTAGGGACTAGTTATC -> CGCTAGGGACTAGTTATCC
CCGGAATTCTACGTGTGTT -> CGGAATTCTACGTGTGTTT
CCGGATTGTGGAAGAGGAC -> CGGATTGTGGAAGAGGACT
CCGGCATTCGATAAAAAGC -> CGGCATTCGATAAAAAGCT
CCGGCTTAAAAGTTCGTCG -> CGGCTTAAAAGTTCGTCGA
CCGGGAACCAATCCCTGTA -> CGGGAACCAATCCCTGTAA
CCGGGAAGCAAAGACTGGA -> CGGGAAGCAAAGACTGGAG
CCGGGCATGGAGCGAGCCT -> CGGGCATGGAGCGAGCCTA
CCGGGGCTGTGTCCGTACC -> CGGGGCTGTGTCCGTACCT
CCGTAAACCCTATTGAGTC -> CGTAAACCCTATTGAGTCT
CCGTAAACTACCACACTCG -> CGTAAACTACCACACTCGA
CCGTACCCAGGTGCGAAAT -> CGTACCCAGGTGCGAAATC
CCGTACCTAAGAAGGACTG -> CGTACCTAAGAAGGACTGC
CCGTCAAGACCGACCTCTT -> CGTCAAGACCGACCTCTTT
CCGTCGCCTACTTGAATAA -> CGTCGCCTACTTGAATAAA
CCGTGTACGGGTACGATGG -> CGTGTACGGGTACGATGGT
CCGTTCCTGGACTAGTGTT -> CGTTCCTGGACTAGTGTTG
CCGTTTTCCTGGTCAGGAG -> CGTTTTCCTGGTCAGGAGA
CCTAAGAAGGACTGCTACG -> CTAAGAAGGACTGCTACGG
CCTAAGGTAGGCGACCCAA -> CTAAGGTAGGCGACCCAAA
CCTAATATAGTCCATTAGC -> CTAATATAGTCCATTAGCT
CCTACACATATCCGGATTG -> CTACACATATCCGGATTGT
CCTACCCACGGATAAGGCC -> CTACCCACGGATAAGGCCG
CCTACGGGTAAGTTCCTGA -> CTACGGGTAAGTTCCTGAG
CCTACTATACTTCGATGAC -> CTACTATACTTCGATGACG
CCTACTTGAATAAAAGAAA -> CTACTTGAATAAAAGAAAC
CCTAGAGTACATTTCCTGG -> CTAGAGTACATTTCCTGGT
CCTAGCGGGCGACGGTATA -> CTAGCGGGCGACGGTATAT
CCTAGTTCTTTGAAAGAGA -> CTAGTTCTTTGAAAGAGAT
CCTATACTCGGTACTTGAG -> CTATACTCGGTACTTGAGA
CCTATAGTTGGCTCTGGAA -> CTATAGTTGGCTCTGGAAG
CCTATCATGCTTCGCACCG -> CTATCATGCTTCGCACCGA
CCTATTGAGTCTTAAAACG -> CTATTGAGTCTTAAAACGA
CCTCCACAGCAGAGGTAAT -> CTCCACAGCAGAGGTAATA
CCTCCTATACTCGGTACTT -> CTCCTATACTCGGTACTTG
CCTCCTGCTGTGTCCACCG -> CTCCTGCTGTGTCCACCGA
CCTCCTTAGACGGTACTAT -> CTCCTTAGACGGTACTATT
CCTCTCAAGGCCTACCCAC -> CTCTCAAGGCCTACCCACG
CCTCTCCTAATATAGTCCA -> CTCTCCTAATATAGTCCAT
CCTCTGCCCAGGCGGACGC -> CTCTGCCCAGGCGGACGCC
CCTCTGGGTTCCATCGCCC -> CTCTGGGTTCCATCGCCCG
CCTCTTAATGATGAATGAT -> CTCTTAATGATGAATGATG
CCTCTTAGGCATGATAGCT -> CTCTTAGGCATGATAGCTT
CCTCTTTGTGTCTAAACTC -> CTCTTTGTGTCTAAACTCT
CCTGACTCCGGAATTCTAC -> CTGACTCCGGAATTCTACG
CCTGAGCAGCCCGTCGCCT -> CTGAGCAGCCCGTCGCCTA
CCTGATGGAGGGATCTCCA -> CTGATGGAGGGATCTCCAC
CCTGATTCAGAATTGTAGC -> CTGATTCAGAATTGTAGCT
CCTGCTGTGTCCACCGAGC -> CTGCTGTGTCCACCGAGCG
CCTGGACTAGTGTTGAGTG -> CTGGACTAGTGTTGAGTGG
CCTGGCACCGTAAACTACC -> CTGGCACCGTAAACTACCA
CCTGGGTGCTAGCAAGACG -> CTGGGTGCTAGCAAGACGT
CCTGGGTTATGCTCCCGAT -> CTGGGTTATGCTCCCGATT
CCTGGTCAGGAGAGGAACG -> CTGGTCAGGAGAGGAACGG
CCTGGTCAGGAGAGGCCCA -> CTGGTCAGGAGAGGCCCAC
CCTGGTCAGGAGAGGGAGT -> CTGGTCAGGAGAGGGAGTC
CCTGGTCAGGAGAGGTAGG -> CTGGTCAGGAGAGGTAGGT
CCTGTAACGCTTCTCGATC -> CTGTAACGCTTCTCGATCG
CCTTAGACGGTACTATTTC -> CTTAGACGGTACTATTTCG
CCTTCGCGCTGCCCAGTAG -> CTTCGCGCTGCCCAGTAGA
CCTTTCAATCCTCCACAGC -> CTTTCAATCCTCCACAGCA
CGAAAAGTACAACGCACTC -> GAAAAGTACAACGCACTCC
CGAAACCGAACGCGTTTGA -> GAAACCGAACGCGTTTGAC
CGAAATCGTTATTGCCGTG -> GAAATCGTTATTGCCGTGT
CGAACAGGCGTATGTTCAC -> GAACAGGCGTATGTTCACC
CGAACGCGTTTGACGGATC -> GAACGCGTTTGACGGATCG
CGAACTATAGCCTCCTATA -> GAACTATAGCCTCCTATAC
CGAATAGCATTAGCACCAA -> GAATAGCATTAGCACCAAG
CGACAAGTAATTGATGTCG -> GACAAGTAATTGATGTCGT
CGACCAACCGACAAGTAAT -> GACCAACCGACAAGTAATT
CGACCCAAATTACTGGTTT -> GACCCAAATTACTGGTTTG
CGACCGGGCATGGAGCGAG -> GACCGGGCATGGAGCGAGC
CGACCTCTTTGTGTCTAAA -> GACCTCTTTGTGTCTAAAC
CGACGAACAGGCGTATGTT -> GACGAACAGGCGTATGTTC
CGACGAGTGAGCAATGTGC -> GACGAGTGAGCAATGTGCT
CGACGCCGCGCTCCCTACT -> GACGCCGCGCTCCCTACTA
CGACGGCGTGGGCTGGAAA -> GACGGCGTGGGCTGGAAAA
CGACGGTATATCATCTATC -> GACGGTATATCATCTATCG
CGACGTCACCAATGGACGG -> GACGTCACCAATGGACGGG
CGACGTCTGCGTTAATCTC -> GACGTCTGCGTTAATCTCT
CGACTGTAGACGAAAAGTA -> GACTGTAGACGAAAAGTAC
CGACTTCCATGTACAAGCG -> GACTTCCATGTACAAGCGC
CGAGATGTAGTGATAGAGG -> GAGATGTAGTGATAGAGGT
CGAGCCGCCTCTGGGTTCC -> GAGCCGCCTCTGGGTTCCA
CGAGCCTAAGGTAGGCGAC -> GAGCCTAAGGTAGGCGACC
CGAGCGGGTTTTTCGCGCG -> GAGCGGGTTTTTCGCGCGC
CGAGGATCCAGCGAAACCG -> GAGGATCCAGCGAAACCGA
CGAGGGGTCTGCTGTGACT -> GAGGGGTCTGCTGTGACTT
CGAGGTATCAAGTGTAGGC -> GAGGTATCAAGTGTAGGCC
CGAGTGAGCAATGTGCTCA -> GAGTGAGCAATGTGCTCAT
CGATAAAAAGCTGTGATCT -> GATAAAAAGCTGTGATCTG
CGATCATGACATGCATCTT -> GATCATGACATGCATCTTG
CGATCGGCCGAATAGCATT -> GATCGGCCGAATAGCATTA
CGATGACGGCCGGCTTAAA -> GATGACGGCCGGCTTAAAA
CGATGAGACAAATAGTGAA -> GATGAGACAAATAGTGAAG
CGATGGTATAGTGTTGGTT -> GATGGTATAGTGTTGGTTA
CGATTGCGCAAGAATTGAG -> GATTGCGCAAGAATTGAGA
CGCAAGAATTGAGACCGGG -> GCAAGAATTGAGACCGGGA
CGCACCGACTTCCATGTAC -> GCACCGACTTCCATGTACA
CGCACCTCTTAATGATGAA -> GCACCTCTTAATGATGAAT
CGCACCTGGGTGCTAGCAA -> GCACCTGGGTGCTAGCAAG
CGCACTCCTGATTCAGAAT -> GCACTCCTGATTCAGAATT
CGCAGCGTCGTAACCCCGT -> GCAGCGTCGTAACCCCGTT
CGCATCCTCTGCCCAGGCG -> GCATCCTCTGCCCAGGCGG
CGCCCCTAGCGGGCGACGG -> GCCCCTAGCGGGCGACGGT
CGCCCGGCATTCGATAAAA -> GCCCGGCATTCGATAAAAA
CGCCCTCCTGCTGTGTCCA -> GCCCTCCTGCTGTGTCCAC
CGCCGCGCTCCCTACTATA -> GCCGCGCTCCCTACTATAC
CGCCGGGGCTGTGTCCGTA -> GCCGGGGCTGTGTCCGTAC
CGCCGTAAACCCTATTGAG -> GCCGTAAACCCTATTGAGT
CGCCGTACCCAGGTGCGAA -> GCCGTACCCAGGTGCGAAA
CGCCTACTTGAATAAAAGA -> GCCTACTTGAATAAAAGAA
CGCCTCTGGGTTCCATCGC -> GCCTCTGGGTTCCATCGCC
CGCCTTTCAATCCTCCACA -> GCCTTTCAATCCTCCACAG
CGCGAGGGGTCTGCTGTGA -> GCGAGGGGTCTGCTGTGAC
CGCGCGCTCCAATTAATAG -> GCGCGCTCCAATTAATAGA
CGCGCTCCAATTAATAGAC -> GCGCTCCAATTAATAGACT
CGCGCTCCCTACTATACTT -> GCGCTCCCTACTATACTTC
CGCGCTGCCCAGTAGAGAC -> GCGCTGCCCAGTAGAGACG
CGCGTATCATAAGATTACC -> GCGTATCATAAGATTACCA
CGCGTTTGACGGATCGACT -> GCGTTTGACGGATCGACTG
CGCTAGGGACTAGTTATCC -> GCTAGGGACTAGTTATCCT
CGCTATCTAATAATTTGAC -> GCTATCTAATAATTTGACT
CGCTCCAATTAATAGACTA -> GCTCCAATTAATAGACTAT
CGCTCCCTACTATACTTCG -> GCTCCCTACTATACTTCGA
CGCTCTCAGTTCTGGCAAC -> GCTCTCAGTTCTGGCAACC
CGCTGCCCAGTAGAGACGA -> GCTGCCCAGTAGAGACGAC
CGCTTCTCGATCGGCCGAA -> GCTTCTCGATCGGCCGAAT
CGGAAAAACGTAATAAGTC -> GGAAAAACGTAATAAGTCT
CGGAAGTTCGTCATCCAAG -> GGAAGTTCGTCATCCAAGC
CGGAATTCTACGTGTGTTT -> GGAATTCTACGTGTGTTTC
CGGACGCCCTCCTGCTGTG -> GGACGCCCTCCTGCTGTGT
CGGACTCGCCGGGGCTGTG -> GGACTCGCCGGGGCTGTGT
CGGACTTTTAGCGCCGTAC -> GGACTTTTAGCGCCGTACC
CGGAGCGAGGATCCAGCGA -> GGAGCGAGGATCCAGCGAA
CGGATAAGGCCGCTAGGGA -> GGATAAGGCCGCTAGGGAC
CGGATCGACTGTAGACGAA -> GGATCGACTGTAGACGAAA
CGGATTGTGGAAGAGGACT -> GGATTGTGGAAGAGGACTG
CGGCACGTAGTTGGCTCTG -> GGCACGTAGTTGGCTCTGG
CGGCATTCGATAAAAAGCT -> GGCATTCGATAAAAAGCTG
CGGCCGAATAGCATTAGCA -> GGCCGAATAGCATTAGCAC
CGGCCGGCTTAAAAGTTCG -> GGCCGGCTTAAAAGTTCGT
CGGCGACCAACCGACAAGT -> GGCGACCAACCGACAAGTA
CGGCGTGGGCTGGAAAAGA -> GGCGTGGGCTGGAAAAGAC
CGGCTCTTATTTCATCGCT -> GGCTCTTATTTCATCGCTC
CGGCTTAAAAGTTCGTCGA -> GGCTTAAAAGTTCGTCGAT
CGGGAACCAATCCCTGTAA -> GGGAACCAATCCCTGTAAC
CGGGAAGCAAAGACTGGAG -> GGGAAGCAAAGACTGGAGT
CGGGAGGACTGACCTCTTA -> GGGAGGACTGACCTCTTAG
CGGGCATGGAGCGAGCCTA -> GGGCATGGAGCGAGCCTAA
CGGGCGACGGTATATCATC -> GGGCGACGGTATATCATCT
CGGGCGCTATCTAATAATT -> GGGCGCTATCTAATAATTT
CGGGGCTGTGTCCGTACCT -> GGGGCTGTGTCCGTACCTA
CGGGTAAGTTCCTGAGCAG -> GGGTAAGTTCCTGAGCAGC
CGGGTACGATGGTATAGTG -> GGGTACGATGGTATAGTGT
CGGGTGGAGTGTCATGTGC -> GGGTGGAGTGTCATGTGCC
CGGGTTGGCTCTGGAAGGA -> GGGTTGGCTCTGGAAGGAG
CGGGTTTTTCGCGCGCTCC -> GGGTTTTTCGCGCGCTCCA
CGGTACTATTTCGGAAAAA -> GGTACTATTTCGGAAAAAC
CGGTACTTGAGATGCGAGG -> GGTACTTGAGATGCGAGGT
CGGTAGAGTCGGACTTTTA -> GGTAGAGTCGGACTTTTAG
CGGTATATCATCTATCGGC -> GGTATATCATCTATCGGCT
CGGTCTATGACTAGCTACC -> GGTCTATGACTAGCTACCT
CGTAAACCCTATTGAGTCT -> GTAAACCCTATTGAGTCTT
CGTAAACTACCACACTCGA -> GTAAACTACCACACTCGAG
CGTAACCCCGTTTTCCTGG -> GTAACCCCGTTTTCCTGGT
CGTAATAAGTCTAGTGATG -> GTAATAAGTCTAGTGATGC
CGTACCCAGGTGCGAAATC -> GTACCCAGGTGCGAAATCG
CGTACCTAAGAAGGACTGC -> GTACCTAAGAAGGACTGCT
CGTAGTTGGCTCTGGAAGG -> GTAGTTGGCTCTGGAAGGA
CGTATCATAAGATTACCAT -> GTATCATAAGATTACCATG
CGTATGTTCACCGTTCCTG -> GTATGTTCACCGTTCCTGG
CGTCAAGACCGACCTCTTT -> GTCAAGACCGACCTCTTTG
CGTCAAGCTCCACTCTTGA -> GTCAAGCTCCACTCTTGAT
CGTCACCAATGGACGGGCG -> GTCACCAATGGACGGGCGC
CGTCATCCAAGCCCGCAGC -> GTCATCCAAGCCCGCAGCG
CGTCCGACCGGGCATGGAG -> GTCCGACCGGGCATGGAGC
CGTCCTAGTTCTTTGAAAG -> GTCCTAGTTCTTTGAAAGA
CGTCGACGTCACCAATGGA -> GTCGACGTCACCAATGGAC
CGTCGATGAGACAAATAGT -> GTCGATGAGACAAATAGTG
CGTCGCCTACTTGAATAAA -> GTCGCCTACTTGAATAAAA
CGTCGTAACCCCGTTTTCC -> GTCGTAACCCCGTTTTCCT
CGTCGTCGACGTCACCAAT -> GTCGTCGACGTCACCAATG
CGTCGTCGTCGACGTCACC -> GTCGTCGTCGACGTCACCA
CGTCTGCGTTAATCTCTGG -> GTCTGCGTTAATCTCTGGA
CGTGGGCTGGAAAAGACTG -> GTGGGCTGGAAAAGACTGA
CGTGTACGGGTACGATGGT -> GTGTACGGGTACGATGGTA
CGTGTGTTTCCTGGTCAGG -> GTGTGTTTCCTGGTCAGGA
CGTTAATCTCTGGATAATC -> GTTAATCTCTGGATAATCC
CGTTATTGCCGTGTACGGG -> GTTATTGCCGTGTACGGGT
CGTTCCTGGACTAGTGTTG -> GTTCCTGGACTAGTGTTGA
CGTTTAATTACCGCCGTAA -> GTTTAATTACCGCCGTAAA
CGTTTGACGGATCGACTGT -> GTTTGACGGATCGACTGTA
CGTTTTCCTGGTCAGGAGA -> GTTTTCCTGGTCAGGAGAG
CTAAACTCTTCATGGGTAC -> TAAACTCTTCATGGGTACG
CTAACCATGAATGGACCTG -> TAACCATGAATGGACCTGA
CTAAGAAGGACTGCTACGG -> TAAGAAGGACTGCTACGGT
CTAAGAAGTTTGAGTATTT -> TAAGAAGTTTGAGTATTTG
CTAAGGTAGGCGACCCAAA -> TAAGGTAGGCGACCCAAAT
CTAATAATTTGACTCGAGA -> TAATAATTTGACTCGAGAT
CTAATATAGTCCATTAGCT -> TAATATAGTCCATTAGCTA
CTAATCACCCTCCTTAGAC -> TAATCACCCTCCTTAGACG
CTACACATATCCGGATTGT -> TACACATATCCGGATTGTG
CTACCACACTCGAGCCGCC -> TACCACACTCGAGCCGCCT
CTACCCACGGATAAGGCCG -> TACCCACGGATAAGGCCGC
CTACCTAGAGTACATTTCC -> TACCTAGAGTACATTTCCT
CTACGACGAACAGGCGTAT -> TACGACGAACAGGCGTATG
CTACGGGTAAGTTCCTGAG -> TACGGGTAAGTTCCTGAGC
CTACGGTCTATGACTAGCT -> TACGGTCTATGACTAGCTA
CTACGTGTGTTTCCTGGTC -> TACGTGTGTTTCCTGGTCA
CTACTATACTTCGATGACG -> TACTATACTTCGATGACGG
CTACTTGAATAAAAGAAAC -> TACTTGAATAAAAGAAACG
CTAGAGTACATTTCCTGGT -> TAGAGTACATTTCCTGGTC
CTAGCAAGACGTCCGACCG -> TAGCAAGACGTCCGACCGG
CTAGCGGGCGACGGTATAT -> TAGCGGGCGACGGTATATC
CTAGCTACCTAGAGTACAT -> TAGCTACCTAGAGTACATT
CTAGCTTTCACGTCAAGCT -> TAGCTTTCACGTCAAGCTC
CTAGGGACTAGTTATCCTG -> TAGGGACTAGTTATCCTGG
CTAGTGTTGAGTGGTGCCT -> TAGTGTTGAGTGGTGCCTG
CTAGTTATCCTGGCACCGT -> TAGTTATCCTGGCACCGTA
CTAGTTCTTTGAAAGAGAT -> TAGTTCTTTGAAAGAGATG
CTATACTCGGTACTTGAGA -> TATACTCGGTACTTGAGAT
CTATACTTCGATGACGGCC -> TATACTTCGATGACGGCCG
CTATAGCCTCCTATACTCG -> TATAGCCTCCTATACTCGG
CTATAGTTGGCTCTGGAAG -> TATAGTTGGCTCTGGAAGG
CTATCATGCTTCGCACCGA -> TATCATGCTTCGCACCGAC
CTATCGGCTCTTATTTCAT -> TATCGGCTCTTATTTCATC
CTATCTAACCATGAATGGA -> TATCTAACCATGAATGGAC
CTATCTAATAATTTGACTC -> TATCTAATAATTTGACTCG
CTATGACTAGCTACCTAGA -> TATGACTAGCTACCTAGAG
CTATGCTCGGGTGGAGTGT -> TATGCTCGGGTGGAGTGTC
CTATTGAGTCTTAAAACGA -> TATTGAGTCTTAAAACGAA
CTATTTCGGAAAAACGTAA -> TATTTCGGAAAAACGTAAT
CTCAAGGCCTACCCACGGA -> TCAAGGCCTACCCACGGAT
CTCAATGTTCTAGCTTTCA -> TCAATGTTCTAGCTTTCAC
CTCACATGGGTAAATTTCT -> TCACATGGGTAAATTTCTG
CTCAGTTCTGGCAACCTCT -> TCAGTTCTGGCAACCTCTC
CTCATCGGTAGAGTCGGAC -> TCATCGGTAGAGTCGGACT
CTCCAATTAATAGACTATG -> TCCAATTAATAGACTATGC
CTCCACAGCAGAGGTAATA -> TCCACAGCAGAGGTAATAT
CTCCACAGGGCATGGAGCC -> TCCACAGGGCATGGAGCCT
CTCCACTCTTGATGTGCAT -> TCCACTCTTGATGTGCATG
CTCCCGATTGCGCAAGAAT -> TCCCGATTGCGCAAGAATT
CTCCCTACTATACTTCGAT -> TCCCTACTATACTTCGATG
CTCCGGAATTCTACGTGTG -> TCCGGAATTCTACGTGTGT
CTCCTAATATAGTCCATTA -> TCCTAATATAGTCCATTAG
CTCCTATACTCGGTACTTG -> TCCTATACTCGGTACTTGA
CTCCTGATTCAGAATTGTA -> TCCTGATTCAGAATTGTAG
CTCCTGCTGTGTCCACCGA -> TCCTGCTGTGTCCACCGAG
CTCCTTAGACGGTACTATT -> TCCTTAGACGGTACTATTT
CTCGACGGCGTGGGCTGGA -> TCGACGGCGTGGGCTGGAA
CTCGAGATGTAGTGATAGA -> TCGAGATGTAGTGATAGAG
CTCGAGCCGCCTCTGGGTT -> TCGAGCCGCCTCTGGGTTC
CTCGATCGGCCGAATAGCA -> TCGATCGGCCGAATAGCAT
CTCGCACCTGGGTGCTAGC -> TCGCACCTGGGTGCTAGCA
CTCGCCGGGGCTGTGTCCG -> TCGCCGGGGCTGTGTCCGT
CTCGGGTGGAGTGTCATGT -> TCGGGTGGAGTGTCATGTG
CTCGGTACTTGAGATGCGA -> TCGGTACTTGAGATGCGAG
CTCTCAAGGCCTACCCACG -> TCTCAAGGCCTACCCACGG
CTCTCAGTTCTGGCAACCT -> TCTCAGTTCTGGCAACCTC
CTCTCCTAATATAGTCCAT -> TCTCCTAATATAGTCCATT
CTCTGCCCAGGCGGACGCC -> TCTGCCCAGGCGGACGCCC
CTCTGGAAGGAGGCAAGGC -> TCTGGAAGGAGGCAAGGCA
CTCTGGAAGGAGGCACTGT -> TCTGGAAGGAGGCACTGTA
CTCTGGAAGGAGGCATCAT -> TCTGGAAGGAGGCATCATT
CTCTGGAAGGAGGCTCTGG -> TCTGGAAGGAGGCTCTGGC
CTCTGGATAATCCTATCAT -> TCTGGATAATCCTATCATG
CTCTGGCACGCCTTTCAAT -> TCTGGCACGCCTTTCAATC
CTCTGGGTTCCATCGCCCG -> TCTGGGTTCCATCGCCCGG
CTCTTAATGATGAATGATG -> TCTTAATGATGAATGATGG
CTCTTAATTTAAAACTTTA -> TCTTAATTTAAAACTTTAT
CTCTTAGGCATGATAGCTT -> TCTTAGGCATGATAGCTTA
CTCTTATTTCATCGCTCTC -> TCTTATTTCATCGCTCTCA
CTCTTCATGGGTACGACGA -> TCTTCATGGGTACGACGAG
CTCTTGATGTGCATGACTT -> TCTTGATGTGCATGACTTC
CTCTTTGTGTCTAAACTCT -> TCTTTGTGTCTAAACTCTT
CTGACAGTACTTTTGAGTG -> TGACAGTACTTTTGAGTGG
CTGACCTCTTAGGCATGAT -> TGACCTCTTAGGCATGATA
CTGACTCCGGAATTCTACG -> TGACTCCGGAATTCTACGT
CTGAGCAGCCCGTCGCCTA -> TGAGCAGCCCGTCGCCTAC
CTGATCTTGTGCAGATTTC -> TGATCTTGTGCAGATTTCA
CTGATGGAGGGATCTCCAC -> TGATGGAGGGATCTCCACA
CTGATTCAGAATTGTAGCT -> TGATTCAGAATTGTAGCTA
CTGCACGGACTCGCCGGGG -> TGCACGGACTCGCCGGGGC
CTGCCAGTATCTAAGAAGT -> TGCCAGTATCTAAGAAGTT
CTGCCCAGGCGGACGCCCT -> TGCCCAGGCGGACGCCCTC
CTGCCCAGTAGAGACGACG -> TGCCCAGTAGAGACGACGT
CTGCGTTAATCTCTGGATA -> TGCGTTAATCTCTGGATAA
CTGCTACGGTCTATGACTA -> TGCTACGGTCTATGACTAG
CTGCTGCCAGTATCTAAGA -> TGCTGCCAGTATCTAAGAA
CTGCTGTGACTTTCCTGGT -> TGCTGTGACTTTCCTGGTC
CTGCTGTGTCCACCGAGCG -> TGCTGTGTCCACCGAGCGG
CTGGAAAAGACTGATCTTG -> TGGAAAAGACTGATCTTGT
CTGGAAGGAGGCAAGGCAC -> TGGAAGGAGGCAAGGCACG
CTGGAAGGAGGCACTGTAC -> TGGAAGGAGGCACTGTACG
CTGGAAGGAGGCATCATTT -> TGGAAGGAGGCATCATTTT
CTGGAAGGAGGCTCTGGCA -> TGGAAGGAGGCTCTGGCAC
CTGGACTAGTGTTGAGTGG -> TGGACTAGTGTTGAGTGGT
CTGGAGTGCATGCGGAGCG -> TGGAGTGCATGCGGAGCGA
CTGGATAATCCTATCATGC -> TGGATAATCCTATCATGCT
CTGGCAACCTCTCAAGGCC -> TGGCAACCTCTCAAGGCCT
CTGGCACCGTAAACTACCA -> TGGCACCGTAAACTACCAC
CTGGCACGCCTTTCAATCC -> TGGCACGCCTTTCAATCCT
CTGGGTGCTAGCAAGACGT -> TGGGTGCTAGCAAGACGTC
CTGGGTTATGCTCCCGATT -> TGGGTTATGCTCCCGATTG
CTGGGTTCCATCGCCCGGC -> TGGGTTCCATCGCCCGGCA
CTGGTCAGGAGAGGAACGG -> TGGTCAGGAGAGGAACGGC
CTGGTCAGGAGAGGCCCAC -> TGGTCAGGAGAGGCCCACA
CTGGTCAGGAGAGGGAGTC -> TGGTCAGGAGAGGGAGTCC
CTGGTCAGGAGAGGTAGGT -> TGGTCAGGAGAGGTAGGTT
CTGGTTTGGAGACTACGAC -> TGGTTTGGAGACTACGACG
CTGTAACGCTTCTCGATCG -> TGTAACGCTTCTCGATCGG
CTGTACGATCATGACATGC -> TGTACGATCATGACATGCA
CTGTAGACGAAAAGTACAA -> TGTAGACGAAAAGTACAAC
CTGTGACTTTCCTGGTCAG -> TGTGACTTTCCTGGTCAGG
CTGTGATCTGCTGCCAGTA -> TGTGATCTGCTGCCAGTAT
CTGTGTCCACCGAGCGGGT -> TGTGTCCACCGAGCGGGTT
CTGTGTCCGTACCTAAGAA -> TGTGTCCGTACCTAAGAAG
CTTAAAACGAACTATAGCC -> TTAAAACGAACTATAGCCT
CTTAAAAGTTCGTCGATGA -> TTAAAAGTTCGTCGATGAG
CTTAAGAGGGAGTTCTCAC -> TTAAGAGGGAGTTCTCACA
CTTAATGATGAATGATGGA -> TTAATGATGAATGATGGAT
CTTAATTTAAAACTTTATG -> TTAATTTAAAACTTTATGT
CTTAGACGGTACTATTTCG -> TTAGACGGTACTATTTCGG
CTTAGGCATGATAGCTTAA -> TTAGGCATGATAGCTTAAG
CTTATTTCATCGCTCTCAG -> TTATTTCATCGCTCTCAGT
CTTCATGGGTACGACGAGT -> TTCATGGGTACGACGAGTG
CTTCCATGTACAAGCGCAC -> TTCCATGTACAAGCGCACC
CTTCCGGGAACCAATCCCT -> TTCCGGGAACCAATCCCTG
CTTCGATGACGGCCGGCTT -> TTCGATGACGGCCGGCTTA
CTTCGCACCGACTTCCATG -> TTCGCACCGACTTCCATGT
CTTCGCGCTGCCCAGTAGA -> TTCGCGCTGCCCAGTAGAG
CTTCTCGATCGGCCGAATA -> TTCTCGATCGGCCGAATAG
CTTGAATAAAAGAAACGCC -> TTGAATAAAAGAAACGCCC
CTTGAGATGCGAGGTATCA -> TTGAGATGCGAGGTATCAA
CTTGATGTGCATGACTTCC -> TTGATGTGCATGACTTCCG
CTTGCGGAAGTTCGTCATC -> TTGCGGAAGTTCGTCATCC
CTTGTGCAGATTTCAAGAC -> TTGTGCAGATTTCAAGACT
CTTGTGCCCCTGGGTTATG -> TTGTGCCCCTGGGTTATGC
CTTTATGTTGTACGTCCTA -> TTTATGTTGTACGTCCTAG
CTTTCAATCCTCCACAGCA -> TTTCAATCCTCCACAGCAG
CTTTCACGTCAAGCTCCAC -> TTTCACGTCAAGCTCCACT
CTTTCCTGGTCAGGAGAGG -> TTTCCTGGTCAGGAGAGGC
CTTTGAAAGAGATGATGAT -> TTTGAAAGAGATGATGATA
CTTTGTGTCTAAACTCTTC -> TTTGTGTCTAAACTCTTCA
CTTTTAAATACCTACGGGT -> TTTTAAATACCTACGGGTA
CTTTTAGCGCCGTACCCAG -> TTTTAGCGCCGTACCCAGG
CTTTTGAGTGGTTAAGAAT -> TTTTGAGTGGTTAAGAATT
GAAAAACGTAATAAGTCTA -> AAAAACGTAATAAGTCTAG
GAAAAGACTGATCTTGTGC -> AAAAGACTGATCTTGTGCA
GAAAAGTACAACGCACTCC -> AAAAGTACAACGCACTCCT
GAAACCGAACGCGTTTGAC -> AAACCGAACGCGTTTGACG
GAAACGCCCCTAGCGGGCG -> AAACGCCCCTAGCGGGCGA
GAAAGAGATGATGATAGGC -> AAAGAGATGATGATAGGCT
GAAATCGTTATTGCCGTGT -> AAATCGTTATTGCCGTGTA
GAACAGGCGTATGTTCACC -> AACAGGCGTATGTTCACCG
GAACCAATCCCTGTAACGC -> AACCAATCCCTGTAACGCT
GAACGCGTTTGACGGATCG -> AACGCGTTTGACGGATCGA
GAACGGCACGTAGTTGGCT -> AACGGCACGTAGTTGGCTC
GAACTATAGCCTCCTATAC -> AACTATAGCCTCCTATACT
GAAGACGGCGACCAACCGA -> AAGACGGCGACCAACCGAC
GAAGAGGACTGCACGGACT -> AAGAGGACTGCACGGACTC
GAAGCAAAGACTGGAGTGC -> AAGCAAAGACTGGAGTGCA
GAAGGACTGCTACGGTCTA -> AAGGACTGCTACGGTCTAT
GAAGGAGGCAAGGCACGCG -> AAGGAGGCAAGGCACGCGT
GAAGGAGGCACTGTACGAT -> AAGGAGGCACTGTACGATC
GAAGGAGGCATCATTTTCG -> AAGGAGGCATCATTTTCGC
GAAGGAGGCTCTGGCACGC -> AAGGAGGCTCTGGCACGCC
GAAGGGCCCCTTCGCGCTG -> AAGGGCCCCTTCGCGCTGC
GAAGTTCGTCATCCAAGCC -> AAGTTCGTCATCCAAGCCC
GAAGTTTGAGTATTTGTTG -> AAGTTTGAGTATTTGTTGG
GAATAAAAGAAACGCCCCT -> AATAAAAGAAACGCCCCTA
GAATAGCATTAGCACCAAG -> AATAGCATTAGCACCAAGA
GAATGATGGATTTCATGAC -> AATGATGGATTTCATGACG
GAATGGACCTGACTCCGGA -> AATGGACCTGACTCCGGAA
GAATGTAGATTATAATAGT -> AATGTAGATTATAATAGTC
GAATTCTACGTGTGTTTCC -> AATTCTACGTGTGTTTCCT
GAATTGAGACCGGGAAGCA -> AATTGAGACCGGGAAGCAA
GAATTGTAGCTAATCACCC -> AATTGTAGCTAATCACCCT
GAATTTAGAATGTAGATTA -> AATTTAGAATGTAGATTAT
GACAAATAGTGAAGACGGC -> ACAAATAGTGAAGACGGCG
GACAAGTAATTGATGTCGT -> ACAAGTAATTGATGTCGTT
GACAGTACTTTTGAGTGGT -> ACAGTACTTTTGAGTGGTT
GACATGCATCTTGCGGAAG -> ACATGCATCTTGCGGAAGT
GACCAACCGACAAGTAATT -> ACCAACCGACAAGTAATTG
GACCCAAATTACTGGTTTG -> ACCCAAATTACTGGTTTGG
GACCGACCTCTTTGTGTCT -> ACCGACCTCTTTGTGTCTA
GACCGGGAAGCAAAGACTG -> ACCGGGAAGCAAAGACTGG
GACCGGGCATGGAGCGAGC -> ACCGGGCATGGAGCGAGCC
GACCTCTTAGGCATGATAG -> ACCTCTTAGGCATGATAGC
GACCTCTTTGTGTCTAAAC -> ACCTCTTTGTGTCTAAACT
GACCTGACTCCGGAATTCT -> ACCTGACTCCGGAATTCTA
GACGAAAAGTACAACGCAC -> ACGAAAAGTACAACGCACT
GACGAACAGGCGTATGTTC -> ACGAACAGGCGTATGTTCA
GACGACGTCTGCGTTAATC -> ACGACGTCTGCGTTAATCT
GACGAGTGAGCAATGTGCT -> ACGAGTGAGCAATGTGCTC
GACGCCCTCCTGCTGTGTC -> ACGCCCTCCTGCTGTGTCC
GACGCCGCGCTCCCTACTA -> ACGCCGCGCTCCCTACTAT
GACGGATCGACTGTAGACG -> ACGGATCGACTGTAGACGA
GACGGCCGGCTTAAAAGTT -> ACGGCCGGCTTAAAAGTTC
GACGGCGACCAACCGACAA -> ACGGCGACCAACCGACAAG
GACGGCGTGGGCTGGAAAA -> ACGGCGTGGGCTGGAAAAG
GACGGGAGGACTGACCTCT -> ACGGGAGGACTGACCTCTT
GACGGGCGCTATCTAATAA -> ACGGGCGCTATCTAATAAT
GACGGTACTATTTCGGAAA -> ACGGTACTATTTCGGAAAA
GACGGTATATCATCTATCG -> ACGGTATATCATCTATCGG
GACGTCACCAATGGACGGG -> ACGTCACCAATGGACGGGC
GACGTCCGACCGGGCATGG -> ACGTCCGACCGGGCATGGA
GACGTCTGCGTTAATCTCT -> ACGTCTGCGTTAATCTCTG
GACTACGACGAACAGGCGT -> ACTACGACGAACAGGCGTA
GACTAGCTACCTAGAGTAC -> ACTAGCTACCTAGAGTACA
GACTAGTGTTGAGTGGTGC -> ACTAGTGTTGAGTGGTGCC
GACTAGTTATCCTGGCACC -> ACTAGTTATCCTGGCACCG
GACTATGCTCGGGTGGAGT -> ACTATGCTCGGGTGGAGTG
GACTCCGGAATTCTACGTG -> ACTCCGGAATTCTACGTGT
GACTCGAGATGTAGTGATA -> ACTCGAGATGTAGTGATAG
GACTCGCCGGGGCTGTGTC -> ACTCGCCGGGGCTGTGTCC
GACTGACCTCTTAGGCATG -> ACTGACCTCTTAGGCATGA
GACTGATCTTGTGCAGATT -> ACTGATCTTGTGCAGATTT
GACTGCACGGACTCGCCGG -> ACTGCACGGACTCGCCGGG
GACTGCTACGGTCTATGAC -> ACTGCTACGGTCTATGACT
GACTGGAGTGCATGCGGAG -> ACTGGAGTGCATGCGGAGC
GACTGTAGACGAAAAGTAC -> ACTGTAGACGAAAAGTACA
GACTTCCATGTACAAGCGC -> ACTTCCATGTACAAGCGCA
GACTTCCGGGAACCAATCC -> ACTTCCGGGAACCAATCCC
GACTTGTGCCCCTGGGTTA -> ACTTGTGCCCCTGGGTTAT
GACTTTCCTGGTCAGGAGA -> ACTTTCCTGGTCAGGAGAG
GACTTTTAAATACCTACGG -> ACTTTTAAATACCTACGGG
GACTTTTAGCGCCGTACCC -> ACTTTTAGCGCCGTACCCA
GAGACAAATAGTGAAGACG -> AGACAAATAGTGAAGACGG
GAGACCGGGAAGCAAAGAC -> AGACCGGGAAGCAAAGACT
GAGACGACGTCTGCGTTAA -> AGACGACGTCTGCGTTAAT
GAGACTACGACGAACAGGC -> AGACTACGACGAACAGGCG
GAGAGGAACGGCACGTAGT -> AGAGGAACGGCACGTAGTT
GAGAGGCCCACACACGGGT -> AGAGGCCCACACACGGGTT
GAGAGGGAGTCCCTATAGT -> AGAGGGAGTCCCTATAGTT
GAGAGGTAGGTTGCATGGT -> AGAGGTAGGTTGCATGGTT
GAGATGATGATAGGCTCGA -> AGATGATGATAGGCTCGAC
GAGATGCGAGGTATCAAGT -> AGATGCGAGGTATCAAGTG
GAGATGTAGTGATAGAGGT -> AGATGTAGTGATAGAGGTC
GAGCAATGTGCTCATCGGT -> AGCAATGTGCTCATCGGTA
GAGCAGCCCGTCGCCTACT -> AGCAGCCCGTCGCCTACTT
GAGCCGCCTCTGGGTTCCA -> AGCCGCCTCTGGGTTCCAT
GAGCCTAAGGTAGGCGACC -> AGCCTAAGGTAGGCGACCC
GAGCCTCTCCTAATATAGT -> AGCCTCTCCTAATATAGTC
GAGCGAGCCTAAGGTAGGC -> AGCGAGCCTAAGGTAGGCG
GAGCGAGGATCCAGCGAAA -> AGCGAGGATCCAGCGAAAC
GAGCGGGTTTTTCGCGCGC -> AGCGGGTTTTTCGCGCGCT
GAGGAACGGCACGTAGTTG -> AGGAACGGCACGTAGTTGG
GAGGACTGACCTCTTAGGC -> AGGACTGACCTCTTAGGCA
GAGGACTGCACGGACTCGC -> AGGACTGCACGGACTCGCC
GAGGATCCAGCGAAACCGA -> AGGATCCAGCGAAACCGAA
GAGGCAAGGCACGCGTATC -> AGGCAAGGCACGCGTATCA
GAGGCACTGTACGATCATG -> AGGCACTGTACGATCATGA
GAGGCATCATTTTCGCGAG -> AGGCATCATTTTCGCGAGG
GAGGCCCACACACGGGTTG -> AGGCCCACACACGGGTTGG
GAGGCTCTGGCACGCCTTT -> AGGCTCTGGCACGCCTTTC
GAGGGAGTCCCTATAGTTG -> AGGGAGTCCCTATAGTTGG
GAGGGAGTTCTCACATGGG -> AGGGAGTTCTCACATGGGT
GAGGGATCTCCACAGGGCA -> AGGGATCTCCACAGGGCAT
GAGGGGTCTGCTGTGACTT -> AGGGGTCTGCTGTGACTTT
GAGGTAATATGTCCCATAG -> AGGTAATATGTCCCATAGG
GAGGTAGGTTGCATGGTTG -> AGGTAGGTTGCATGGTTGG
GAGGTATCAAGTGTAGGCC -> AGGTATCAAGTGTAGGCCG
GAGGTCGCATCCTCTGCCC -> AGGTCGCATCCTCTGCCCA
GAGTACATTTCCTGGTCAG -> AGTACATTTCCTGGTCAGG
GAGTATTTGTTGGGGGGAT -> AGTATTTGTTGGGGGGATA
GAGTCCCTATAGTTGGCTC -> AGTCCCTATAGTTGGCTCT
GAGTCGGACTTTTAGCGCC -> AGTCGGACTTTTAGCGCCG
GAGTCTTAAAACGAACTAT -> AGTCTTAAAACGAACTATA
GAGTGAGCAATGTGCTCAT -> AGTGAGCAATGTGCTCATC
GAGTGCATGCGGAGCGAGG -> AGTGCATGCGGAGCGAGGA
GAGTGGTGCCTGATGGAGG -> AGTGGTGCCTGATGGAGGG
GAGTGGTTAAGAATTTAGA -> AGTGGTTAAGAATTTAGAA
GAGTGTCATGTGCCACTCG -> AGTGTCATGTGCCACTCGC
GAGTTCTCACATGGGTAAA -> AGTTCTCACATGGGTAAAT
GATAAAAAGCTGTGATCTG -> ATAAAAAGCTGTGATCTGC
GATAAGGCCGCTAGGGACT -> ATAAGGCCGCTAGGGACTA
GATAATCCTATCATGCTTC -> ATAATCCTATCATGCTTCG
GATAGAGGTCGCATCCTCT -> ATAGAGGTCGCATCCTCTG
GATAGCTTAAGAGGGAGTT -> ATAGCTTAAGAGGGAGTTC
GATAGGCTCGACGGCGTGG -> ATAGGCTCGACGGCGTGGG
GATATACCGACGCCGCGCT -> ATATACCGACGCCGCGCTC
GATCATGACATGCATCTTG -> ATCATGACATGCATCTTGC
GATCCAGCGAAACCGAACG -> ATCCAGCGAAACCGAACGC
GATCGACTGTAGACGAAAA -> ATCGACTGTAGACGAAAAG
GATCGGCCGAATAGCATTA -> ATCGGCCGAATAGCATTAG
GATCTCCACAGGGCATGGA -> ATCTCCACAGGGCATGGAG
GATCTGCTGCCAGTATCTA -> ATCTGCTGCCAGTATCTAA
GATCTTGTGCAGATTTCAA -> ATCTTGTGCAGATTTCAAG
GATGAATGATGGATTTCAT -> ATGAATGATGGATTTCATG
GATGACGGCCGGCTTAAAA -> ATGACGGCCGGCTTAAAAG
GATGAGACAAATAGTGAAG -> ATGAGACAAATAGTGAAGA
GATGATAGGCTCGACGGCG -> ATGATAGGCTCGACGGCGT
GATGATGATAGGCTCGACG -> ATGATGATAGGCTCGACGG
GATGCGAGGTATCAAGTGT -> ATGCGAGGTATCAAGTGTA
GATGGAGGGATCTCCACAG -> ATGGAGGGATCTCCACAGG
GATGGATTTCATGACGGGA -> ATGGATTTCATGACGGGAG
GATGGTATAGTGTTGGTTA -> ATGGTATAGTGTTGGTTAA
GATGTAGTGATAGAGGTCG -> ATGTAGTGATAGAGGTCGC
GATGTCGTTTAATTACCGC -> ATGTCGTTTAATTACCGCC
GATGTGCATGACTTCCGGG -> ATGTGCATGACTTCCGGGA
GATTACCATGGGGCGTCGT -> ATTACCATGGGGCGTCGTC
GATTATAATAGTCACCCTA -> ATTATAATAGTCACCCTAC
GATTCAGAATTGTAGCTAA -> ATTCAGAATTGTAGCTAAT
GATTCAGGTGTAAGTCTCA -> ATTCAGGTGTAAGTCTCAA
GATTGCGCAAGAATTGAGA -> ATTGCGCAAGAATTGAGAC
GATTGTGGAAGAGGACTGC -> ATTGTGGAAGAGGACTGCA
GATTTCAAGACTTGTGCCC -> ATTTCAAGACTTGTGCCCC
GATTTCATGACGGGAGGAC -> ATTTCATGACGGGAGGACT
GCAAAGACTGGAGTGCATG -> CAAAGACTGGAGTGCATGC
GCAACCTCTCAAGGCCTAC -> CAACCTCTCAAGGCCTACC
GCAAGAATTGAGACCGGGA -> CAAGAATTGAGACCGGGAA
GCAAGACGTCCGACCGGGC -> CAAGACGTCCGACCGGGCA
GCAAGGCACGCGTATCATA -> CAAGGCACGCGTATCATAA
GCAATGTGCTCATCGGTAG -> CAATGTGCTCATCGGTAGA
GCACCAAGAAGGGCCCCTT -> CACCAAGAAGGGCCCCTTC
GCACCGACTTCCATGTACA -> CACCGACTTCCATGTACAA
GCACCGTAAACTACCACAC -> CACCGTAAACTACCACACT
GCACCTCTTAATGATGAAT -> CACCTCTTAATGATGAATG
GCACCTGGGTGCTAGCAAG -> CACCTGGGTGCTAGCAAGA
GCACGCCTTTCAATCCTCC -> CACGCCTTTCAATCCTCCA
GCACGCGTATCATAAGATT -> CACGCGTATCATAAGATTA
GCACGGACTCGCCGGGGCT -> CACGGACTCGCCGGGGCTG
GCACGTAGTTGGCTCTGGA -> CACGTAGTTGGCTCTGGAA
GCACTCCTGATTCAGAATT -> CACTCCTGATTCAGAATTG
GCACTGTACGATCATGACA -> CACTGTACGATCATGACAT
GCAGAGGTAATATGTCCCA -> CAGAGGTAATATGTCCCAT
GCAGATTTCAAGACTTGTG -> CAGATTTCAAGACTTGTGC
GCAGCCCGTCGCCTACTTG -> CAGCCCGTCGCCTACTTGA
GCAGCGTCGTAACCCCGTT -> CAGCGTCGTAACCCCGTTT
GCATCATTTTCGCGAGGGG -> CATCATTTTCGCGAGGGGT
GCATCCTCTGCCCAGGCGG -> CATCCTCTGCCCAGGCGGA
GCATCTTGCGGAAGTTCGT -> CATCTTGCGGAAGTTCGTC
GCATGACTTCCGGGAACCA -> CATGACTTCCGGGAACCAA
GCATGATAGCTTAAGAGGG -> CATGATAGCTTAAGAGGGA
GCATGCGGAGCGAGGATCC -> CATGCGGAGCGAGGATCCA
GCATGGAGCCTCTCCTAAT -> CATGGAGCCTCTCCTAATA
GCATGGAGCGAGCCTAAGG -> CATGGAGCGAGCCTAAGGT
GCATGGTTGGCTCTGGAAG -> CATGGTTGGCTCTGGAAGG
GCATTAGCACCAAGAAGGG -> CATTAGCACCAAGAAGGGC
GCATTCGATAAAAAGCTGT -> CATTCGATAAAAAGCTGTG
GCCACTCGCACCTGGGTGC -> CCACTCGCACCTGGGTGCT
GCCAGTATCTAAGAAGTTT -> CCAGTATCTAAGAAGTTTG
GCCCACACACGGGTTGGCT -> CCCACACACGGGTTGGCTC
GCCCAGGCGGACGCCCTCC -> CCCAGGCGGACGCCCTCCT
GCCCAGTAGAGACGACGTC -> CCCAGTAGAGACGACGTCT
GCCCCTAGCGGGCGACGGT -> CCCCTAGCGGGCGACGGTA
GCCCCTGGGTTATGCTCCC -> CCCCTGGGTTATGCTCCCG
GCCCCTTCGCGCTGCCCAG -> CCCCTTCGCGCTGCCCAGT
GCCCGCAGCGTCGTAACCC -> CCCGCAGCGTCGTAACCCC
GCCCGGCATTCGATAAAAA -> CCCGGCATTCGATAAAAAG
GCCCGTCGCCTACTTGAAT -> CCCGTCGCCTACTTGAATA
GCCCTCCTGCTGTGTCCAC -> CCCTCCTGCTGTGTCCACC
GCCGAATAGCATTAGCACC -> CCGAATAGCATTAGCACCA
GCCGCCTCTGGGTTCCATC -> CCGCCTCTGGGTTCCATCG
GCCGCGCTCCCTACTATAC -> CCGCGCTCCCTACTATACT
GCCGCTAGGGACTAGTTAT -> CCGCTAGGGACTAGTTATC
GCCGGCTTAAAAGTTCGTC -> CCGGCTTAAAAGTTCGTCG
GCCGGGGCTGTGTCCGTAC -> CCGGGGCTGTGTCCGTACC
GCCGTAAACCCTATTGAGT -> CCGTAAACCCTATTGAGTC
GCCGTACCCAGGTGCGAAA -> CCGTACCCAGGTGCGAAAT
GCCGTCAAGACCGACCTCT -> CCGTCAAGACCGACCTCTT
GCCGTGTACGGGTACGATG -> CCGTGTACGGGTACGATGG
GCCTAAGGTAGGCGACCCA -> CCTAAGGTAGGCGACCCAA
GCCTACCCACGGATAAGGC -> CCTACCCACGGATAAGGCC
GCCTACTTGAATAAAAGAA -> CCTACTTGAATAAAAGAAA
GCCTCCTATACTCGGTACT -> CCTCCTATACTCGGTACTT
GCCTCTCCTAATATAGTCC -> CCTCTCCTAATATAGTCCA
GCCTCTGGGTTCCATCGCC -> CCTCTGGGTTCCATCGCCC
GCCTGATGGAGGGATCTCC -> CCTGATGGAGGGATCTCCA
GCCTTTCAATCCTCCACAG -> CCTTTCAATCCTCCACAGC
GCGAAACCGAACGCGTTTG -> CGAAACCGAACGCGTTTGA
GCGAAATCGTTATTGCCGT -> CGAAATCGTTATTGCCGTG
GCGACCAACCGACAAGTAA -> CGACCAACCGACAAGTAAT
GCGACCCAAATTACTGGTT -> CGACCCAAATTACTGGTTT
GCGACGGTATATCATCTAT -> CGACGGTATATCATCTATC
GCGAGCCTAAGGTAGGCGA -> CGAGCCTAAGGTAGGCGAC
GCGAGGATCCAGCGAAACC -> CGAGGATCCAGCGAAACCG
GCGAGGGGTCTGCTGTGAC -> CGAGGGGTCTGCTGTGACT
GCGAGGTATCAAGTGTAGG -> CGAGGTATCAAGTGTAGGC
GCGCAAGAATTGAGACCGG -> CGCAAGAATTGAGACCGGG
GCGCACCTCTTAATGATGA -> CGCACCTCTTAATGATGAA
GCGCCGTACCCAGGTGCGA -> CGCCGTACCCAGGTGCGAA
GCGCGCTCCAATTAATAGA -> CGCGCTCCAATTAATAGAC
GCGCTATCTAATAATTTGA -> CGCTATCTAATAATTTGAC
GCGCTCCAATTAATAGACT -> CGCTCCAATTAATAGACTA
GCGCTCCCTACTATACTTC -> CGCTCCCTACTATACTTCG
GCGCTGCCCAGTAGAGACG -> CGCTGCCCAGTAGAGACGA
GCGGAAGTTCGTCATCCAA -> CGGAAGTTCGTCATCCAAG
GCGGACGCCCTCCTGCTGT -> CGGACGCCCTCCTGCTGTG
GCGGAGCGAGGATCCAGCG -> CGGAGCGAGGATCCAGCGA
GCGGGCGACGGTATATCAT -> CGGGCGACGGTATATCATC
GCGGGTTTTTCGCGCGCTC -> CGGGTTTTTCGCGCGCTCC
GCGTATCATAAGATTACCA -> CGTATCATAAGATTACCAT
GCGTATGTTCACCGTTCCT -> CGTATGTTCACCGTTCCTG
GCGTCGTAACCCCGTTTTC -> CGTCGTAACCCCGTTTTCC
GCGTCGTCGTCGACGTCAC -> CGTCGTCGTCGACGTCACC
GCGTGGGCTGGAAAAGACT -> CGTGGGCTGGAAAAGACTG
GCGTTAATCTCTGGATAAT -> CGTTAATCTCTGGATAATC
GCGTTTGACGGATCGACTG -> CGTTTGACGGATCGACTGT
GCTAATCACCCTCCTTAGA -> CTAATCACCCTCCTTAGAC
GCTACCTAGAGTACATTTC -> CTACCTAGAGTACATTTCC
GCTACGGTCTATGACTAGC -> CTACGGTCTATGACTAGCT
GCTAGCAAGACGTCCGACC -> CTAGCAAGACGTCCGACCG
GCTAGGGACTAGTTATCCT -> CTAGGGACTAGTTATCCTG
GCTATCTAACCATGAATGG -> CTATCTAACCATGAATGGA
GCTATCTAATAATTTGACT -> CTATCTAATAATTTGACTC
GCTCATCGGTAGAGTCGGA -> CTCATCGGTAGAGTCGGAC
GCTCCAATTAATAGACTAT -> CTCCAATTAATAGACTATG
GCTCCACTCTTGATGTGCA -> CTCCACTCTTGATGTGCAT
GCTCCCGATTGCGCAAGAA -> CTCCCGATTGCGCAAGAAT
GCTCCCTACTATACTTCGA -> CTCCCTACTATACTTCGAT
GCTCGACGGCGTGGGCTGG -> CTCGACGGCGTGGGCTGGA
GCTCGGGTGGAGTGTCATG -> CTCGGGTGGAGTGTCATGT
GCTCTCAGTTCTGGCAACC -> CTCTCAGTTCTGGCAACCT
GCTCTGGAAGGAGGCAAGG -> CTCTGGAAGGAGGCAAGGC
GCTCTGGAAGGAGGCACTG -> CTCTGGAAGGAGGCACTGT
GCTCTGGAAGGAGGCATCA -> CTCTGGAAGGAGGCATCAT
GCTCTGGAAGGAGGCTCTG -> CTCTGGAAGGAGGCTCTGG
GCTCTGGCACGCCTTTCAA -> CTCTGGCACGCCTTTCAAT
GCTCTTAATTTAAAACTTT -> CTCTTAATTTAAAACTTTA
GCTCTTATTTCATCGCTCT -> CTCTTATTTCATCGCTCTC
GCTGCCAGTATCTAAGAAG -> CTGCCAGTATCTAAGAAGT
GCTGCCCAGTAGAGACGAC -> CTGCCCAGTAGAGACGACG
GCTGGAAAAGACTGATCTT -> CTGGAAAAGACTGATCTTG
GCTGTGACTTTCCTGGTCA -> CTGTGACTTTCCTGGTCAG
GCTGTGATCTGCTGCCAGT -> CTGTGATCTGCTGCCAGTA
GCTGTGTCCACCGAGCGGG -> CTGTGTCCACCGAGCGGGT
GCTGTGTCCGTACCTAAGA -> CTGTGTCCGTACCTAAGAA
GCTTAAAAGTTCGTCGATG -> CTTAAAAGTTCGTCGATGA
GCTTAAGAGGGAGTTCTCA -> CTTAAGAGGGAGTTCTCAC
GCTTCGCACCGACTTCCAT -> CTTCGCACCGACTTCCATG
GCTTCTCGATCGGCCGAAT -> CTTCTCGATCGGCCGAATA
GCTTTCACGTCAAGCTCCA -> CTTTCACGTCAAGCTCCAC
GGAAAAACGTAATAAGTCT -> GAAAAACGTAATAAGTCTA
GGAAAAGACTGATCTTGTG -> GAAAAGACTGATCTTGTGC
GGAACCAATCCCTGTAACG -> GAACCAATCCCTGTAACGC
GGAACGGCACGTAGTTGGC -> GAACGGCACGTAGTTGGCT
GGAAGAGGACTGCACGGAC -> GAAGAGGACTGCACGGACT
GGAAGCAAAGACTGGAGTG -> GAAGCAAAGACTGGAGTGC
GGAAGGAGGCAAGGCACGC -> GAAGGAGGCAAGGCACGCG
GGAAGGAGGCACTGTACGA -> GAAGGAGGCACTGTACGAT
GGAAGGAGGCATCATTTTC -> GAAGGAGGCATCATTTTCG
GGAAGGAGGCTCTGGCACG -> GAAGGAGGCTCTGGCACGC
GGAAGTTCGTCATCCAAGC -> GAAGTTCGTCATCCAAGCC
GGAATTCTACGTGTGTTTC -> GAATTCTACGTGTGTTTCC
GGACCTGACTCCGGAATTC -> GACCTGACTCCGGAATTCT
GGACGCCCTCCTGCTGTGT -> GACGCCCTCCTGCTGTGTC
GGACGGGCGCTATCTAATA -> GACGGGCGCTATCTAATAA
GGACTAGTGTTGAGTGGTG -> GACTAGTGTTGAGTGGTGC
GGACTAGTTATCCTGGCAC -> GACTAGTTATCCTGGCACC
GGACTCGCCGGGGCTGTGT -> GACTCGCCGGGGCTGTGTC
GGACTGACCTCTTAGGCAT -> GACTGACCTCTTAGGCATG
GGACTGCACGGACTCGCCG -> GACTGCACGGACTCGCCGG
GGACTGCTACGGTCTATGA -> GACTGCTACGGTCTATGAC
GGACTTTTAAATACCTACG -> GACTTTTAAATACCTACGG
GGACTTTTAGCGCCGTACC -> GACTTTTAGCGCCGTACCC
GGAGACTACGACGAACAGG -> GAGACTACGACGAACAGGC
GGAGAGGAACGGCACGTAG -> GAGAGGAACGGCACGTAGT
GGAGAGGCCCACACACGGG -> GAGAGGCCCACACACGGGT
GGAGAGGGAGTCCCTATAG -> GAGAGGGAGTCCCTATAGT
GGAGAGGTAGGTTGCATGG -> GAGAGGTAGGTTGCATGGT
GGAGCCTCTCCTAATATAG -> GAGCCTCTCCTAATATAGT
GGAGCGAGCCTAAGGTAGG -> GAGCGAGCCTAAGGTAGGC
GGAGCGAGGATCCAGCGAA -> GAGCGAGGATCCAGCGAAA
GGAGGACTGACCTCTTAGG -> GAGGACTGACCTCTTAGGC
GGAGGCAAGGCACGCGTAT -> GAGGCAAGGCACGCGTATC
GGAGGCACTGTACGATCAT -> GAGGCACTGTACGATCATG
GGAGGCATCATTTTCGCGA -> GAGGCATCATTTTCGCGAG
GGAGGCTCTGGCACGCCTT -> GAGGCTCTGGCACGCCTTT
GGAGGGATCTCCACAGGGC -> GAGGGATCTCCACAGGGCA
GGAGTCCCTATAGTTGGCT -> GAGTCCCTATAGTTGGCTC
GGAGTGCATGCGGAGCGAG -> GAGTGCATGCGGAGCGAGG
GGAGTGTCATGTGCCACTC -> GAGTGTCATGTGCCACTCG
GGAGTTCTCACATGGGTAA -> GAGTTCTCACATGGGTAAA
GGATAAGGCCGCTAGGGAC -> GATAAGGCCGCTAGGGACT
GGATAATCCTATCATGCTT -> GATAATCCTATCATGCTTC
GGATATACCGACGCCGCGC -> GATATACCGACGCCGCGCT
GGATCCAGCGAAACCGAAC -> GATCCAGCGAAACCGAACG
GGATCGACTGTAGACGAAA -> GATCGACTGTAGACGAAAA
GGATCTCCACAGGGCATGG -> GATCTCCACAGGGCATGGA
GGATTCAGGTGTAAGTCTC -> GATTCAGGTGTAAGTCTCA
GGATTGTGGAAGAGGACTG -> GATTGTGGAAGAGGACTGC
GGATTTCATGACGGGAGGA -> GATTTCATGACGGGAGGAC
GGCAACCTCTCAAGGCCTA -> GCAACCTCTCAAGGCCTAC
GGCAAGGCACGCGTATCAT -> GCAAGGCACGCGTATCATA
GGCACCGTAAACTACCACA -> GCACCGTAAACTACCACAC
GGCACGCCTTTCAATCCTC -> GCACGCCTTTCAATCCTCC
GGCACGCGTATCATAAGAT -> GCACGCGTATCATAAGATT
GGCACGTAGTTGGCTCTGG -> GCACGTAGTTGGCTCTGGA
GGCACTGTACGATCATGAC -> GCACTGTACGATCATGACA
GGCATCATTTTCGCGAGGG -> GCATCATTTTCGCGAGGGG
GGCATGATAGCTTAAGAGG -> GCATGATAGCTTAAGAGGG
GGCATGGAGCCTCTCCTAA -> GCATGGAGCCTCTCCTAAT
GGCATGGAGCGAGCCTAAG -> GCATGGAGCGAGCCTAAGG
GGCATTCGATAAAAAGCTG -> GCATTCGATAAAAAGCTGT
GGCCCACACACGGGTTGGC -> GCCCACACACGGGTTGGCT
GGCCCCTTCGCGCTGCCCA -> GCCCCTTCGCGCTGCCCAG
GGCCGAATAGCATTAGCAC -> GCCGAATAGCATTAGCACC
GGCCGCTAGGGACTAGTTA -> GCCGCTAGGGACTAGTTAT
GGCCGGCTTAAAAGTTCGT -> GCCGGCTTAAAAGTTCGTC
GGCCGTCAAGACCGACCTC -> GCCGTCAAGACCGACCTCT
GGCCTACCCACGGATAAGG -> GCCTACCCACGGATAAGGC
GGCGACCAACCGACAAGTA -> GCGACCAACCGACAAGTAA
GGCGACCCAAATTACTGGT -> GCGACCCAAATTACTGGTT
GGCGACGGTATATCATCTA -> GCGACGGTATATCATCTAT
GGCGCTATCTAATAATTTG -> GCGCTATCTAATAATTTGA
GGCGGACGCCCTCCTGCTG -> GCGGACGCCCTCCTGCTGT
GGCGTATGTTCACCGTTCC -> GCGTATGTTCACCGTTCCT
GGCGTCGTCGTCGACGTCA -> GCGTCGTCGTCGACGTCAC
GGCGTGGGCTGGAAAAGAC -> GCGTGGGCTGGAAAAGACT
GGCTCGACGGCGTGGGCTG -> GCTCGACGGCGTGGGCTGG
GGCTCTGGAAGGAGGCAAG -> GCTCTGGAAGGAGGCAAGG
GGCTCTGGAAGGAGGCACT -> GCTCTGGAAGGAGGCACTG
GGCTCTGGAAGGAGGCATC -> GCTCTGGAAGGAGGCATCA
GGCTCTGGAAGGAGGCTCT -> GCTCTGGAAGGAGGCTCTG
GGCTCTGGCACGCCTTTCA -> GCTCTGGCACGCCTTTCAA
GGCTCTTAATTTAAAACTT -> GCTCTTAATTTAAAACTTT
GGCTCTTATTTCATCGCTC -> GCTCTTATTTCATCGCTCT
GGCTGGAAAAGACTGATCT -> GCTGGAAAAGACTGATCTT
GGCTGTGTCCGTACCTAAG -> GCTGTGTCCGTACCTAAGA
GGCTTAAAAGTTCGTCGAT -> GCTTAAAAGTTCGTCGATG
GGGAACCAATCCCTGTAAC -> GGAACCAATCCCTGTAACG
GGGAAGCAAAGACTGGAGT -> GGAAGCAAAGACTGGAGTG
GGGACTAGTTATCCTGGCA -> GGACTAGTTATCCTGGCAC
GGGAGGACTGACCTCTTAG -> GGAGGACTGACCTCTTAGG
GGGAGTCCCTATAGTTGGC -> GGAGTCCCTATAGTTGGCT
GGGAGTTCTCACATGGGTA -> GGAGTTCTCACATGGGTAA
GGGATATACCGACGCCGCG -> GGATATACCGACGCCGCGC
GGGATCTCCACAGGGCATG -> GGATCTCCACAGGGCATGG
GGGATTCAGGTGTAAGTCT -> GGATTCAGGTGTAAGTCTC
GGGCATGGAGCCTCTCCTA -> GGCATGGAGCCTCTCCTAA
GGGCATGGAGCGAGCCTAA -> GGCATGGAGCGAGCCTAAG
GGGCCCCTTCGCGCTGCCC -> GGCCCCTTCGCGCTGCCCA
GGGCGACGGTATATCATCT -> GGCGACGGTATATCATCTA
GGGCGCTATCTAATAATTT -> GGCGCTATCTAATAATTTG
GGGCGTCGTCGTCGACGTC -> GGCGTCGTCGTCGACGTCA
GGGCTGGAAAAGACTGATC -> GGCTGGAAAAGACTGATCT
GGGCTGTGTCCGTACCTAA -> GGCTGTGTCCGTACCTAAG
GGGGATATACCGACGCCGC -> GGGATATACCGACGCCGCG
GGGGCGTCGTCGTCGACGT -> GGGCGTCGTCGTCGACGTC
GGGGCTGTGTCCGTACCTA -> GGGCTGTGTCCGTACCTAA
GGGGGATATACCGACGCCG -> GGGGATATACCGACGCCGC
GGGGGGATATACCGACGCC -> GGGGGATATACCGACGCCG
GGGGTCTGCTGTGACTTTC -> GGGTCTGCTGTGACTTTCC
GGGTAAATTTCTGACAGTA -> GGTAAATTTCTGACAGTAC
GGGTAAGTTCCTGAGCAGC -> GGTAAGTTCCTGAGCAGCC
GGGTACGACGAGTGAGCAA -> GGTACGACGAGTGAGCAAT
GGGTACGATGGTATAGTGT -> GGTACGATGGTATAGTGTT
GGGTCTGCTGTGACTTTCC -> GGTCTGCTGTGACTTTCCT
GGGTGCTAGCAAGACGTCC -> GGTGCTAGCAAGACGTCCG
GGGTGGAGTGTCATGTGCC -> GGTGGAGTGTCATGTGCCA
GGGTTATGCTCCCGATTGC -> GGTTATGCTCCCGATTGCG
GGGTTCCATCGCCCGGCAT -> GGTTCCATCGCCCGGCATT
GGGTTGGCTCTGGAAGGAG -> GGTTGGCTCTGGAAGGAGG
GGGTTTTTCGCGCGCTCCA -> GGTTTTTCGCGCGCTCCAA
GGTAAATTTCTGACAGTAC -> GTAAATTTCTGACAGTACT
GGTAAGTTCCTGAGCAGCC -> GTAAGTTCCTGAGCAGCCC
GGTAATATGTCCCATAGGC -> GTAATATGTCCCATAGGCT
GGTACGACGAGTGAGCAAT -> GTACGACGAGTGAGCAATG
GGTACGATGGTATAGTGTT -> GTACGATGGTATAGTGTTG
GGTACTATTTCGGAAAAAC -> GTACTATTTCGGAAAAACG
GGTACTTGAGATGCGAGGT -> GTACTTGAGATGCGAGGTA
GGTAGAGTCGGACTTTTAG -> GTAGAGTCGGACTTTTAGC
GGTAGGCGACCCAAATTAC -> GTAGGCGACCCAAATTACT
GGTAGGTTGCATGGTTGGC -> GTAGGTTGCATGGTTGGCT
GGTATAGTGTTGGTTAAAC -> GTATAGTGTTGGTTAAACA
GGTATATCATCTATCGGCT -> GTATATCATCTATCGGCTC
GGTATCAAGTGTAGGCCGT -> GTATCAAGTGTAGGCCGTC
GGTCAGGAGAGGAACGGCA -> GTCAGGAGAGGAACGGCAC
GGTCAGGAGAGGCCCACAC -> GTCAGGAGAGGCCCACACA
GGTCAGGAGAGGGAGTCCC -> GTCAGGAGAGGGAGTCCCT
GGTCAGGAGAGGTAGGTTG -> GTCAGGAGAGGTAGGTTGC
GGTCGCATCCTCTGCCCAG -> GTCGCATCCTCTGCCCAGG
GGTCTATGACTAGCTACCT -> GTCTATGACTAGCTACCTA
GGTCTGCTGTGACTTTCCT -> GTCTGCTGTGACTTTCCTG
GGTGCCTGATGGAGGGATC -> GTGCCTGATGGAGGGATCT
GGTGCGAAATCGTTATTGC -> GTGCGAAATCGTTATTGCC
GGTGCTAGCAAGACGTCCG -> GTGCTAGCAAGACGTCCGA
GGTGGAGTGTCATGTGCCA -> GTGGAGTGTCATGTGCCAC
GGTGTAAGTCTCAATGTTC -> GTGTAAGTCTCAATGTTCT
GGTTAAACAAGTTGGGATT -> GTTAAACAAGTTGGGATTC
GGTTAAGAATTTAGAATGT -> GTTAAGAATTTAGAATGTA
GGTTATGCTCCCGATTGCG -> GTTATGCTCCCGATTGCGC
GGTTCCATCGCCCGGCATT -> GTTCCATCGCCCGGCATTC
GGTTGCATGGTTGGCTCTG -> GTTGCATGGTTGGCTCTGG
GGTTGGCTCTGGAAGGAGG -> GTTGGCTCTGGAAGGAGGC,GTTGGCTCTGGAAGGAGGC
GGTTTGGAGACTACGACGA -> GTTTGGAGACTACGACGAA
GGTTTTTCGCGCGCTCCAA -> GTTTTTCGCGCGCTCCAAT
GTAAACCCTATTGAGTCTT -> TAAACCCTATTGAGTCTTA
GTAAACTACCACACTCGAG -> TAAACTACCACACTCGAGC
GTAAATTTCTGACAGTACT -> TAAATTTCTGACAGTACTT
GTAACCCCGTTTTCCTGGT -> TAACCCCGTTTTCCTGGTC
GTAACGCTTCTCGATCGGC -> TAACGCTTCTCGATCGGCC
GTAAGTCTCAATGTTCTAG -> TAAGTCTCAATGTTCTAGC
GTAAGTTCCTGAGCAGCCC -> TAAGTTCCTGAGCAGCCCG
GTAATAAGTCTAGTGATGC -> TAATAAGTCTAGTGATGCG
GTAATATGTCCCATAGGCT -> TAATATGTCCCATAGGCTC
GTAATTGATGTCGTTTAAT -> TAATTGATGTCGTTTAATT
GTACAACGCACTCCTGATT -> TACAACGCACTCCTGATTC
GTACAAGCGCACCTCTTAA -> TACAAGCGCACCTCTTAAT
GTACATTTCCTGGTCAGGA -> TACATTTCCTGGTCAGGAG
GTACCCAGGTGCGAAATCG -> TACCCAGGTGCGAAATCGT
GTACCTAAGAAGGACTGCT -> TACCTAAGAAGGACTGCTA
GTACGACGAGTGAGCAATG -> TACGACGAGTGAGCAATGT
GTACGATCATGACATGCAT -> TACGATCATGACATGCATC
GTACGATGGTATAGTGTTG -> TACGATGGTATAGTGTTGG
GTACGGGTACGATGGTATA -> TACGGGTACGATGGTATAG
GTACGTCCTAGTTCTTTGA -> TACGTCCTAGTTCTTTGAA
GTACTATTTCGGAAAAACG -> TACTATTTCGGAAAAACGT
GTACTTGAGATGCGAGGTA -> TACTTGAGATGCGAGGTAT
GTACTTTTGAGTGGTTAAG -> TACTTTTGAGTGGTTAAGA
GTAGACGAAAAGTACAACG -> TAGACGAAAAGTACAACGC
GTAGAGACGACGTCTGCGT -> TAGAGACGACGTCTGCGTT
GTAGAGTCGGACTTTTAGC -> TAGAGTCGGACTTTTAGCG
GTAGATTATAATAGTCACC -> TAGATTATAATAGTCACCC
GTAGCTAATCACCCTCCTT -> TAGCTAATCACCCTCCTTA
GTAGGCCGTCAAGACCGAC -> TAGGCCGTCAAGACCGACC
GTAGGCGACCCAAATTACT -> TAGGCGACCCAAATTACTG
GTAGGTTGCATGGTTGGCT -> TAGGTTGCATGGTTGGCTC
GTAGTGATAGAGGTCGCAT -> TAGTGATAGAGGTCGCATC
GTAGTTGGCTCTGGAAGGA -> TAGTTGGCTCTGGAAGGAG
GTATAGTGTTGGTTAAACA -> TATAGTGTTGGTTAAACAA
GTATATCATCTATCGGCTC -> TATATCATCTATCGGCTCT
GTATCAAGTGTAGGCCGTC -> TATCAAGTGTAGGCCGTCA
GTATCATAAGATTACCATG -> TATCATAAGATTACCATGG
GTATCTAAGAAGTTTGAGT -> TATCTAAGAAGTTTGAGTA
GTATGTTCACCGTTCCTGG -> TATGTTCACCGTTCCTGGA
GTATTTGTTGGGGGGATAT -> TATTTGTTGGGGGGATATA
GTCAAGACCGACCTCTTTG -> TCAAGACCGACCTCTTTGT
GTCAAGCTCCACTCTTGAT -> TCAAGCTCCACTCTTGATG
GTCACCAATGGACGGGCGC -> TCACCAATGGACGGGCGCT
GTCACCCTACACATATCCG -> TCACCCTACACATATCCGG
GTCAGGAGAGGAACGGCAC -> TCAGGAGAGGAACGGCACG
GTCAGGAGAGGCCCACACA -> TCAGGAGAGGCCCACACAC
GTCAGGAGAGGGAGTCCCT -> TCAGGAGAGGGAGTCCCTA
GTCAGGAGAGGTAGGTTGC -> TCAGGAGAGGTAGGTTGCA
GTCATCCAAGCCCGCAGCG -> TCATCCAAGCCCGCAGCGT
GTCATGTGCCACTCGCACC -> TCATGTGCCACTCGCACCT
GTCCACCGAGCGGGTTTTT -> TCCACCGAGCGGGTTTTTC
GTCCATTAGCTATCTAACC -> TCCATTAGCTATCTAACCA
GTCCCATAGGCTCTTAATT -> TCCCATAGGCTCTTAATTT
GTCCCTATAGTTGGCTCTG -> TCCCTATAGTTGGCTCTGG
GTCCGACCGGGCATGGAGC -> TCCGACCGGGCATGGAGCG
GTCCGTACCTAAGAAGGAC -> TCCGTACCTAAGAAGGACT
GTCCTAGTTCTTTGAAAGA -> TCCTAGTTCTTTGAAAGAG
GTCGACGTCACCAATGGAC -> TCGACGTCACCAATGGACG
GTCGATGAGACAAATAGTG -> TCGATGAGACAAATAGTGA
GTCGCATCCTCTGCCCAGG -> TCGCATCCTCTGCCCAGGC
GTCGCCTACTTGAATAAAA -> TCGCCTACTTGAATAAAAG
GTCGGACTTTTAGCGCCGT -> TCGGACTTTTAGCGCCGTA
GTCGTAACCCCGTTTTCCT -> TCGTAACCCCGTTTTCCTG
GTCGTCGACGTCACCAATG -> TCGTCGACGTCACCAATGG
GTCGTCGTCGACGTCACCA -> TCGTCGTCGACGTCACCAA
GTCGTTTAATTACCGCCGT -> TCGTTTAATTACCGCCGTA
GTCTAAACTCTTCATGGGT -> TCTAAACTCTTCATGGGTA
GTCTAGTGATGCGGCCCTC -> TCTAGTGATGCGGCCCTCT
GTCTATGACTAGCTACCTA -> TCTATGACTAGCTACCTAG
GTCTCAATGTTCTAGCTTT -> TCTCAATGTTCTAGCTTTC
GTCTGCGTTAATCTCTGGA -> TCTGCGTTAATCTCTGGAT
GTCTGCTGTGACTTTCCTG -> TCTGCTGTGACTTTCCTGG
GTCTTAAAACGAACTATAG -> TCTTAAAACGAACTATAGC
GTGAAGACGGCGACCAACC -> TGAAGACGGCGACCAACCG
GTGACTTTCCTGGTCAGGA -> TGACTTTCCTGGTCAGGAG
GTGAGCAATGTGCTCATCG -> TGAGCAATGTGCTCATCGG
GTGATAGAGGTCGCATCCT -> TGATAGAGGTCGCATCCTC
GTGATCTGCTGCCAGTATC -> TGATCTGCTGCCAGTATCT
GTGCAGATTTCAAGACTTG -> TGCAGATTTCAAGACTTGT
GTGCATGACTTCCGGGAAC -> TGCATGACTTCCGGGAACC
GTGCATGCGGAGCGAGGAT -> TGCATGCGGAGCGAGGATC
GTGCCACTCGCACCTGGGT -> TGCCACTCGCACCTGGGTG
GTGCCCCTGGGTTATGCTC -> TGCCCCTGGGTTATGCTCC
GTGCCTGATGGAGGGATCT -> TGCCTGATGGAGGGATCTC
GTGCGAAATCGTTATTGCC -> TGCGAAATCGTTATTGCCG
GTGCTAGCAAGACGTCCGA -> TGCTAGCAAGACGTCCGAC
GTGCTCATCGGTAGAGTCG -> TGCTCATCGGTAGAGTCGG
GTGGAAGAGGACTGCACGG -> TGGAAGAGGACTGCACGGA
GTGGAGTGTCATGTGCCAC -> TGGAGTGTCATGTGCCACT
GTGGGCTGGAAAAGACTGA -> TGGGCTGGAAAAGACTGAT
GTGGTGCCTGATGGAGGGA -> TGGTGCCTGATGGAGGGAT
GTGGTTAAGAATTTAGAAT -> TGGTTAAGAATTTAGAATG
GTGTAAGTCTCAATGTTCT -> TGTAAGTCTCAATGTTCTA
GTGTACGGGTACGATGGTA -> TGTACGGGTACGATGGTAT
GTGTAGGCCGTCAAGACCG -> TGTAGGCCGTCAAGACCGA
GTGTCATGTGCCACTCGCA -> TGTCATGTGCCACTCGCAC
GTGTCCACCGAGCGGGTTT -> TGTCCACCGAGCGGGTTTT
GTGTCCGTACCTAAGAAGG -> TGTCCGTACCTAAGAAGGA
GTGTCTAAACTCTTCATGG -> TGTCTAAACTCTTCATGGG
GTGTGTTTCCTGGTCAGGA -> TGTGTTTCCTGGTCAGGAG
GTGTTGAGTGGTGCCTGAT -> TGTTGAGTGGTGCCTGATG
GTGTTGGTTAAACAAGTTG -> TGTTGGTTAAACAAGTTGG
GTGTTTCCTGGTCAGGAGA -> TGTTTCCTGGTCAGGAGAG
GTTAAACAAGTTGGGATTC -> TTAAACAAGTTGGGATTCA
GTTAAGAATTTAGAATGTA -> TTAAGAATTTAGAATGTAG
GTTAATCTCTGGATAATCC -> TTAATCTCTGGATAATCCT
GTTATCCTGGCACCGTAAA -> TTATCCTGGCACCGTAAAC
GTTATGCTCCCGATTGCGC -> TTATGCTCCCGATTGCGCA
GTTATTGCCGTGTACGGGT -> TTATTGCCGTGTACGGGTA
GTTCACCGTTCCTGGACTA -> TTCACCGTTCCTGGACTAG
GTTCCATCGCCCGGCATTC -> TTCCATCGCCCGGCATTCG
GTTCCTGAGCAGCCCGTCG -> TTCCTGAGCAGCCCGTCGC
GTTCCTGGACTAGTGTTGA -> TTCCTGGACTAGTGTTGAG
GTTCGTCATCCAAGCCCGC -> TTCGTCATCCAAGCCCGCA
GTTCGTCGATGAGACAAAT -> TTCGTCGATGAGACAAATA
GTTCTAGCTTTCACGTCAA -> TTCTAGCTTTCACGTCAAG
GTTCTCACATGGGTAAATT -> TTCTCACATGGGTAAATTT
GTTCTGGCAACCTCTCAAG -> TTCTGGCAACCTCTCAAGG
GTTCTTTGAAAGAGATGAT -> TTCTTTGAAAGAGATGATG
GTTGAGTGGTGCCTGATGG -> TTGAGTGGTGCCTGATGGA
GTTGCATGGTTGGCTCTGG -> TTGCATGGTTGGCTCTGGA
GTTGGCTCTGGAAGGAGGC -> TTGGCTCTGGAAGGAGGCA,TTGGCTCTGGAAGGAGGCA,TTGGCTCTGGAAGGAGGCA,TTGGCTCTGGAAGGAGGCT
GTTGGGATTCAGGTGTAAG -> TTGGGATTCAGGTGTAAGT
GTTGGGGGGATATACCGAC -> TTGGGGGGATATACCGACG
GTTGGTTAAACAAGTTGGG -> TTGGTTAAACAAGTTGGGA
GTTGTACGTCCTAGTTCTT -> TTGTACGTCCTAGTTCTTT
GTTTAATTACCGCCGTAAA -> TTTAATTACCGCCGTAAAC
GTTTCCTGGTCAGGAGAGG -> TTTCCTGGTCAGGAGAGGG
GTTTGACGGATCGACTGTA -> TTTGACGGATCGACTGTAG
GTTTGAGTATTTGTTGGGG -> TTTGAGTATTTGTTGGGGG
GTTTGGAGACTACGACGAA -> TTTGGAGACTACGACGAAC
GTTTTCCTGGTCAGGAGAG -> TTTTCCTGGTCAGGAGAGG
GTTTTTCGCGCGCTCCAAT -> TTTTTCGCGCGCTCCAATT
TAAAAAGCTGTGATCTGCT -> AAAAAGCTGTGATCTGCTG
TAAAACGAACTATAGCCTC -> AAAACGAACTATAGCCTCC
TAAAACTTTATGTTGTACG -> AAAACTTTATGTTGTACGT
TAAAAGAAACGCCCCTAGC -> AAAAGAAACGCCCCTAGCG
TAAAAGTTCGTCGATGAGA -> AAAAGTTCGTCGATGAGAC
TAAACAAGTTGGGATTCAG -> AAACAAGTTGGGATTCAGG
TAAACCCTATTGAGTCTTA -> AAACCCTATTGAGTCTTAA
TAAACTACCACACTCGAGC -> AAACTACCACACTCGAGCC
TAAACTCTTCATGGGTACG -> AAACTCTTCATGGGTACGA
TAAATACCTACGGGTAAGT -> AAATACCTACGGGTAAGTT
TAAATTTCTGACAGTACTT -> AAATTTCTGACAGTACTTT
TAACCATGAATGGACCTGA -> AACCATGAATGGACCTGAC
TAACCCCGTTTTCCTGGTC -> AACCCCGTTTTCCTGGTCA
TAACGCTTCTCGATCGGCC -> AACGCTTCTCGATCGGCCG
TAAGAAGGACTGCTACGGT -> AAGAAGGACTGCTACGGTC
TAAGAAGTTTGAGTATTTG -> AAGAAGTTTGAGTATTTGT
TAAGAATTTAGAATGTAGA -> AAGAATTTAGAATGTAGAT
TAAGAGGGAGTTCTCACAT -> AAGAGGGAGTTCTCACATG
TAAGATTACCATGGGGCGT -> AAGATTACCATGGGGCGTC
TAAGGACTTTTAAATACCT -> AAGGACTTTTAAATACCTA
TAAGGCCGCTAGGGACTAG -> AAGGCCGCTAGGGACTAGT
TAAGGTAGGCGACCCAAAT -> AAGGTAGGCGACCCAAATT
TAAGTCTAGTGATGCGGCC -> AAGTCTAGTGATGCGGCCC
TAAGTCTCAATGTTCTAGC -> AAGTCTCAATGTTCTAGCT
TAAGTTCCTGAGCAGCCCG -> AAGTTCCTGAGCAGCCCGT
TAATAAGTCTAGTGATGCG -> AATAAGTCTAGTGATGCGG
TAATAATTTGACTCGAGAT -> AATAATTTGACTCGAGATG
TAATAGACTATGCTCGGGT -> AATAGACTATGCTCGGGTG
TAATAGTCACCCTACACAT -> AATAGTCACCCTACACATA
TAATATAGTCCATTAGCTA -> AATATAGTCCATTAGCTAT
TAATATGTCCCATAGGCTC -> AATATGTCCCATAGGCTCT
TAATCACCCTCCTTAGACG -> AATCACCCTCCTTAGACGG
TAATCCTATCATGCTTCGC -> AATCCTATCATGCTTCGCA
TAATCTCTGGATAATCCTA -> AATCTCTGGATAATCCTAT
TAATGATGAATGATGGATT -> AATGATGAATGATGGATTT
TAATTACCGCCGTAAACCC -> AATTACCGCCGTAAACCCT
TAATTGATGTCGTTTAATT -> AATTGATGTCGTTTAATTA
TAATTTAAAACTTTATGTT -> AATTTAAAACTTTATGTTG
TAATTTGACTCGAGATGTA -> AATTTGACTCGAGATGTAG
TACAACGCACTCCTGATTC -> ACAACGCACTCCTGATTCA
TACAAGCGCACCTCTTAAT -> ACAAGCGCACCTCTTAATG
TACACATATCCGGATTGTG -> ACACATATCCGGATTGTGG
TACATTTCCTGGTCAGGAG -> ACATTTCCTGGTCAGGAGA
TACCACACTCGAGCCGCCT -> ACCACACTCGAGCCGCCTC
TACCATGGGGCGTCGTCGT -> ACCATGGGGCGTCGTCGTC
TACCCACGGATAAGGCCGC -> ACCCACGGATAAGGCCGCT
TACCCAGGTGCGAAATCGT -> ACCCAGGTGCGAAATCGTT
TACCGACGCCGCGCTCCCT -> ACCGACGCCGCGCTCCCTA
TACCGCCGTAAACCCTATT -> ACCGCCGTAAACCCTATTG
TACCTAAGAAGGACTGCTA -> ACCTAAGAAGGACTGCTAC
TACCTACGGGTAAGTTCCT -> ACCTACGGGTAAGTTCCTG
TACCTAGAGTACATTTCCT -> ACCTAGAGTACATTTCCTG
TACGACGAACAGGCGTATG -> ACGACGAACAGGCGTATGT
TACGACGAGTGAGCAATGT -> ACGACGAGTGAGCAATGTG
TACGATCATGACATGCATC -> ACGATCATGACATGCATCT
TACGATGGTATAGTGTTGG -> ACGATGGTATAGTGTTGGT
TACGGGTAAGTTCCTGAGC -> ACGGGTAAGTTCCTGAGCA
TACGGGTACGATGGTATAG -> ACGGGTACGATGGTATAGT
TACGGTCTATGACTAGCTA -> ACGGTCTATGACTAGCTAC
TACGTCCTAGTTCTTTGAA -> ACGTCCTAGTTCTTTGAAA
TACGTGTGTTTCCTGGTCA -> ACGTGTGTTTCCTGGTCAG
TACTATACTTCGATGACGG -> ACTATACTTCGATGACGGC
TACTATTTCGGAAAAACGT -> ACTATTTCGGAAAAACGTA
TACTCGGTACTTGAGATGC -> ACTCGGTACTTGAGATGCG
TACTGGTTTGGAGACTACG -> ACTGGTTTGGAGACTACGA
TACTTCGATGACGGCCGGC -> ACTTCGATGACGGCCGGCT
TACTTGAATAAAAGAAACG -> ACTTGAATAAAAGAAACGC
TACTTGAGATGCGAGGTAT -> ACTTGAGATGCGAGGTATC
TACTTTTGAGTGGTTAAGA -> ACTTTTGAGTGGTTAAGAA
TAGAATGTAGATTATAATA -> AGAATGTAGATTATAATAG
TAGACGAAAAGTACAACGC -> AGACGAAAAGTACAACGCA
TAGACGGTACTATTTCGGA -> AGACGGTACTATTTCGGAA
TAGACTATGCTCGGGTGGA -> AGACTATGCTCGGGTGGAG
TAGAGACGACGTCTGCGTT -> AGAGACGACGTCTGCGTTA
TAGAGGTCGCATCCTCTGC -> AGAGGTCGCATCCTCTGCC
TAGAGTACATTTCCTGGTC -> AGAGTACATTTCCTGGTCA
TAGAGTCGGACTTTTAGCG -> AGAGTCGGACTTTTAGCGC
TAGATTATAATAGTCACCC -> AGATTATAATAGTCACCCT
TAGCAAGACGTCCGACCGG -> AGCAAGACGTCCGACCGGG
TAGCACCAAGAAGGGCCCC -> AGCACCAAGAAGGGCCCCT
TAGCATTAGCACCAAGAAG -> AGCATTAGCACCAAGAAGG
TAGCCTCCTATACTCGGTA -> AGCCTCCTATACTCGGTAC
TAGCGCCGTACCCAGGTGC -> AGCGCCGTACCCAGGTGCG
TAGCGGGCGACGGTATATC -> AGCGGGCGACGGTATATCA
TAGCTAATCACCCTCCTTA -> AGCTAATCACCCTCCTTAG
TAGCTACCTAGAGTACATT -> AGCTACCTAGAGTACATTT
TAGCTATCTAACCATGAAT -> AGCTATCTAACCATGAATG
TAGCTTAAGAGGGAGTTCT -> AGCTTAAGAGGGAGTTCTC
TAGCTTTCACGTCAAGCTC -> AGCTTTCACGTCAAGCTCC
TAGGCATGATAGCTTAAGA -> AGGCATGATAGCTTAAGAG
TAGGCCGTCAAGACCGACC -> AGGCCGTCAAGACCGACCT
TAGGCGACCCAAATTACTG -> AGGCGACCCAAATTACTGG
TAGGCTCGACGGCGTGGGC -> AGGCTCGACGGCGTGGGCT
TAGGCTCTTAATTTAAAAC -> AGGCTCTTAATTTAAAACT
TAGGGACTAGTTATCCTGG -> AGGGACTAGTTATCCTGGC
TAGGTTGCATGGTTGGCTC -> AGGTTGCATGGTTGGCTCT
TAGTCACCCTACACATATC -> AGTCACCCTACACATATCC
TAGTCCATTAGCTATCTAA -> AGTCCATTAGCTATCTAAC
TAGTGAAGACGGCGACCAA -> AGTGAAGACGGCGACCAAC
TAGTGATAGAGGTCGCATC -> AGTGATAGAGGTCGCATCC
TAGTGTTGAGTGGTGCCTG -> AGTGTTGAGTGGTGCCTGA
TAGTGTTGGTTAAACAAGT -> AGTGTTGGTTAAACAAGTT
TAGTTATCCTGGCACCGTA -> AGTTATCCTGGCACCGTAA
TAGTTCTTTGAAAGAGATG -> AGTTCTTTGAAAGAGATGA
TAGTTGGCTCTGGAAGGAG -> AGTTGGCTCTGGAAGGAGG,AGTTGGCTCTGGAAGGAGG
TATAATAGTCACCCTACAC -> ATAATAGTCACCCTACACA
TATACCGACGCCGCGCTCC -> ATACCGACGCCGCGCTCCC
TATACTCGGTACTTGAGAT -> ATACTCGGTACTTGAGATG
TATACTTCGATGACGGCCG -> ATACTTCGATGACGGCCGG
TATAGCCTCCTATACTCGG -> ATAGCCTCCTATACTCGGT
TATAGTCCATTAGCTATCT -> ATAGTCCATTAGCTATCTA
TATAGTGTTGGTTAAACAA -> ATAGTGTTGGTTAAACAAG
TATAGTTGGCTCTGGAAGG -> ATAGTTGGCTCTGGAAGGA
TATATCATCTATCGGCTCT -> ATATCATCTATCGGCTCTT
TATCAAGTGTAGGCCGTCA -> ATCAAGTGTAGGCCGTCAA
TATCATAAGATTACCATGG -> ATCATAAGATTACCATGGG
TATCATCTATCGGCTCTTA -> ATCATCTATCGGCTCTTAT
TATCATGCTTCGCACCGAC -> ATCATGCTTCGCACCGACT
TATCCGGATTGTGGAAGAG -> ATCCGGATTGTGGAAGAGG
TATCCTGGCACCGTAAACT -> ATCCTGGCACCGTAAACTA
TATCGGCTCTTATTTCATC -> ATCGGCTCTTATTTCATCG
TATCTAACCATGAATGGAC -> ATCTAACCATGAATGGACC
TATCTAAGAAGTTTGAGTA -> ATCTAAGAAGTTTGAGTAT
TATCTAATAATTTGACTCG -> ATCTAATAATTTGACTCGA
TATGACTAGCTACCTAGAG -> ATGACTAGCTACCTAGAGT
TATGCTCCCGATTGCGCAA -> ATGCTCCCGATTGCGCAAG
TATGCTCGGGTGGAGTGTC -> ATGCTCGGGTGGAGTGTCA
TATGTCCCATAGGCTCTTA -> ATGTCCCATAGGCTCTTAA
TATGTTCACCGTTCCTGGA -> ATGTTCACCGTTCCTGGAC
TATGTTGTACGTCCTAGTT -> ATGTTGTACGTCCTAGTTC
TATTGAGTCTTAAAACGAA -> ATTGAGTCTTAAAACGAAC
TATTGCCGTGTACGGGTAC -> ATTGCCGTGTACGGGTACG
TATTTCATCGCTCTCAGTT -> ATTTCATCGCTCTCAGTTC
TATTTCGGAAAAACGTAAT -> ATTTCGGAAAAACGTAATA
TATTTGTTGGGGGGATATA -> ATTTGTTGGGGGGATATAC
TCAAGACCGACCTCTTTGT -> CAAGACCGACCTCTTTGTG
TCAAGACTTGTGCCCCTGG -> CAAGACTTGTGCCCCTGGG
TCAAGCTCCACTCTTGATG -> CAAGCTCCACTCTTGATGT
TCAAGGCCTACCCACGGAT -> CAAGGCCTACCCACGGATA
TCAAGTGTAGGCCGTCAAG -> CAAGTGTAGGCCGTCAAGA
TCAATCCTCCACAGCAGAG -> CAATCCTCCACAGCAGAGG
TCAATGTTCTAGCTTTCAC -> CAATGTTCTAGCTTTCACG
TCACATGGGTAAATTTCTG -> CACATGGGTAAATTTCTGA
TCACCAATGGACGGGCGCT -> CACCAATGGACGGGCGCTA
TCACCCTACACATATCCGG -> CACCCTACACATATCCGGA
TCACCCTCCTTAGACGGTA -> CACCCTCCTTAGACGGTAC
TCACCGTTCCTGGACTAGT -> CACCGTTCCTGGACTAGTG
TCACGTCAAGCTCCACTCT -> CACGTCAAGCTCCACTCTT
TCAGAATTGTAGCTAATCA -> CAGAATTGTAGCTAATCAC
TCAGGAGAGGAACGGCACG -> CAGGAGAGGAACGGCACGT
TCAGGAGAGGCCCACACAC -> CAGGAGAGGCCCACACACG
TCAGGAGAGGGAGTCCCTA -> CAGGAGAGGGAGTCCCTAT
TCAGGAGAGGTAGGTTGCA -> CAGGAGAGGTAGGTTGCAT
TCAGGTGTAAGTCTCAATG -> CAGGTGTAAGTCTCAATGT
TCAGTTCTGGCAACCTCTC -> CAGTTCTGGCAACCTCTCA
TCATAAGATTACCATGGGG -> CATAAGATTACCATGGGGC
TCATCCAAGCCCGCAGCGT -> CATCCAAGCCCGCAGCGTC
TCATCGCTCTCAGTTCTGG -> CATCGCTCTCAGTTCTGGC
TCATCGGTAGAGTCGGACT -> CATCGGTAGAGTCGGACTT
TCATCTATCGGCTCTTATT -> CATCTATCGGCTCTTATTT
TCATGACATGCATCTTGCG -> CATGACATGCATCTTGCGG
TCATGACGGGAGGACTGAC -> CATGACGGGAGGACTGACC
TCATGCTTCGCACCGACTT -> CATGCTTCGCACCGACTTC
TCATGGGTACGACGAGTGA -> CATGGGTACGACGAGTGAG
TCATGTGCCACTCGCACCT -> CATGTGCCACTCGCACCTG
TCATTTTCGCGAGGGGTCT -> CATTTTCGCGAGGGGTCTG
TCCAAGCCCGCAGCGTCGT -> CCAAGCCCGCAGCGTCGTA
TCCAATTAATAGACTATGC -> CCAATTAATAGACTATGCT
TCCACAGCAGAGGTAATAT -> CCACAGCAGAGGTAATATG
TCCACAGGGCATGGAGCCT -> CCACAGGGCATGGAGCCTC
TCCACCGAGCGGGTTTTTC -> CCACCGAGCGGGTTTTTCG
TCCACTCTTGATGTGCATG -> CCACTCTTGATGTGCATGA
TCCAGCGAAACCGAACGCG -> CCAGCGAAACCGAACGCGT
TCCATCGCCCGGCATTCGA -> CCATCGCCCGGCATTCGAT
TCCATGTACAAGCGCACCT -> CCATGTACAAGCGCACCTC
TCCATTAGCTATCTAACCA -> CCATTAGCTATCTAACCAT
TCCCATAGGCTCTTAATTT -> CCCATAGGCTCTTAATTTA
TCCCGATTGCGCAAGAATT -> CCCGATTGCGCAAGAATTG
TCCCTACTATACTTCGATG -> CCCTACTATACTTCGATGA
TCCCTATAGTTGGCTCTGG -> CCCTATAGTTGGCTCTGGA
TCCCTGTAACGCTTCTCGA -> CCCTGTAACGCTTCTCGAT
TCCGACCGGGCATGGAGCG -> CCGACCGGGCATGGAGCGA
TCCGGAATTCTACGTGTGT -> CCGGAATTCTACGTGTGTT
TCCGGATTGTGGAAGAGGA -> CCGGATTGTGGAAGAGGAC
TCCGGGAACCAATCCCTGT -> CCGGGAACCAATCCCTGTA
TCCGTACCTAAGAAGGACT -> CCGTACCTAAGAAGGACTG
TCCTAATATAGTCCATTAG -> CCTAATATAGTCCATTAGC
TCCTAGTTCTTTGAAAGAG -> CCTAGTTCTTTGAAAGAGA
TCCTATACTCGGTACTTGA -> CCTATACTCGGTACTTGAG
TCCTATCATGCTTCGCACC -> CCTATCATGCTTCGCACCG
TCCTCCACAGCAGAGGTAA -> CCTCCACAGCAGAGGTAAT
TCCTCTGCCCAGGCGGACG -> CCTCTGCCCAGGCGGACGC
TCCTGAGCAGCCCGTCGCC -> CCTGAGCAGCCCGTCGCCT
TCCTGATTCAGAATTGTAG -> CCTGATTCAGAATTGTAGC
TCCTGCTGTGTCCACCGAG -> CCTGCTGTGTCCACCGAGC
TCCTGGACTAGTGTTGAGT -> CCTGGACTAGTGTTGAGTG
TCCTGGCACCGTAAACTAC -> CCTGGCACCGTAAACTACC
TCCTGGTCAGGAGAGGAAC -> CCTGGTCAGGAGAGGAACG
TCCTGGTCAGGAGAGGCCC -> CCTGGTCAGGAGAGGCCCA
TCCTGGTCAGGAGAGGGAG -> CCTGGTCAGGAGAGGGAGT
TCCTGGTCAGGAGAGGTAG -> CCTGGTCAGGAGAGGTAGG
TCCTTAGACGGTACTATTT -> CCTTAGACGGTACTATTTC
TCGACGGCGTGGGCTGGAA -> CGACGGCGTGGGCTGGAAA
TCGACGTCACCAATGGACG -> CGACGTCACCAATGGACGG
TCGACTGTAGACGAAAAGT -> CGACTGTAGACGAAAAGTA
TCGAGATGTAGTGATAGAG -> CGAGATGTAGTGATAGAGG
TCGAGCCGCCTCTGGGTTC -> CGAGCCGCCTCTGGGTTCC
TCGATAAAAAGCTGTGATC -> CGATAAAAAGCTGTGATCT
TCGATCGGCCGAATAGCAT -> CGATCGGCCGAATAGCATT
TCGATGACGGCCGGCTTAA -> CGATGACGGCCGGCTTAAA
TCGATGAGACAAATAGTGA -> CGATGAGACAAATAGTGAA
TCGCACCGACTTCCATGTA -> CGCACCGACTTCCATGTAC
TCGCACCTGGGTGCTAGCA -> CGCACCTGGGTGCTAGCAA
TCGCATCCTCTGCCCAGGC -> CGCATCCTCTGCCCAGGCG
TCGCCCGGCATTCGATAAA -> CGCCCGGCATTCGATAAAA
TCGCCGGGGCTGTGTCCGT -> CGCCGGGGCTGTGTCCGTA
TCGCCTACTTGAATAAAAG -> CGCCTACTTGAATAAAAGA
TCGCGAGGGGTCTGCTGTG -> CGCGAGGGGTCTGCTGTGA
TCGCGCGCTCCAATTAATA -> CGCGCGCTCCAATTAATAG
TCGCGCTGCCCAGTAGAGA -> CGCGCTGCCCAGTAGAGAC
TCGCTCTCAGTTCTGGCAA -> CGCTCTCAGTTCTGGCAAC
TCGGAAAAACGTAATAAGT -> CGGAAAAACGTAATAAGTC
TCGGACTTTTAGCGCCGTA -> CGGACTTTTAGCGCCGTAC
TCGGCCGAATAGCATTAGC -> CGGCCGAATAGCATTAGCA
TCGGCTCTTATTTCATCGC -> CGGCTCTTATTTCATCGCT
TCGGGTGGAGTGTCATGTG -> CGGGTGGAGTGTCATGTGC
TCGGTACTTGAGATGCGAG -> CGGTACTTGAGATGCGAGG
TCGGTAGAGTCGGACTTTT -> CGGTAGAGTCGGACTTTTA
TCGTAACCCCGTTTTCCTG -> CGTAACCCCGTTTTCCTGG
TCGTCATCCAAGCCCGCAG -> CGTCATCCAAGCCCGCAGC
TCGTCGACGTCACCAATGG -> CGTCGACGTCACCAATGGA
TCGTCGATGAGACAAATAG -> CGTCGATGAGACAAATAGT
TCGTCGTCGACGTCACCAA -> CGTCGTCGACGTCACCAAT
TCGTTATTGCCGTGTACGG -> CGTTATTGCCGTGTACGGG
TCGTTTAATTACCGCCGTA -> CGTTTAATTACCGCCGTAA
TCTAAACTCTTCATGGGTA -> CTAAACTCTTCATGGGTAC
TCTAACCATGAATGGACCT -> CTAACCATGAATGGACCTG
TCTAAGAAGTTTGAGTATT -> CTAAGAAGTTTGAGTATTT
TCTAATAATTTGACTCGAG -> CTAATAATTTGACTCGAGA
TCTACGTGTGTTTCCTGGT -> CTACGTGTGTTTCCTGGTC
TCTAGCTTTCACGTCAAGC -> CTAGCTTTCACGTCAAGCT
TCTAGTGATGCGGCCCTCT -> CTAGTGATGCGGCCCTCTA
TCTATCGGCTCTTATTTCA -> CTATCGGCTCTTATTTCAT
TCTATGACTAGCTACCTAG -> CTATGACTAGCTACCTAGA
TCTCAAGGCCTACCCACGG -> CTCAAGGCCTACCCACGGA
TCTCAATGTTCTAGCTTTC -> CTCAATGTTCTAGCTTTCA
TCTCACATGGGTAAATTTC -> CTCACATGGGTAAATTTCT
TCTCAGTTCTGGCAACCTC -> CTCAGTTCTGGCAACCTCT
TCTCCACAGGGCATGGAGC -> CTCCACAGGGCATGGAGCC
TCTCCTAATATAGTCCATT -> CTCCTAATATAGTCCATTA
TCTCGATCGGCCGAATAGC -> CTCGATCGGCCGAATAGCA
TCTCTGGATAATCCTATCA -> CTCTGGATAATCCTATCAT
TCTGACAGTACTTTTGAGT -> CTGACAGTACTTTTGAGTG
TCTGCCCAGGCGGACGCCC -> CTGCCCAGGCGGACGCCCT
TCTGCGTTAATCTCTGGAT -> CTGCGTTAATCTCTGGATA
TCTGCTGCCAGTATCTAAG -> CTGCTGCCAGTATCTAAGA
TCTGCTGTGACTTTCCTGG -> CTGCTGTGACTTTCCTGGT
TCTGGAAGGAGGCAAGGCA -> CTGGAAGGAGGCAAGGCAC
TCTGGAAGGAGGCACTGTA -> CTGGAAGGAGGCACTGTAC
TCTGGAAGGAGGCATCATT -> CTGGAAGGAGGCATCATTT
TCTGGAAGGAGGCTCTGGC -> CTGGAAGGAGGCTCTGGCA
TCTGGATAATCCTATCATG -> CTGGATAATCCTATCATGC
TCTGGCAACCTCTCAAGGC -> CTGGCAACCTCTCAAGGCC
TCTGGCACGCCTTTCAATC -> CTGGCACGCCTTTCAATCC
TCTGGGTTCCATCGCCCGG -> CTGGGTTCCATCGCCCGGC
TCTTAAAACGAACTATAGC -> CTTAAAACGAACTATAGCC
TCTTAATGATGAATGATGG -> CTTAATGATGAATGATGGA
TCTTAATTTAAAACTTTAT -> CTTAATTTAAAACTTTATG
TCTTAGGCATGATAGCTTA -> CTTAGGCATGATAGCTTAA
TCTTATTTCATCGCTCTCA -> CTTATTTCATCGCTCTCAG
TCTTCATGGGTACGACGAG -> CTTCATGGGTACGACGAGT
TCTTGATGTGCATGACTTC -> CTTGATGTGCATGACTTCC
TCTTGCGGAAGTTCGTCAT -> CTTGCGGAAGTTCGTCATC
TCTTGTGCAGATTTCAAGA -> CTTGTGCAGATTTCAAGAC
TCTTTGAAAGAGATGATGA -> CTTTGAAAGAGATGATGAT
TCTTTGTGTCTAAACTCTT -> CTTTGTGTCTAAACTCTTC
TGAAAGAGATGATGATAGG -> GAAAGAGATGATGATAGGC
TGAAGACGGCGACCAACCG -> GAAGACGGCGACCAACCGA
TGAATAAAAGAAACGCCCC -> GAATAAAAGAAACGCCCCT
TGAATGATGGATTTCATGA -> GAATGATGGATTTCATGAC
TGAATGGACCTGACTCCGG -> GAATGGACCTGACTCCGGA
TGACAGTACTTTTGAGTGG -> GACAGTACTTTTGAGTGGT
TGACATGCATCTTGCGGAA -> GACATGCATCTTGCGGAAG
TGACCTCTTAGGCATGATA -> GACCTCTTAGGCATGATAG
TGACGGATCGACTGTAGAC -> GACGGATCGACTGTAGACG
TGACGGCCGGCTTAAAAGT -> GACGGCCGGCTTAAAAGTT
TGACGGGAGGACTGACCTC -> GACGGGAGGACTGACCTCT
TGACTAGCTACCTAGAGTA -> GACTAGCTACCTAGAGTAC
TGACTCCGGAATTCTACGT -> GACTCCGGAATTCTACGTG
TGACTCGAGATGTAGTGAT -> GACTCGAGATGTAGTGATA
TGACTTCCGGGAACCAATC -> GACTTCCGGGAACCAATCC
TGACTTTCCTGGTCAGGAG -> GACTTTCCTGGTCAGGAGA
TGAGACAAATAGTGAAGAC -> GAGACAAATAGTGAAGACG
TGAGACCGGGAAGCAAAGA -> GAGACCGGGAAGCAAAGAC
TGAGATGCGAGGTATCAAG -> GAGATGCGAGGTATCAAGT
TGAGCAATGTGCTCATCGG -> GAGCAATGTGCTCATCGGT
TGAGCAGCCCGTCGCCTAC -> GAGCAGCCCGTCGCCTACT
TGAGTATTTGTTGGGGGGA -> GAGTATTTGTTGGGGGGAT
TGAGTCTTAAAACGAACTA -> GAGTCTTAAAACGAACTAT
TGAGTGGTGCCTGATGGAG -> GAGTGGTGCCTGATGGAGG
TGAGTGGTTAAGAATTTAG -> GAGTGGTTAAGAATTTAGA
TGATAGAGGTCGCATCCTC -> GATAGAGGTCGCATCCTCT
TGATAGCTTAAGAGGGAGT -> GATAGCTTAAGAGGGAGTT
TGATAGGCTCGACGGCGTG -> GATAGGCTCGACGGCGTGG
TGATCTGCTGCCAGTATCT -> GATCTGCTGCCAGTATCTA
TGATCTTGTGCAGATTTCA -> GATCTTGTGCAGATTTCAA
TGATGAATGATGGATTTCA -> GATGAATGATGGATTTCAT
TGATGATAGGCTCGACGGC -> GATGATAGGCTCGACGGCG
TGATGGAGGGATCTCCACA -> GATGGAGGGATCTCCACAG
TGATGGATTTCATGACGGG -> GATGGATTTCATGACGGGA
TGATGTCGTTTAATTACCG -> GATGTCGTTTAATTACCGC
TGATGTGCATGACTTCCGG -> GATGTGCATGACTTCCGGG
TGATTCAGAATTGTAGCTA -> GATTCAGAATTGTAGCTAA
TGCACGGACTCGCCGGGGC -> GCACGGACTCGCCGGGGCT
TGCAGATTTCAAGACTTGT -> GCAGATTTCAAGACTTGTG
TGCATCTTGCGGAAGTTCG -> GCATCTTGCGGAAGTTCGT
TGCATGACTTCCGGGAACC -> GCATGACTTCCGGGAACCA
TGCATGCGGAGCGAGGATC -> GCATGCGGAGCGAGGATCC
TGCATGGTTGGCTCTGGAA -> GCATGGTTGGCTCTGGAAG
TGCCACTCGCACCTGGGTG -> GCCACTCGCACCTGGGTGC
TGCCAGTATCTAAGAAGTT -> GCCAGTATCTAAGAAGTTT
TGCCCAGGCGGACGCCCTC -> GCCCAGGCGGACGCCCTCC
TGCCCAGTAGAGACGACGT -> GCCCAGTAGAGACGACGTC
TGCCCCTGGGTTATGCTCC -> GCCCCTGGGTTATGCTCCC
TGCCGTGTACGGGTACGAT -> GCCGTGTACGGGTACGATG
TGCCTGATGGAGGGATCTC -> GCCTGATGGAGGGATCTCC
TGCGAAATCGTTATTGCCG -> GCGAAATCGTTATTGCCGT
TGCGAGGTATCAAGTGTAG -> GCGAGGTATCAAGTGTAGG
TGCGCAAGAATTGAGACCG -> GCGCAAGAATTGAGACCGG
TGCGGAAGTTCGTCATCCA -> GCGGAAGTTCGTCATCCAA
TGCGGAGCGAGGATCCAGC -> GCGGAGCGAGGATCCAGCG
TGCGTTAATCTCTGGATAA -> GCGTTAATCTCTGGATAAT
TGCTACGGTCTATGACTAG -> GCTACGGTCTATGACTAGC
TGCTAGCAAGACGTCCGAC -> GCTAGCAAGACGTCCGACC
TGCTCATCGGTAGAGTCGG -> GCTCATCGGTAGAGTCGGA
TGCTCCCGATTGCGCAAGA -> GCTCCCGATTGCGCAAGAA
TGCTCGGGTGGAGTGTCAT -> GCTCGGGTGGAGTGTCATG
TGCTGCCAGTATCTAAGAA -> GCTGCCAGTATCTAAGAAG
TGCTGTGACTTTCCTGGTC -> GCTGTGACTTTCCTGGTCA
TGCTGTGTCCACCGAGCGG -> GCTGTGTCCACCGAGCGGG
TGCTTCGCACCGACTTCCA -> GCTTCGCACCGACTTCCAT
TGGAAAAGACTGATCTTGT -> GGAAAAGACTGATCTTGTG
TGGAAGAGGACTGCACGGA -> GGAAGAGGACTGCACGGAC
TGGAAGGAGGCAAGGCACG -> GGAAGGAGGCAAGGCACGC
TGGAAGGAGGCACTGTACG -> GGAAGGAGGCACTGTACGA
TGGAAGGAGGCATCATTTT -> GGAAGGAGGCATCATTTTC
TGGAAGGAGGCTCTGGCAC -> GGAAGGAGGCTCTGGCACG
TGGACCTGACTCCGGAATT -> GGACCTGACTCCGGAATTC
TGGACGGGCGCTATCTAAT -> GGACGGGCGCTATCTAATA
TGGACTAGTGTTGAGTGGT -> GGACTAGTGTTGAGTGGTG
TGGAGACTACGACGAACAG -> GGAGACTACGACGAACAGG
TGGAGCCTCTCCTAATATA -> GGAGCCTCTCCTAATATAG
TGGAGCGAGCCTAAGGTAG -> GGAGCGAGCCTAAGGTAGG
TGGAGGGATCTCCACAGGG -> GGAGGGATCTCCACAGGGC
TGGAGTGCATGCGGAGCGA -> GGAGTGCATGCGGAGCGAG
TGGAGTGTCATGTGCCACT -> GGAGTGTCATGTGCCACTC
TGGATAATCCTATCATGCT -> GGATAATCCTATCATGCTT
TGGATTTCATGACGGGAGG -> GGATTTCATGACGGGAGGA
TGGCAACCTCTCAAGGCCT -> GGCAACCTCTCAAGGCCTA
TGGCACCGTAAACTACCAC -> GGCACCGTAAACTACCACA
TGGCACGCCTTTCAATCCT -> GGCACGCCTTTCAATCCTC
TGGCTCTGGAAGGAGGCAA -> GGCTCTGGAAGGAGGCAAG
TGGCTCTGGAAGGAGGCAC -> GGCTCTGGAAGGAGGCACT
TGGCTCTGGAAGGAGGCAT -> GGCTCTGGAAGGAGGCATC
TGGCTCTGGAAGGAGGCTC -> GGCTCTGGAAGGAGGCTCT
TGGGATTCAGGTGTAAGTC -> GGGATTCAGGTGTAAGTCT
TGGGCTGGAAAAGACTGAT -> GGGCTGGAAAAGACTGATC
TGGGGCGTCGTCGTCGACG -> GGGGCGTCGTCGTCGACGT
TGGGGGGATATACCGACGC -> GGGGGGATATACCGACGCC
TGGGTAAATTTCTGACAGT -> GGGTAAATTTCTGACAGTA
TGGGTACGACGAGTGAGCA -> GGGTACGACGAGTGAGCAA
TGGGTGCTAGCAAGACGTC -> GGGTGCTAGCAAGACGTCC
TGGGTTATGCTCCCGATTG -> GGGTTATGCTCCCGATTGC
TGGGTTCCATCGCCCGGCA -> GGGTTCCATCGCCCGGCAT
TGGTATAGTGTTGGTTAAA -> GGTATAGTGTTGGTTAAAC
TGGTCAGGAGAGGAACGGC -> GGTCAGGAGAGGAACGGCA
TGGTCAGGAGAGGCCCACA -> GGTCAGGAGAGGCCCACAC
TGGTCAGGAGAGGGAGTCC -> GGTCAGGAGAGGGAGTCCC
TGGTCAGGAGAGGTAGGTT -> GGTCAGGAGAGGTAGGTTG
TGGTGCCTGATGGAGGGAT -> GGTGCCTGATGGAGGGATC
TGGTTAAACAAGTTGGGAT -> GGTTAAACAAGTTGGGATT
TGGTTAAGAATTTAGAATG -> GGTTAAGAATTTAGAATGT
TGGTTGGCTCTGGAAGGAG -> GGTTGGCTCTGGAAGGAGG
TGGTTTGGAGACTACGACG -> GGTTTGGAGACTACGACGA
TGTAACGCTTCTCGATCGG -> GTAACGCTTCTCGATCGGC
TGTAAGTCTCAATGTTCTA -> GTAAGTCTCAATGTTCTAG
TGTACAAGCGCACCTCTTA -> GTACAAGCGCACCTCTTAA
TGTACGATCATGACATGCA -> GTACGATCATGACATGCAT
TGTACGGGTACGATGGTAT -> GTACGGGTACGATGGTATA
TGTACGTCCTAGTTCTTTG -> GTACGTCCTAGTTCTTTGA
TGTAGACGAAAAGTACAAC -> GTAGACGAAAAGTACAACG
TGTAGATTATAATAGTCAC -> GTAGATTATAATAGTCACC
TGTAGCTAATCACCCTCCT -> GTAGCTAATCACCCTCCTT
TGTAGGCCGTCAAGACCGA -> GTAGGCCGTCAAGACCGAC
TGTAGTGATAGAGGTCGCA -> GTAGTGATAGAGGTCGCAT
TGTCATGTGCCACTCGCAC -> GTCATGTGCCACTCGCACC
TGTCCACCGAGCGGGTTTT -> GTCCACCGAGCGGGTTTTT
TGTCCCATAGGCTCTTAAT -> GTCCCATAGGCTCTTAATT
TGTCCGTACCTAAGAAGGA -> GTCCGTACCTAAGAAGGAC
TGTCGTTTAATTACCGCCG -> GTCGTTTAATTACCGCCGT
TGTCTAAACTCTTCATGGG -> GTCTAAACTCTTCATGGGT
TGTGACTTTCCTGGTCAGG -> GTGACTTTCCTGGTCAGGA
TGTGATCTGCTGCCAGTAT -> GTGATCTGCTGCCAGTATC
TGTGCAGATTTCAAGACTT -> GTGCAGATTTCAAGACTTG
TGTGCATGACTTCCGGGAA -> GTGCATGACTTCCGGGAAC
TGTGCCACTCGCACCTGGG -> GTGCCACTCGCACCTGGGT
TGTGCCCCTGGGTTATGCT -> GTGCCCCTGGGTTATGCTC
TGTGCTCATCGGTAGAGTC -> GTGCTCATCGGTAGAGTCG
TGTGGAAGAGGACTGCACG -> GTGGAAGAGGACTGCACGG
TGTGTCCACCGAGCGGGTT -> GTGTCCACCGAGCGGGTTT
TGTGTCCGTACCTAAGAAG -> GTGTCCGTACCTAAGAAGG
TGTGTCTAAACTCTTCATG -> GTGTCTAAACTCTTCATGG
TGTGTTTCCTGGTCAGGAG -> GTGTTTCCTGGTCAGGAGA
TGTTCACCGTTCCTGGACT -> GTTCACCGTTCCTGGACTA
TGTTCTAGCTTTCACGTCA -> GTTCTAGCTTTCACGTCAA
TGTTGAGTGGTGCCTGATG -> GTTGAGTGGTGCCTGATGG
TGTTGGGGGGATATACCGA -> GTTGGGGGGATATACCGAC
TGTTGGTTAAACAAGTTGG -> GTTGGTTAAACAAGTTGGG
TGTTGTACGTCCTAGTTCT -> GTTGTACGTCCTAGTTCTT
TGTTTCCTGGTCAGGAGAG -> GTTTCCTGGTCAGGAGAGG
TTAAAACGAACTATAGCCT -> TAAAACGAACTATAGCCTC
TTAAAACTTTATGTTGTAC -> TAAAACTTTATGTTGTACG
TTAAAAGTTCGTCGATGAG -> TAAAAGTTCGTCGATGAGA
TTAAACAAGTTGGGATTCA -> TAAACAAGTTGGGATTCAG
TTAAATACCTACGGGTAAG -> TAAATACCTACGGGTAAGT
TTAAGAATTTAGAATGTAG -> TAAGAATTTAGAATGTAGA
TTAAGAGGGAGTTCTCACA -> TAAGAGGGAGTTCTCACAT
TTAAGGACTTTTAAATACC -> TAAGGACTTTTAAATACCT
TTAATAGACTATGCTCGGG -> TAATAGACTATGCTCGGGT
TTAATCTCTGGATAATCCT -> TAATCTCTGGATAATCCTA
TTAATGATGAATGATGGAT -> TAATGATGAATGATGGATT
TTAATTACCGCCGTAAACC -> TAATTACCGCCGTAAACCC
TTAATTTAAAACTTTATGT -> TAATTTAAAACTTTATGTT
TTACCATGGGGCGTCGTCG -> TACCATGGGGCGTCGTCGT
TTACCGCCGTAAACCCTAT -> TACCGCCGTAAACCCTATT
TTACTGGTTTGGAGACTAC -> TACTGGTTTGGAGACTACG
TTAGAATGTAGATTATAAT -> TAGAATGTAGATTATAATA
TTAGACGGTACTATTTCGG -> TAGACGGTACTATTTCGGA
TTAGCACCAAGAAGGGCCC -> TAGCACCAAGAAGGGCCCC
TTAGCGCCGTACCCAGGTG -> TAGCGCCGTACCCAGGTGC
TTAGCTATCTAACCATGAA -> TAGCTATCTAACCATGAAT
TTAGGCATGATAGCTTAAG -> TAGGCATGATAGCTTAAGA
TTATAATAGTCACCCTACA -> TATAATAGTCACCCTACAC
TTATCCTGGCACCGTAAAC -> TATCCTGGCACCGTAAACT
TTATGCTCCCGATTGCGCA -> TATGCTCCCGATTGCGCAA
TTATGTTGTACGTCCTAGT -> TATGTTGTACGTCCTAGTT
TTATTGCCGTGTACGGGTA -> TATTGCCGTGTACGGGTAC
TTATTTCATCGCTCTCAGT -> TATTTCATCGCTCTCAGTT
TTCAAGACTTGTGCCCCTG -> TCAAGACTTGTGCCCCTGG
TTCAATCCTCCACAGCAGA -> TCAATCCTCCACAGCAGAG
TTCACCGTTCCTGGACTAG -> TCACCGTTCCTGGACTAGT
TTCACGTCAAGCTCCACTC -> TCACGTCAAGCTCCACTCT
TTCAGAATTGTAGCTAATC -> TCAGAATTGTAGCTAATCA
TTCAGGTGTAAGTCTCAAT -> TCAGGTGTAAGTCTCAATG
TTCATCGCTCTCAGTTCTG -> TCATCGCTCTCAGTTCTGG
TTCATGACGGGAGGACTGA -> TCATGACGGGAGGACTGAC
TTCATGGGTACGACGAGTG -> TCATGGGTACGACGAGTGA
TTCCATCGCCCGGCATTCG -> TCCATCGCCCGGCATTCGA
TTCCATGTACAAGCGCACC -> TCCATGTACAAGCGCACCT
TTCCGGGAACCAATCCCTG -> TCCGGGAACCAATCCCTGT
TTCCTGAGCAGCCCGTCGC -> TCCTGAGCAGCCCGTCGCC
TTCCTGGACTAGTGTTGAG -> TCCTGGACTAGTGTTGAGT
TTCCTGGTCAGGAGAGGAA -> TCCTGGTCAGGAGAGGAAC
TTCCTGGTCAGGAGAGGCC -> TCCTGGTCAGGAGAGGCCC
TTCCTGGTCAGGAGAGGGA -> TCCTGGTCAGGAGAGGGAG
TTCCTGGTCAGGAGAGGTA -> TCCTGGTCAGGAGAGGTAG
TTCGATAAAAAGCTGTGAT -> TCGATAAAAAGCTGTGATC
TTCGATGACGGCCGGCTTA -> TCGATGACGGCCGGCTTAA
TTCGCACCGACTTCCATGT -> TCGCACCGACTTCCATGTA
TTCGCGAGGGGTCTGCTGT -> TCGCGAGGGGTCTGCTGTG
TTCGCGCGCTCCAATTAAT -> TCGCGCGCTCCAATTAATA
TTCGCGCTGCCCAGTAGAG -> TCGCGCTGCCCAGTAGAGA
TTCGGAAAAACGTAATAAG -> TCGGAAAAACGTAATAAGT
TTCGTCATCCAAGCCCGCA -> TCGTCATCCAAGCCCGCAG
TTCGTCGATGAGACAAATA -> TCGTCGATGAGACAAATAG
TTCTACGTGTGTTTCCTGG -> TCTACGTGTGTTTCCTGGT
TTCTAGCTTTCACGTCAAG -> TCTAGCTTTCACGTCAAGC
TTCTCACATGGGTAAATTT -> TCTCACATGGGTAAATTTC
TTCTCGATCGGCCGAATAG -> TCTCGATCGGCCGAATAGC
TTCTGACAGTACTTTTGAG -> TCTGACAGTACTTTTGAGT
TTCTGGCAACCTCTCAAGG -> TCTGGCAACCTCTCAAGGC
TTCTTTGAAAGAGATGATG -> TCTTTGAAAGAGATGATGA
TTGAAAGAGATGATGATAG -> TGAAAGAGATGATGATAGG
TTGAATAAAAGAAACGCCC -> TGAATAAAAGAAACGCCCC
TTGACGGATCGACTGTAGA -> TGACGGATCGACTGTAGAC
TTGACTCGAGATGTAGTGA -> TGACTCGAGATGTAGTGAT
TTGAGACCGGGAAGCAAAG -> TGAGACCGGGAAGCAAAGA
TTGAGATGCGAGGTATCAA -> TGAGATGCGAGGTATCAAG
TTGAGTATTTGTTGGGGGG -> TGAGTATTTGTTGGGGGGA
TTGAGTCTTAAAACGAACT -> TGAGTCTTAAAACGAACTA
TTGAGTGGTGCCTGATGGA -> TGAGTGGTGCCTGATGGAG
TTGAGTGGTTAAGAATTTA -> TGAGTGGTTAAGAATTTAG
TTGATGTCGTTTAATTACC -> TGATGTCGTTTAATTACCG
TTGATGTGCATGACTTCCG -> TGATGTGCATGACTTCCGG
TTGCATGGTTGGCTCTGGA -> TGCATGGTTGGCTCTGGAA
TTGCCGTGTACGGGTACGA -> TGCCGTGTACGGGTACGAT
TTGCGCAAGAATTGAGACC -> TGCGCAAGAATTGAGACCG
TTGCGGAAGTTCGTCATCC -> TGCGGAAGTTCGTCATCCA
TTGGAGACTACGACGAACA -> TGGAGACTACGACGAACAG
TTGGCTCTGGAAGGAGGCA -> TGGCTCTGGAAGGAGGCAA,TGGCTCTGGAAGGAGGCAC,TGGCTCTGGAAGGAGGCAT
TTGGCTCTGGAAGGAGGCT -> TGGCTCTGGAAGGAGGCTC
TTGGGATTCAGGTGTAAGT -> TGGGATTCAGGTGTAAGTC
TTGGGGGGATATACCGACG -> TGGGGGGATATACCGACGC
TTGGTTAAACAAGTTGGGA -> TGGTTAAACAAGTTGGGAT
TTGTACGTCCTAGTTCTTT -> TGTACGTCCTAGTTCTTTG
TTGTAGCTAATCACCCTCC -> TGTAGCTAATCACCCTCCT
TTGTGCAGATTTCAAGACT -> TGTGCAGATTTCAAGACTT
TTGTGCCCCTGGGTTATGC -> TGTGCCCCTGGGTTATGCT
TTGTGGAAGAGGACTGCAC -> TGTGGAAGAGGACTGCACG
TTGTGTCTAAACTCTTCAT -> TGTGTCTAAACTCTTCATG
TTGTTGGGGGGATATACCG -> TGTTGGGGGGATATACCGA
TTTAAAACTTTATGTTGTA -> TTAAAACTTTATGTTGTAC
TTTAAATACCTACGGGTAA -> TTAAATACCTACGGGTAAG
TTTAATTACCGCCGTAAAC -> TTAATTACCGCCGTAAACC
TTTAGAATGTAGATTATAA -> TTAGAATGTAGATTATAAT
TTTAGCGCCGTACCCAGGT -> TTAGCGCCGTACCCAGGTG
TTTATGTTGTACGTCCTAG -> TTATGTTGTACGTCCTAGT
TTTCAAGACTTGTGCCCCT -> TTCAAGACTTGTGCCCCTG
TTTCAATCCTCCACAGCAG -> TTCAATCCTCCACAGCAGA
TTTCACGTCAAGCTCCACT -> TTCACGTCAAGCTCCACTC
TTTCATCGCTCTCAGTTCT -> TTCATCGCTCTCAGTTCTG
TTTCATGACGGGAGGACTG -> TTCATGACGGGAGGACTGA
TTTCCTGGTCAGGAGAGGA -> TTCCTGGTCAGGAGAGGAA
TTTCCTGGTCAGGAGAGGC -> TTCCTGGTCAGGAGAGGCC
TTTCCTGGTCAGGAGAGGG -> TTCCTGGTCAGGAGAGGGA
TTTCCTGGTCAGGAGAGGT -> TTCCTGGTCAGGAGAGGTA
TTTCGCGAGGGGTCTGCTG -> TTCGCGAGGGGTCTGCTGT
TTTCGCGCGCTCCAATTAA -> TTCGCGCGCTCCAATTAAT
TTTCGGAAAAACGTAATAA -> TTCGGAAAAACGTAATAAG
TTTCTGACAGTACTTTTGA -> TTCTGACAGTACTTTTGAG
TTTGAAAGAGATGATGATA -> TTGAAAGAGATGATGATAG
TTTGACGGATCGACTGTAG -> TTGACGGATCGACTGTAGA
TTTGACTCGAGATGTAGTG -> TTGACTCGAGATGTAGTGA
TTTGAGTATTTGTTGGGGG -> TTGAGTATTTGTTGGGGGG
TTTGAGTGGTTAAGAATTT -> TTGAGTGGTTAAGAATTTA
TTTGGAGACTACGACGAAC -> TTGGAGACTACGACGAACA
TTTGTGTCTAAACTCTTCA -> TTGTGTCTAAACTCTTCAT
TTTGTTGGGGGGATATACC -> TTGTTGGGGGGATATACCG
TTTTAAATACCTACGGGTA -> TTTAAATACCTACGGGTAA
TTTTAGCGCCGTACCCAGG -> TTTAGCGCCGTACCCAGGT
TTTTCCTGGTCAGGAGAGG -> TTTCCTGGTCAGGAGAGGT
TTTTCGCGAGGGGTCTGCT -> TTTCGCGAGGGGTCTGCTG
TTTTCGCGCGCTCCAATTA -> TTTCGCGCGCTCCAATTAA
TTTTGAGTGGTTAAGAATT -> TTTGAGTGGTTAAGAATTT
TTTTTCGCGCGCTCCAATT -> TTTTCGCGCGCTCCAATTA
