AAAAAACGGAG -> AAAAACGGAGG
AAAAACGGAGG -> AAAACGGAGGC
AAAAAGGGTGT -> AAAAGGGTGTA
AAAAATCACCG -> AAAATCACCGG
AAAACGGAGGC -> AAACGGAGGCA
AAAAGGGTGTA -> AAAGGGTGTAT
AAAAGGTGTGG -> AAAGGTGTGGC
AAAAGTATGGA -> AAAGTATGGAA
AAAAGTCTCGG -> AAAGTCTCGGT
AAAATCACCGG -> AAATCACCGGT
AAACAATTACG -> AACAATTACGC
AAACGGAGGCA -> AACGGAGGCAA
AAACGTGGAGG -> AACGTGGAGGC
AAACTCTTTTC -> AACTCTTTTCG
AAAGAAGGCTT -> AAGAAGGCTTG
AAAGCAGTTTT -> AAGCAGTTTTG
AAAGCCTAAGC -> AAGCCTAAGCC
AAAGGCCCCCC -> AAGGCCCCCCG
AAAGGGGAGGC -> AAGGGGAGGCG
AAAGGGTGTAT -> AAGGGTGTATG
AAAGGTGTGGC -> AAGGTGTGGCT
AAAGTACCGTC -> AAGTACCGTCG
AAAGTATGGAA -> AAGTATGGAAA
AAAGTCGTAAG -> AAGTCGTAAGT
AAAGTCTCGGT -> AAGTCTCGGTA
AAATAGTGCCT -> AATAGTGCCTT
AAATCACCGGT -> AATCACCGGTA
AAATCGAGAGA -> AATCGAGAGAG
AAATTCATAAA -> AATTCATAAAA
AAATTGGCTAC -> AATTGGCTACG
AACAATTACGC -> ACAATTACGCA
AACAGATTCCA -> ACAGATTCCAT
AACAGTCCTCA -> ACAGTCCTCAA
AACCCCAACGT -> ACCCCAACGTA
AACCCCAGGCA -> ACCCCAGGCAG
AACCGGACACG -> ACCGGACACGA
AACCGTCGAAA -> ACCGTCGAAAT
AACCGTCTGTG -> ACCGTCTGTGC
AACCGTTACTA -> ACCGTTACTAT
AACCTGGCATG -> ACCTGGCATGA
AACGGAGGCAA -> ACGGAGGCAAT
AACGGGTACCA -> ACGGGTACCAG
AACGTAGTATA -> ACGTAGTATAT
AACGTGGAGGC -> ACGTGGAGGCG
AACTAACTCCT -> ACTAACTCCTA
AACTACCGTAG -> ACTACCGTAGT
AACTCCCGAGG -> ACTCCCGAGGA
AACTCCTACAG -> ACTCCTACAGT
AACTCTAAGAA -> ACTCTAAGAAG
AACTCTTTTCG -> ACTCTTTTCGG
AACTGCGACCC -> ACTGCGACCCC
AACTGTATCAG -> ACTGTATCAGT
AACTTGAGGAC -> ACTTGAGGACG
AAGAACTACCG -> AGAACTACCGT
AAGAAGGCTTG -> AGAAGGCTTGG
AAGAAGTACAT -> AGAAGTACATG
AAGAATCGAAA -> AGAATCGAAAA
AAGACGAGTTA -> AGACGAGTTAC
AAGAGTTGCCG -> AGAGTTGCCGC
AAGATATTAGT -> AGATATTAGTC
AAGCACCCATA -> AGCACCCATAC
AAGCAGTTTTG -> AGCAGTTTTGG
AAGCCTAAGCC -> AGCCTAAGCCT
AAGCCTCACTT -> AGCCTCACTTC
AAGCTCTCGGT -> AGCTCTCGGTC
AAGCTGTGGAT -> AGCTGTGGATT
AAGGACGAAAG -> AGGACGAAAGG
AAGGATAGAGT -> AGGATAGAGTG
AAGGCCCCCCG -> AGGCCCCCCGA
AAGGCCGCAAG -> AGGCCGCAAGG
AAGGCGACGGC -> AGGCGACGGCG
AAGGCTTGGTT -> AGGCTTGGTTG
AAGGGGAGGCG -> AGGGGAGGCGG
AAGGGTGTATG -> AGGGTGTATGT
AAGGTGTGGCT -> AGGTGTGGCTC
AAGTAATCCGG -> AGTAATCCGGG
AAGTACATGCA -> AGTACATGCAA
AAGTACCAGTG -> AGTACCAGTGT
AAGTACCGTCG -> AGTACCGTCGG
AAGTACGCGCA -> AGTACGCGCAG
AAGTAGGAGCG -> AGTAGGAGCGA
AAGTATGGAAA -> AGTATGGAAAC
AAGTCCTTTGC -> AGTCCTTTGCG
AAGTCGTAAGT -> AGTCGTAAGTT
AAGTCTCGGTA -> AGTCTCGGTAC
AAGTGTTGATT -> AGTGTTGATTA
AAGTTAAGAAT -> AGTTAAGAATC
AAGTTGACTAC -> AGTTGACTACG
AAGTTGTGCAC -> AGTTGTGCACT
AATAAAGTACC -> ATAAAGTACCG
AATACCAGGCG -> ATACCAGGCGC
AATAGCAAGGC -> ATAGCAAGGCC
AATAGGCCGAA -> ATAGGCCGAAT
AATAGGGCTCT -> ATAGGGCTCTG
AATAGTGCCTT -> ATAGTGCCTTC
AATCACCGGTA -> ATCACCGGTAA
AATCAGTACAA -> ATCAGTACAAT
AATCCGCACAT -> ATCCGCACATT
AATCCGGGATG -> ATCCGGGATGT
AATCGAAAAGT -> ATCGAAAAGTA
AATCGAGAGAG -> ATCGAGAGAGC
AATCTGTCATC -> ATCTGTCATCC
AATCTTCTCTG -> ATCTTCTCTGC
AATCTTGCAGG -> ATCTTGCAGGG
AATGACCAGTA -> ATGACCAGTAC
AATGCCCCAAA -> ATGCCCCAAAA
AATGCCGTGGG -> ATGCCGTGGGA
AATGGCAACCG -> ATGGCAACCGT
AATGTTATTCC -> ATGTTATTCCA
AATTACGCAGC -> ATTACGCAGCT
AATTCATAAAA -> ATTCATAAAAG
AATTGCCCGTG -> ATTGCCCGTGG
AATTGGCTACG -> ATTGGCTACGT
ACAAACAATTA -> CAAACAATTAC
ACAAAGTCGTA -> CAAAGTCGTAA
ACAATAGCAAG -> CAATAGCAAGG
ACAATCTTGCA -> CAATCTTGCAG
ACAATTACGCA -> CAATTACGCAG
ACACATGTAAT -> CACATGTAATG
ACACGACAATC -> CACGACAATCT
ACACTATTGAC -> CACTATTGACC
ACACTCATTTT -> CACTCATTTTC
ACAGATTCCAT -> CAGATTCCATC
ACAGCGTCACA -> CAGCGTCACAT
ACAGCTAAGTA -> CAGCTAAGTAC
ACAGGAGTTTT -> CAGGAGTTTTT
ACAGTCCTCAA -> CAGTCCTCAAA
ACAGTGTGTTA -> CAGTGTGTTAA
ACATACACTCA -> CATACACTCAT
ACATCCCAGTA -> CATCCCAGTAT
ACATCCGTCGA -> CATCCGTCGAA
ACATCGCATTC -> CATCGCATTCC
ACATGCAATAA -> CATGCAATAAA
ACATGCTTGCA -> CATGCTTGCAT
ACATGGAAGTT -> CATGGAAGTTA
ACATGTAATGC -> CATGTAATGCC
ACATGTGCTTA -> CATGTGCTTAG
ACATTCTTGAT -> CATTCTTGATG
ACATTGGACCA -> CATTGGACCAA
ACCAACCTGGC -> CCAACCTGGCA
ACCAAGATATT -> CCAAGATATTA
ACCAATAGGCC -> CCAATAGGCCG
ACCAGACCTCG -> CCAGACCTCGA
ACCAGCGCGCA -> CCAGCGCGCAA
ACCAGGCGCAG -> CCAGGCGCAGA
ACCAGTACGTT -> CCAGTACGTTG
ACCAGTGTACC -> CCAGTGTACCC
ACCATTCTCTC -> CCATTCTCTCT
ACCCATACATG -> CCCATACATGC
ACCCCAACGTA -> CCCCAACGTAG
ACCCCACCTTG -> CCCCACCTTGT
ACCCCAGGCAG -> CCCCAGGCAGG
ACCCCATGAGC -> CCCCATGAGCC
ACCGAACAGTC -> CCGAACAGTCC
ACCGCGACATA -> CCGCGACATAC
ACCGGACACGA -> CCGGACACGAC
ACCGGTAAGCT -> CCGGTAAGCTC
ACCGTAGTCTG -> CCGTAGTCTGC
ACCGTCGAAAT -> CCGTCGAAATC
ACCGTCGGGAA -> CCGTCGGGAAC
ACCGTCTGTGC -> CCGTCTGTGCG
ACCGTTACTAT -> CCGTTACTATT
ACCGTTATGGG -> CCGTTATGGGT
ACCTCGAACCC -> CCTCGAACCCC
ACCTCGATTGG -> CCTCGATTGGC
ACCTCTGAAAC -> CCTCTGAAACT
ACCTGGCATGA -> CCTGGCATGAC
ACCTTAAAGGC -> CCTTAAAGGCC
ACCTTGTCTTA -> CCTTGTCTTAC
ACCTTTGAGAG -> CCTTTGAGAGC
ACGAAAGGGGA -> CGAAAGGGGAG
ACGAACTCTAA -> CGAACTCTAAG
ACGAATGGCAA -> CGAATGGCAAC
ACGACAATCTT -> CGACAATCTTG
ACGACTCATTG -> CGACTCATTGG
ACGACTTCGTT -> CGACTTCGTTG
ACGAGGCGGTT -> CGAGGCGGTTC
ACGAGTTACCT -> CGAGTTACCTT
ACGATTGTGCA -> CGATTGTGCAC
ACGCAGCTCGA -> CGCAGCTCGAA
ACGCCATTTAG -> CGCCATTTAGA
ACGCCGACCAG -> CGCCGACCAGC
ACGCCGATGGC -> CGCCGATGGCC
ACGCCTATATG -> CGCCTATATGC
ACGCGCAGGCG -> CGCGCAGGCGG
ACGGACTGCGA -> CGGACTGCGAC
ACGGAGGCAAT -> CGGAGGCAATG
ACGGATATTCA -> CGGATATTCAT
ACGGCGAACCG -> CGGCGAACCGT
ACGGGCATCAT -> CGGGCATCATG
ACGGGTACCAG -> CGGGTACCAGA
ACGGTTCAAAG -> CGGTTCAAAGA
ACGTAAGACGA -> CGTAAGACGAG
ACGTACATTGG -> CGTACATTGGA
ACGTAGTATAT -> CGTAGTATATT
ACGTATTGCAA -> CGTATTGCAAG
ACGTCGTGATT -> CGTCGTGATTA
ACGTGGAGGCG -> CGTGGAGGCGT
ACGTTGCTACT -> CGTTGCTACTG
ACTAACTCCTA -> CTAACTCCTAC
ACTACCAAGAT -> CTACCAAGATA
ACTACCATTCT -> CTACCATTCTC
ACTACCGTAGT -> CTACCGTAGTC
ACTACGGTTCA -> CTACGGTTCAA
ACTACTAGCCG -> CTACTAGCCGG
ACTACTTCCGA -> CTACTTCCGAC
ACTAGCCGGAG -> CTAGCCGGAGT
ACTATATCAAT -> CTATATCAATA
ACTATTGACCT -> CTATTGACCTC
ACTATTGCCGG -> CTATTGCCGGA
ACTCATTGGGT -> CTCATTGGGTT
ACTCATTTTCC -> CTCATTTTCCT
ACTCCCGAGGA -> CTCCCGAGGAA
ACTCCCTAGGC -> CTCCCTAGGCA
ACTCCGAGGTG -> CTCCGAGGTGG
ACTCCTACAGT -> CTCCTACAGTG
ACTCCTCATCT -> CTCCTCATCTC
ACTCGTTGTCG -> CTCGTTGTCGG
ACTCTAAGAAG -> CTCTAAGAAGT
ACTCTGCGAAG -> CTCTGCGAAGT
ACTCTTGCGGT -> CTCTTGCGGTA
ACTCTTTTCGG -> CTCTTTTCGGG
ACTGACGCCGA -> CTGACGCCGAT
ACTGCATGGTG -> CTGCATGGTGC
ACTGCGACCCC -> CTGCGACCCCA
ACTGCGACCGC -> CTGCGACCGCG
ACTGTATCAGT -> CTGTATCAGTC
ACTTAAATTCA -> CTTAAATTCAT
ACTTCCGACGC -> CTTCCGACGCC
ACTTCGACACA -> CTTCGACACAT
ACTTCGTTGTT -> CTTCGTTGTTA
ACTTGAGGACG -> CTTGAGGACGA
ACTTTCACTCG -> CTTTCACTCGT
ACTTTTAAAGC -> CTTTTAAAGCA
AGAAATAGTGC -> GAAATAGTGCC
AGAACTACCGT -> GAACTACCGTA
AGAACTGTATC -> GAACTGTATCA
AGAAGGCTTGG -> GAAGGCTTGGT
AGAAGTACATG -> GAAGTACATGC
AGAATACCAGG -> GAATACCAGGC
AGAATCAGTAC -> GAATCAGTACA
AGAATCGAAAA -> GAATCGAAAAG
AGAATTGCCCG -> GAATTGCCCGT
AGACAAACAAT -> GACAAACAATT
AGACCTCGAAC -> GACCTCGAACC
AGACGAACTCT -> GACGAACTCTA
AGACGAATGGC -> GACGAATGGCA
AGACGAGTTAC -> GACGAGTTACC
AGACGGATATT -> GACGGATATTC
AGACGTACATT -> GACGTACATTG
AGACTACCATT -> GACTACCATTC
AGAGAGCATGC -> GAGAGCATGCA
AGAGAGCGCAT -> GAGAGCGCATG
AGAGCAGACGG -> GAGCAGACGGA
AGAGCATGCAG -> GAGCATGCAGC
AGAGCGCATGC -> GAGCGCATGCT
AGAGTGGGACG -> GAGTGGGACGG
AGAGTGGTTCG -> GAGTGGTTCGA
AGAGTTGCCGC -> GAGTTGCCGCA
AGATATTAGTC -> GATATTAGTCC
AGATCAGAATA -> GATCAGAATAC
AGATGAGATGT -> GATGAGATGTG
AGATGTGGCAC -> GATGTGGCACA
AGATTATGTGC -> GATTATGTGCT
AGATTCCATCG -> GATTCCATCGT
AGATTCGAACT -> GATTCGAACTG
AGCAAGGCCGC -> GCAAGGCCGCA
AGCAATCCGCA -> GCAATCCGCAC
AGCACCCATAC -> GCACCCATACA
AGCAGACGGAT -> GCAGACGGATA
AGCAGGTAGGC -> GCAGGTAGGCT
AGCAGTTTTGG -> GCAGTTTTGGA
AGCATGATATC -> GCATGATATCT
AGCATGCAGCA -> GCATGCAGCAG
AGCCAAGTGTT -> GCCAAGTGTTG
AGCCATTCTGA -> GCCATTCTGAC
AGCCGGAGTAC -> GCCGGAGTACG
AGCCTAAGCCT -> GCCTAAGCCTC
AGCCTCACTTC -> GCCTCACTTCG
AGCCTCGGGTA -> GCCTCGGGTAA
AGCGACCTTTG -> GCGACCTTTGA
AGCGACGGGCA -> GCGACGGGCAT
AGCGCATGCTC -> GCGCATGCTCT
AGCGCGAGCAA -> GCGCGAGCAAT
AGCGCGCAAGT -> GCGCGCAAGTT
AGCGGTAGACG -> GCGGTAGACGA
AGCGGTTAAAT -> GCGGTTAAATT
AGCGTCACATC -> GCGTCACATCC
AGCGTTTCCGT -> GCGTTTCCGTG
AGCTAAGTACG -> GCTAAGTACGC
AGCTCGAACCC -> GCTCGAACCCC
AGCTCTCGGTC -> GCTCTCGGTCG
AGCTGTGGATT -> GCTGTGGATTG
AGGAAAAAGGG -> GGAAAAAGGGT
AGGACCGAACA -> GGACCGAACAG
AGGACGAAAGG -> GGACGAAAGGG
AGGACGATTGT -> GGACGATTGTG
AGGACTACTAG -> GGACTACTAGC
AGGAGCGACCT -> GGAGCGACCTT
AGGAGTTTTTT -> GGAGTTTTTTC
AGGATAGAGTG -> GGATAGAGTGG
AGGCAAGCTGT -> GGCAAGCTGTG
AGGCAATGACC -> GGCAATGACCA
AGGCAGGTTCG -> GGCAGGTTCGC
AGGCCCCCCGA -> GGCCCCCCGAT
AGGCCGAATGT -> GGCCGAATGTT
AGGCCGCAAGG -> GGCCGCAAGGC
AGGCGACGGCG -> GGCGACGGCGA
AGGCGCAGAAT -> GGCGCAGAATT
AGGCGCCAGAC -> GGCGCCAGACG
AGGCGGAGAGT -> GGCGGAGAGTG
AGGCGGCTGGT -> GGCGGCTGGTT
AGGCGGTTCAG -> GGCGGTTCAGA
AGGCGTAACTA -> GGCGTAACTAA
AGGCGTACTCC -> GGCGTACTCCG
AGGCGTCTGGA -> GGCGTCTGGAG
AGGCTGTGCGT -> GGCTGTGCGTT
AGGCTTCAGCG -> GGCTTCAGCGG
AGGCTTGGTTG -> GGCTTGGTTGG
AGGGACAGCGT -> GGGACAGCGTC
AGGGCTCTGCC -> GGGCTCTGCCA
AGGGCTTACTC -> GGGCTTACTCT
AGGGGAGGCGG -> GGGGAGGCGGA
AGGGGGGCTCC -> GGGGGGCTCCG
AGGGGTAGTTG -> GGGGTAGTTGG
AGGGTGTATGT -> GGGTGTATGTA
AGGTAGGCTGT -> GGTAGGCTGTG
AGGTGGTATTA -> GGTGGTATTAT
AGGTGTGGCTC -> GGTGTGGCTCA
AGGTTCGCCAG -> GGTTCGCCAGG
AGTAATCCGGG -> GTAATCCGGGA
AGTACAATAGC -> GTACAATAGCA
AGTACATGCAA -> GTACATGCAAT
AGTACCAGTGT -> GTACCAGTGTA
AGTACCGTCGG -> GTACCGTCGGG
AGTACGCGCAG -> GTACGCGCAGG
AGTACGTTGCT -> GTACGTTGCTA
AGTAGAATCAG -> GTAGAATCAGT
AGTAGGAGCGA -> GTAGGAGCGAC
AGTATATTATG -> GTATATTATGA
AGTATGGAAAC -> GTATGGAAACG
AGTATTCGTGA -> GTATTCGTGAC
AGTCCGGGAGG -> GTCCGGGAGGG
AGTCCTCAAAG -> GTCCTCAAAGC
AGTCCTTTGCG -> GTCCTTTGCGC
AGTCGTAAGTT -> GTCGTAAGTTG
AGTCGTCAGTA -> GTCGTCAGTAG
AGTCTCGGTAC -> GTCTCGGTACT
AGTCTGCATTG -> GTCTGCATTGC
AGTGATGTTGA -> GTGATGTTGAA
AGTGCCTTCAA -> GTGCCTTCAAA
AGTGCTACACT -> GTGCTACACTA
AGTGGAAGGAT -> GTGGAAGGATA
AGTGGAGATGA -> GTGGAGATGAG
AGTGGGACGGA -> GTGGGACGGAC
AGTGGTTCGAC -> GTGGTTCGACG
AGTGTACCCCA -> GTGTACCCCAC
AGTGTGTTAAT -> GTGTGTTAATC
AGTGTTGATTA -> GTGTTGATTAC
AGTTAAGAATC -> GTTAAGAATCG
AGTTACCTTAA -> GTTACCTTAAA
AGTTGACTACG -> GTTGACTACGG
AGTTGCCGCAC -> GTTGCCGCACA
AGTTGGGTCGG -> GTTGGGTCGGG
AGTTGGGTGTA -> GTTGGGTGTAG
AGTTGTGCACT -> GTTGTGCACTC
AGTTTCAGTGC -> GTTTCAGTGCT
AGTTTTGGAAC -> GTTTTGGAACA
AGTTTTTTCAC -> GTTTTTTCACT
ATAAAAGTCTC -> TAAAAGTCTCG
ATAAAGTACCG -> TAAAGTACCGT
ATAACCGGACA -> TAACCGGACAC
ATAAGTAATCC -> TAAGTAATCCG
ATAAGTAGGAG -> TAAGTAGGAGC
ATACACTCATT -> TACACTCATTT
ATACATGCTTG -> TACATGCTTGC
ATACATGTGCT -> TACATGTGCTT
ATACCAACCTG -> TACCAACCTGG
ATACCAGGCGC -> TACCAGGCGCA
ATACCGTTATG -> TACCGTTATGG
ATAGAGTGGTT -> TAGAGTGGTTC
ATAGCAAGGCC -> TAGCAAGGCCG
ATAGGCCGAAT -> TAGGCCGAATG
ATAGGGCTCTG -> TAGGGCTCTGC
ATAGTGCCTTC -> TAGTGCCTTCA
ATAGTTGGGTG -> TAGTTGGGTGT
ATATCAATAGG -> TATCAATAGGG
ATATCGCTCCC -> TATCGCTCCCC
ATATCTTGCAT -> TATCTTGCATT
ATATGCCTACA -> TATGCCTACAA
ATATTAGTCCG -> TATTAGTCCGG
ATATTATGATG -> TATTATGATGC
ATATTCATCAT -> TATTCATCATA
ATCAATAGGGC -> TCAATAGGGCT
ATCACCGGTAA -> TCACCGGTAAG
ATCAGAATACC -> TCAGAATACCA
ATCAGTACAAT -> TCAGTACAATA
ATCAGTCGTCA -> TCAGTCGTCAG
ATCATACCAAC -> TCATACCAACC
ATCATGGTTGC -> TCATGGTTGCT
ATCCAGACAAA -> TCCAGACAAAC
ATCCCAGTATT -> TCCCAGTATTC
ATCCGCACATT -> TCCGCACATTC
ATCCGGGATGT -> TCCGGGATGTT
ATCCGTCGAAT -> TCCGTCGAATG
ATCCGTTCGTA -> TCCGTTCGTAC
ATCGAAAAGTA -> TCGAAAAGTAT
ATCGAGAGAGC -> TCGAGAGAGCA
ATCGCACTCCC -> TCGCACTCCCT
ATCGCATTCCC -> TCGCATTCCCG
ATCGCTCCCCA -> TCGCTCCCCAA
ATCGGGAACGG -> TCGGGAACGGG
ATCGTATCTAG -> TCGTATCTAGA
ATCGTATGAAG -> TCGTATGAAGT
ATCTAGACTAC -> TCTAGACTACC
ATCTCGGCGCG -> TCTCGGCGCGG
ATCTGTCATCC -> TCTGTCATCCG
ATCTTCTCTGC -> TCTTCTCTGCG
ATCTTGCAGGG -> TCTTGCAGGGC
ATCTTGCATTT -> TCTTGCATTTG
ATGAAGTCCTT -> TGAAGTCCTTT
ATGACCAGTAC -> TGACCAGTACG
ATGACTTTCAC -> TGACTTTCACT
ATGAGATGTGG -> TGAGATGTGGC
ATGAGCCAAGT -> TGAGCCAAGTG
ATGAGCCATTC -> TGAGCCATTCT
ATGATATCTTG -> TGATATCTTGC
ATGATGCAACT -> TGATGCAACTC
ATGCAACTCCC -> TGCAACTCCCG
ATGCAATAAAG -> TGCAATAAAGT
ATGCAGCAGGT -> TGCAGCAGGTA
ATGCCCCAAAA -> TGCCCCAAAAG
ATGCCGTGGGA -> TGCCGTGGGAA
ATGCCTACAAA -> TGCCTACAAAG
ATGCGTTAGCG -> TGCGTTAGCGG
ATGCTCTGACG -> TGCTCTGACGC
ATGCTTGCATG -> TGCTTGCATGT
ATGGAAACGTG -> TGGAAACGTGG
ATGGAAGTTAA -> TGGAAGTTAAG
ATGGCAACCGT -> TGGCAACCGTC
ATGGCCGGCGT -> TGGCCGGCGTC
ATGGGTCGACT -> TGGGTCGACTT
ATGGTGCGGCA -> TGGTGCGGCAG
ATGGTTGCTTT -> TGGTTGCTTTC
ATGTAATGCCG -> TGTAATGCCGT
ATGTAGTGGAA -> TGTAGTGGAAG
ATGTCAGGGGG -> TGTCAGGGGGG
ATGTCTGCTTA -> TGTCTGCTTAT
ATGTGCTGAAG -> TGTGCTGAAGA
ATGTGCTTAGC -> TGTGCTTAGCA
ATGTGGCACAT -> TGTGGCACATC
ATGTTAGCGTT -> TGTTAGCGTTT
ATGTTATTCCA -> TGTTATTCCAC
ATGTTGAAGAG -> TGTTGAAGAGT
ATTACGCAGCT -> TTACGCAGCTC
ATTACTACCAA -> TTACTACCAAG
ATTAGTCCGGG -> TTAGTCCGGGA
ATTATCGCACT -> TTATCGCACTC
ATTATCGTATG -> TTATCGTATGA
ATTATGATGCA -> TTATGATGCAA
ATTATGTGCTG -> TTATGTGCTGA
ATTCATAAAAG -> TTCATAAAAGT
ATTCATCATAC -> TTCATCATACC
ATTCCACATCG -> TTCCACATCGC
ATTCCATCGTA -> TTCCATCGTAT
ATTCCCGTTAC -> TTCCCGTTACA
ATTCGAACTGC -> TTCGAACTGCG
ATTCGTGACTA -> TTCGTGACTAT
ATTCTCTCTGG -> TTCTCTCTGGC
ATTCTGACGAC -> TTCTGACGACT
ATTCTTGATGT -> TTCTTGATGTC
ATTGACCTCGA -> TTGACCTCGAT
ATTGAGGCTTC -> TTGAGGCTTCA
ATTGATACATG -> TTGATACATGT
ATTGCAAGCAC -> TTGCAAGCACC
ATTGCCCGTGG -> TTGCCCGTGGG
ATTGCCGGATA -> TTGCCGGATAT
ATTGCTCAGGA -> TTGCTCAGGAC
ATTGGACCAAT -> TTGGACCAATA
ATTGGCTACGT -> TTGGCTACGTC
ATTGGCTGCTC -> TTGGCTGCTCC
ATTGGGTTGTT -> TTGGGTTGTTG
ATTGTGCACGA -> TTGTGCACGAC
ATTGTTGACGC -> TTGTTGACGCC
ATTTAGATTCG -> TTTAGATTCGA
ATTTCCTTCCC -> TTTCCTTCCCG
ATTTGACGAGG -> TTTGACGAGGC
ATTTGTCGCCA -> TTTGTCGCCAG
ATTTTCCTATC -> TTTTCCTATCG
CAAAAATCACC -> AAAAATCACCG
CAAAAGGTGTG -> AAAAGGTGTGG
CAAACAATTAC -> AAACAATTACG
CAAAGAAGGCT -> AAAGAAGGCTT
CAAAGCCTAAG -> AAAGCCTAAGC
CAAAGTCGTAA -> AAAGTCGTAAG
CAACCGTCTGT -> AACCGTCTGTG
CAACCTGGCAT -> AACCTGGCATG
CAACGTAGTAT -> AACGTAGTATA
CAACTCCCGAG -> AACTCCCGAGG
CAAGATATTAG -> AAGATATTAGT
CAAGCACCCAT -> AAGCACCCATA
CAAGCTGTGGA -> AAGCTGTGGAT
CAAGGCCGCAA -> AAGGCCGCAAG
CAAGGCGACGG -> AAGGCGACGGC
CAAGTGTTGAT -> AAGTGTTGATT
CAAGTTGACTA -> AAGTTGACTAC
CAATAAAGTAC -> AATAAAGTACC
CAATAGCAAGG -> AATAGCAAGGC
CAATAGGCCGA -> AATAGGCCGAA
CAATAGGGCTC -> AATAGGGCTCT
CAATCCGCACA -> AATCCGCACAT
CAATCTTCTCT -> AATCTTCTCTG
CAATCTTGCAG -> AATCTTGCAGG
CAATGACCAGT -> AATGACCAGTA
CAATTACGCAG -> AATTACGCAGC
CACAGCTAAGT -> ACAGCTAAGTA
CACATCCCAGT -> ACATCCCAGTA
CACATCCGTCG -> ACATCCGTCGA
CACATCGCATT -> ACATCGCATTC
CACATGTAATG -> ACATGTAATGC
CACATTCTTGA -> ACATTCTTGAT
CACCCATACAT -> ACCCATACATG
CACCGGTAAGC -> ACCGGTAAGCT
CACCTTGTCTT -> ACCTTGTCTTA
CACGACAATCT -> ACGACAATCTT
CACGACTCATT -> ACGACTCATTG
CACTATTGACC -> ACTATTGACCT
CACTCATTTTC -> ACTCATTTTCC
CACTCCCTAGG -> ACTCCCTAGGC
CACTCGTTGTC -> ACTCGTTGTCG
CACTCTGCGAA -> ACTCTGCGAAG
CACTGCATGGT -> ACTGCATGGTG
CACTTCGACAC -> ACTTCGACACA
CAGAACTGTAT -> AGAACTGTATC
CAGAATACCAG -> AGAATACCAGG
CAGAATTGCCC -> AGAATTGCCCG
CAGACAAACAA -> AGACAAACAAT
CAGACCTCGAA -> AGACCTCGAAC
CAGACGAACTC -> AGACGAACTCT
CAGACGGATAT -> AGACGGATATT
CAGATCAGAAT -> AGATCAGAATA
CAGATTCCATC -> AGATTCCATCG
CAGCAGGTAGG -> AGCAGGTAGGC
CAGCCTCGGGT -> AGCCTCGGGTA
CAGCGCGAGCA -> AGCGCGAGCAA
CAGCGCGCAAG -> AGCGCGCAAGT
CAGCGGTAGAC -> AGCGGTAGACG
CAGCGTCACAT -> AGCGTCACATC
CAGCTAAGTAC -> AGCTAAGTACG
CAGCTCGAACC -> AGCTCGAACCC
CAGGACCGAAC -> AGGACCGAACA
CAGGACTACTA -> AGGACTACTAG
CAGGAGTTTTT -> AGGAGTTTTTT
CAGGCAGGTTC -> AGGCAGGTTCG
CAGGCGCAGAA -> AGGCGCAGAAT
CAGGCGCCAGA -> AGGCGCCAGAC
CAGGCGGCTGG -> AGGCGGCTGGT
CAGGCGTAACT -> AGGCGTAACTA
CAGGGCTTACT -> AGGGCTTACTC
CAGGGGGGCTC -> AGGGGGGCTCC
CAGGTAGGCTG -> AGGTAGGCTGT
CAGGTTCGCCA -> AGGTTCGCCAG
CAGTACAATAG -> AGTACAATAGC
CAGTACGTTGC -> AGTACGTTGCT
CAGTAGAATCA -> AGTAGAATCAG
CAGTATTCGTG -> AGTATTCGTGA
CAGTCCTCAAA -> AGTCCTCAAAG
CAGTCGTCAGT -> AGTCGTCAGTA
CAGTGCTACAC -> AGTGCTACACT
CAGTGTACCCC -> AGTGTACCCCA
CAGTGTGTTAA -> AGTGTGTTAAT
CAGTTTCAGTG -> AGTTTCAGTGC
CAGTTTTGGAA -> AGTTTTGGAAC
CATAAAAGTCT -> ATAAAAGTCTC
CATAACCGGAC -> ATAACCGGACA
CATACACTCAT -> ATACACTCATT
CATACATGCTT -> ATACATGCTTG
CATACCAACCT -> ATACCAACCTG
CATACCGTTAT -> ATACCGTTATG
CATAGTTGGGT -> ATAGTTGGGTG
CATCATACCAA -> ATCATACCAAC
CATCATGGTTG -> ATCATGGTTGC
CATCCCAGTAT -> ATCCCAGTATT
CATCCGTCGAA -> ATCCGTCGAAT
CATCCGTTCGT -> ATCCGTTCGTA
CATCGCATTCC -> ATCGCATTCCC
CATCGTATCTA -> ATCGTATCTAG
CATCTCGGCGC -> ATCTCGGCGCG
CATGACTTTCA -> ATGACTTTCAC
CATGAGCCAAG -> ATGAGCCAAGT
CATGATATCTT -> ATGATATCTTG
CATGCAATAAA -> ATGCAATAAAG
CATGCAGCAGG -> ATGCAGCAGGT
CATGCGTTAGC -> ATGCGTTAGCG
CATGCTCTGAC -> ATGCTCTGACG
CATGCTTGCAT -> ATGCTTGCATG
CATGGAAGTTA -> ATGGAAGTTAA
CATGGTGCGGC -> ATGGTGCGGCA
CATGGTTGCTT -> ATGGTTGCTTT
CATGTAATGCC -> ATGTAATGCCG
CATGTCTGCTT -> ATGTCTGCTTA
CATGTGCTTAG -> ATGTGCTTAGC
CATTCCCGTTA -> ATTCCCGTTAC
CATTCTCTCTG -> ATTCTCTCTGG
CATTCTGACGA -> ATTCTGACGAC
CATTCTTGATG -> ATTCTTGATGT
CATTGATACAT -> ATTGATACATG
CATTGCTCAGG -> ATTGCTCAGGA
CATTGGACCAA -> ATTGGACCAAT
CATTGGGTTGT -> ATTGGGTTGTT
CATTTAGATTC -> ATTTAGATTCG
CATTTGTCGCC -> ATTTGTCGCCA
CATTTTCCTAT -> ATTTTCCTATC
CCAAAAGGTGT -> CAAAAGGTGTG
CCAACCTGGCA -> CAACCTGGCAT
CCAACGTAGTA -> CAACGTAGTAT
CCAAGATATTA -> CAAGATATTAG
CCAAGTGTTGA -> CAAGTGTTGAT
CCAATAGGCCG -> CAATAGGCCGA
CCAATCTTCTC -> CAATCTTCTCT
CCACATCGCAT -> CACATCGCATT
CCACCTTGTCT -> CACCTTGTCTT
CCAGAACTGTA -> CAGAACTGTAT
CCAGACAAACA -> CAGACAAACAA
CCAGACCTCGA -> CAGACCTCGAA
CCAGACGAACT -> CAGACGAACTC
CCAGCCTCGGG -> CAGCCTCGGGT
CCAGCGCGCAA -> CAGCGCGCAAG
CCAGGACCGAA -> CAGGACCGAAC
CCAGGCAGGTT -> CAGGCAGGTTC
CCAGGCGCAGA -> CAGGCGCAGAA
CCAGTACGTTG -> CAGTACGTTGC
CCAGTATTCGT -> CAGTATTCGTG
CCAGTGTACCC -> CAGTGTACCCC
CCATACATGCT -> CATACATGCTT
CCATCGTATCT -> CATCGTATCTA
CCATGAGCCAA -> CATGAGCCAAG
CCATGCGTTAG -> CATGCGTTAGC
CCATTCTCTCT -> CATTCTCTCTG
CCATTCTGACG -> CATTCTGACGA
CCATTGATACA -> CATTGATACAT
CCATTTAGATT -> CATTTAGATTC
CCCAAAAGGTG -> CCAAAAGGTGT
CCCAACGTAGT -> CCAACGTAGTA
CCCAATCTTCT -> CCAATCTTCTC
CCCACCTTGTC -> CCACCTTGTCT
CCCAGGCAGGT -> CCAGGCAGGTT
CCCAGTATTCG -> CCAGTATTCGT
CCCATACATGC -> CCATACATGCT
CCCATGAGCCA -> CCATGAGCCAA
CCCCAAAAGGT -> CCCAAAAGGTG
CCCCAACGTAG -> CCCAACGTAGT
CCCCAATCTTC -> CCCAATCTTCT
CCCCACCTTGT -> CCCACCTTGTC
CCCCAGGCAGG -> CCCAGGCAGGT
CCCCATGAGCC -> CCCATGAGCCA
CCCCCCGATCC -> CCCCCGATCCA
CCCCCGATCCA -> CCCCGATCCAG
CCCCGATCCAG -> CCCGATCCAGA
CCCGAGGAAAA -> CCGAGGAAAAA
CCCGATCCAGA -> CCGATCCAGAC
CCCGCATAACC -> CCGCATAACCG
CCCGTGGGTCA -> CCGTGGGTCAT
CCCGTTACATG -> CCGTTACATGG
CCCTAGGCAAG -> CCTAGGCAAGC
CCGAACAGTCC -> CGAACAGTCCT
CCGAATGTTAT -> CGAATGTTATT
CCGACCAGCGC -> CGACCAGCGCG
CCGACGCCTAT -> CGACGCCTATA
CCGAGGAAAAA -> CGAGGAAAAAG
CCGAGGTGGTA -> CGAGGTGGTAT
CCGATCCAGAC -> CGATCCAGACA
CCGATGGCCGG -> CGATGGCCGGC
CCGATTTGACG -> CGATTTGACGA
CCGCAAGGCGA -> CGCAAGGCGAC
CCGCACAGCTA -> CGCACAGCTAA
CCGCACATTCT -> CGCACATTCTT
CCGCATAACCG -> CGCATAACCGG
CCGCGACATAC -> CGCGACATACA
CCGGACACGAC -> CGGACACGACA
CCGGATATCGC -> CGGATATCGCT
CCGGCCAGCCT -> CGGCCAGCCTC
CCGGCGTCAGT -> CGGCGTCAGTT
CCGGGAGGGAC -> CGGGAGGGACA
CCGGGATGTTA -> CGGGATGTTAG
CCGGTAAGCTC -> CGGTAAGCTCT
CCGTAGCGACG -> CGTAGCGACGG
CCGTAGTCTGC -> CGTAGTCTGCA
CCGTCGAAATC -> CGTCGAAATCG
CCGTCGAATGC -> CGTCGAATGCC
CCGTCGGGAAC -> CGTCGGGAACT
CCGTCTGTGCG -> CGTCTGTGCGT
CCGTGACTTTT -> CGTGACTTTTA
CCGTGGGAACC -> CGTGGGAACCG
CCGTGGGTCAT -> CGTGGGTCATA
CCGTTACATGG -> CGTTACATGGA
CCGTTACTATT -> CGTTACTATTG
CCGTTATGGGT -> CGTTATGGGTC
CCGTTCGTACC -> CGTTCGTACCT
CCTAAGCCTCA -> CTAAGCCTCAC
CCTACAAAGTC -> CTACAAAGTCG
CCTACAGTGTG -> CTACAGTGTGT
CCTAGGCAAGC -> CTAGGCAAGCT
CCTATATGCCT -> CTATATGCCTA
CCTATCGGGAA -> CTATCGGGAAC
CCTCAAAGCCT -> CTCAAAGCCTA
CCTCACTTCGA -> CTCACTTCGAC
CCTCATCTCGG -> CTCATCTCGGC
CCTCGAACCCC -> CTCGAACCCCA
CCTCGATTGGC -> CTCGATTGGCT
CCTCGGGTAAA -> CTCGGGTAAAA
CCTCTGAAACT -> CTCTGAAACTC
CCTGGCATGAC -> CTGGCATGACT
CCTTAAAGGCC -> CTTAAAGGCCC
CCTTCAAAAAT -> CTTCAAAAATC
CCTTCCCGCAT -> CTTCCCGCATA
CCTTGTCTTAC -> CTTGTCTTACG
CCTTTGAGAGC -> CTTTGAGAGCA
CCTTTGCGCGC -> CTTTGCGCGCA
CGAAAAGTATG -> GAAAAGTATGG
CGAAAGGGGAG -> GAAAGGGGAGG
CGAAATCGAGA -> GAAATCGAGAG
CGAACAGTCCT -> GAACAGTCCTC
CGAACCCCAAC -> GAACCCCAACG
CGAACCCCAGG -> GAACCCCAGGC
CGAACCGTCGA -> GAACCGTCGAA
CGAACTCTAAG -> GAACTCTAAGA
CGAACTGCGAC -> GAACTGCGACC
CGAAGTACCAG -> GAAGTACCAGT
CGAATGCCCCA -> GAATGCCCCAA
CGAATGGCAAC -> GAATGGCAACC
CGAATGTTATT -> GAATGTTATTC
CGACAATCTTG -> GACAATCTTGC
CGACACATGTA -> GACACATGTAA
CGACATACACT -> GACATACACTC
CGACCAGCGCG -> GACCAGCGCGC
CGACCCCATGA -> GACCCCATGAG
CGACCGCGACA -> GACCGCGACAT
CGACCTTTGAG -> GACCTTTGAGA
CGACGCCTATA -> GACGCCTATAT
CGACGGCGAAC -> GACGGCGAACC
CGACGGGCATC -> GACGGGCATCA
CGACGTAAGAC -> GACGTAAGACG
CGACTCATTGG -> GACTCATTGGG
CGACTTAAATT -> GACTTAAATTC
CGACTTCGTTG -> GACTTCGTTGT
CGAGAGAGCAT -> GAGAGAGCATG
CGAGCAATCCG -> GAGCAATCCGC
CGAGGAAAAAG -> GAGGAAAAAGG
CGAGGCGGTTC -> GAGGCGGTTCA
CGAGGTGGTAT -> GAGGTGGTATT
CGAGTTACCTT -> GAGTTACCTTA
CGATAAGTAAT -> GATAAGTAATC
CGATCCAGACA -> GATCCAGACAA
CGATGGCCGGC -> GATGGCCGGCG
CGATTGGCTGC -> GATTGGCTGCT
CGATTGTGCAC -> GATTGTGCACG
CGATTTGACGA -> GATTTGACGAG
CGCAAGGCGAC -> GCAAGGCGACG
CGCAAGTTGAC -> GCAAGTTGACT
CGCACAGCTAA -> GCACAGCTAAG
CGCACATTCTT -> GCACATTCTTG
CGCACTCCCTA -> GCACTCCCTAG
CGCAGAATTGC -> GCAGAATTGCC
CGCAGCGCGAG -> GCAGCGCGAGC
CGCAGCTCGAA -> GCAGCTCGAAC
CGCAGGCGGCT -> GCAGGCGGCTG
CGCATAACCGG -> GCATAACCGGA
CGCATGCTCTG -> GCATGCTCTGA
CGCATTCCCGT -> GCATTCCCGTT
CGCCAGAACTG -> GCCAGAACTGT
CGCCAGACGAA -> GCCAGACGAAC
CGCCAGGACCG -> GCCAGGACCGA
CGCCATTTAGA -> GCCATTTAGAT
CGCCGACCAGC -> GCCGACCAGCG
CGCCGATGGCC -> GCCGATGGCCG
CGCCTATATGC -> GCCTATATGCC
CGCGACATACA -> GCGACATACAC
CGCGAGCAATC -> GCGAGCAATCC
CGCGCAAGTTG -> GCGCAAGTTGA
CGCGCAGCGCG -> GCGCAGCGCGA
CGCGCAGGCGG -> GCGCAGGCGGC
CGCGGAGATTA -> GCGGAGATTAT
CGCTCCCCAAT -> GCTCCCCAATC
CGGACACGACA -> GGACACGACAA
CGGACTGCGAC -> GGACTGCGACC
CGGAGAGTGGG -> GGAGAGTGGGA
CGGAGATTATG -> GGAGATTATGT
CGGAGGCAATG -> GGAGGCAATGA
CGGATATCGCT -> GGATATCGCTC
CGGATATTCAT -> GGATATTCATC
CGGCAGGCGTA -> GGCAGGCGTAA
CGGCCAGCCTC -> GGCCAGCCTCG
CGGCGAACCGT -> GGCGAACCGTC
CGGCGCGGAGA -> GGCGCGGAGAT
CGGCGTCAGTT -> GGCGTCAGTTT
CGGCTGGTTAG -> GGCTGGTTAGA
CGGCTGTATTG -> GGCTGTATTGT
CGGGAACGGGT -> GGGAACGGGTA
CGGGAACTTGA -> GGGAACTTGAG
CGGGAGAGAGC -> GGGAGAGAGCG
CGGGAGGGACA -> GGGAGGGACAG
CGGGATGTTAG -> GGGATGTTAGC
CGGGCATCATG -> GGGCATCATGG
CGGGGGTTAGT -> GGGGGTTAGTG
CGGGTAAAAAA -> GGGTAAAAAAC
CGGGTACCAGA -> GGGTACCAGAC
CGGTAAGCTCT -> GGTAAGCTCTC
CGGTACTACTT -> GGTACTACTTC
CGGTACTCCTC -> GGTACTCCTCA
CGGTAGACGAA -> GGTAGACGAAT
CGGTATGAGCC -> GGTATGAGCCA
CGGTCGGTACT -> GGTCGGTACTC
CGGTTAAATTG -> GGTTAAATTGG
CGGTTCAAAGA -> GGTTCAAAGAA
CGGTTCAGATC -> GGTTCAGATCA
CGTAACTAACT -> GTAACTAACTC
CGTAAGACGAG -> GTAAGACGAGT
CGTAAGTTGTG -> GTAAGTTGTGC
CGTACATTGGA -> GTACATTGGAC
CGTACCTCTGA -> GTACCTCTGAA
CGTACTCCGAG -> GTACTCCGAGG
CGTAGCGACGG -> GTAGCGACGGG
CGTAGTATATT -> GTAGTATATTA
CGTAGTCTGCA -> GTAGTCTGCAT
CGTATCTAGAC -> GTATCTAGACT
CGTATGAAGTC -> GTATGAAGTCC
CGTATTGCAAG -> GTATTGCAAGC
CGTCACATCCG -> GTCACATCCGT
CGTCAGTAGAA -> GTCAGTAGAAT
CGTCAGTTTCA -> GTCAGTTTCAG
CGTCGAAATCG -> GTCGAAATCGA
CGTCGAATGCC -> GTCGAATGCCC
CGTCGGGAACT -> GTCGGGAACTT
CGTCGTGATTA -> GTCGTGATTAT
CGTCTACAGGA -> GTCTACAGGAG
CGTCTGGAGGG -> GTCTGGAGGGG
CGTCTGTGCGT -> GTCTGTGCGTC
CGTGACTATAT -> GTGACTATATC
CGTGACTTTTA -> GTGACTTTTAA
CGTGATTATCG -> GTGATTATCGC
CGTGGAGGCGT -> GTGGAGGCGTC
CGTGGGAACCG -> GTGGGAACCGT
CGTGGGTCATA -> GTGGGTCATAC
CGTTACATGGA -> GTTACATGGAA
CGTTACTATTG -> GTTACTATTGC
CGTTAGCGGTT -> GTTAGCGGTTA
CGTTATGGGTC -> GTTATGGGTCG
CGTTCGTACCT -> GTTCGTACCTC
CGTTCTAGGCG -> GTTCTAGGCGT
CGTTGCTACTG -> GTTGCTACTGA
CGTTGTCGGCT -> GTTGTCGGCTG
CGTTGTTAGTG -> GTTGTTAGTGA
CGTTTCCGTGA -> GTTTCCGTGAC
CTAACTCCTAC -> TAACTCCTACA
CTAAGAAGTAC -> TAAGAAGTACA
CTAAGCCTCAC -> TAAGCCTCACT
CTAAGGACGAA -> TAAGGACGAAA
CTAAGTACGCG -> TAAGTACGCGC
CTACAAAGTCG -> TACAAAGTCGT
CTACACTATTG -> TACACTATTGA
CTACAGGAGTT -> TACAGGAGTTT
CTACAGTGTGT -> TACAGTGTGTT
CTACCAAGATA -> TACCAAGATAT
CTACCATTCTC -> TACCATTCTCT
CTACCGTAGTC -> TACCGTAGTCT
CTACGGTTCAA -> TACGGTTCAAA
CTACGTCGTGA -> TACGTCGTGAT
CTACTAGCCGG -> TACTAGCCGGA
CTACTGACGCC -> TACTGACGCCG
CTACTTCCGAC -> TACTTCCGACG
CTAGACTACCA -> TAGACTACCAT
CTAGCCGGAGT -> TAGCCGGAGTA
CTAGGCAAGCT -> TAGGCAAGCTG
CTAGGCGTACT -> TAGGCGTACTC
CTATATCAATA -> TATATCAATAG
CTATATGCCTA -> TATATGCCTAC
CTATCGGGAAC -> TATCGGGAACG
CTATTGACCTC -> TATTGACCTCG
CTATTGCCGGA -> TATTGCCGGAT
CTCAAAGCCTA -> TCAAAGCCTAA
CTCACTTCGAC -> TCACTTCGACA
CTCAGGACTAC -> TCAGGACTACT
CTCATAGTTGG -> TCATAGTTGGG
CTCATCTCGGC -> TCATCTCGGCG
CTCATTGGGTT -> TCATTGGGTTG
CTCATTTTCCT -> TCATTTTCCTA
CTCCCCAATCT -> TCCCCAATCTT
CTCCCGAGGAA -> TCCCGAGGAAA
CTCCCTAGGCA -> TCCCTAGGCAA
CTCCGAGGTGG -> TCCGAGGTGGT
CTCCGGCCAGC -> TCCGGCCAGCC
CTCCGTAGCGA -> TCCGTAGCGAC
CTCCTACAGTG -> TCCTACAGTGT
CTCCTCATCTC -> TCCTCATCTCG
CTCGAACCCCA -> TCGAACCCCAA,TCGAACCCCAG
CTCGATTGGCT -> TCGATTGGCTG
CTCGGCGCGGA -> TCGGCGCGGAG
CTCGGGTAAAA -> TCGGGTAAAAA
CTCGGTACTAC -> TCGGTACTACT
CTCGGTCGGTA -> TCGGTCGGTAC
CTCGTTGTCGG -> TCGTTGTCGGC
CTCTAAGAAGT -> TCTAAGAAGTA
CTCTCGGTCGG -> TCTCGGTCGGT
CTCTCTGGCAG -> TCTCTGGCAGG
CTCTGAAACTC -> TCTGAAACTCT
CTCTGACGCCG -> TCTGACGCCGA
CTCTGCCATTG -> TCTGCCATTGA
CTCTGCGAAGT -> TCTGCGAAGTA
CTCTGCGATAA -> TCTGCGATAAG
CTCTGGCAGGC -> TCTGGCAGGCG
CTCTTGCGGTA -> TCTTGCGGTAT
CTCTTTTCGGG -> TCTTTTCGGGG
CTGAAACTCTT -> TGAAACTCTTT
CTGAAGAACTA -> TGAAGAACTAC
CTGACGACTTC -> TGACGACTTCG
CTGACGCCGAC -> TGACGCCGACC
CTGACGCCGAT -> TGACGCCGATG
CTGCATGGTGC -> TGCATGGTGCG
CTGCATTGCTC -> TGCATTGCTCA
CTGCCATTGAT -> TGCCATTGATA
CTGCGAAGTAC -> TGCGAAGTACC
CTGCGACCCCA -> TGCGACCCCAT
CTGCGACCGCG -> TGCGACCGCGA
CTGCGATAAGT -> TGCGATAAGTA
CTGCTCCGTAG -> TGCTCCGTAGC
CTGCTTATTTC -> TGCTTATTTCC
CTGGAGGGGTA -> TGGAGGGGTAG
CTGGCAGGCGC -> TGGCAGGCGCC
CTGGCATGACT -> TGGCATGACTT
CTGGCCGATTT -> TGGCCGATTTG
CTGGTTAGACG -> TGGTTAGACGT
CTGTATCAGTC -> TGTATCAGTCG
CTGTATTGTTG -> TGTATTGTTGA
CTGTCATCCGT -> TGTCATCCGTT
CTGTGCGTCTA -> TGTGCGTCTAC
CTGTGCGTTCT -> TGTGCGTTCTA
CTGTGGATTGA -> TGTGGATTGAG
CTTAAAGGCCC -> TTAAAGGCCCC
CTTAAATTCAT -> TTAAATTCATA
CTTACGTATTG -> TTACGTATTGC
CTTACTCTTGC -> TTACTCTTGCG
CTTAGCATGAT -> TTAGCATGATA
CTTATTTCCTT -> TTATTTCCTTC
CTTCAAAAATC -> TTCAAAAATCA
CTTCAGCGGTA -> TTCAGCGGTAG
CTTCCCGCATA -> TTCCCGCATAA
CTTCCGACGCC -> TTCCGACGCCT
CTTCGACACAT -> TTCGACACATG
CTTCGTTGTTA -> TTCGTTGTTAG
CTTCTCTGCGA -> TTCTCTGCGAT
CTTGAGGACGA -> TTGAGGACGAT
CTTGATGTCAG -> TTGATGTCAGG
CTTGCAGGGCT -> TTGCAGGGCTT
CTTGCATGTCT -> TTGCATGTCTG
CTTGCATTTGT -> TTGCATTTGTC
CTTGCGGTATG -> TTGCGGTATGA
CTTGGTTGGCC -> TTGGTTGGCCA
CTTGTCTTACG -> TTGTCTTACGT
CTTTCACTCGT -> TTTCACTCGTT
CTTTCTAAGGA -> TTTCTAAGGAC
CTTTGAGAGCA -> TTTGAGAGCAG
CTTTGCGCGCA -> TTTGCGCGCAG
CTTTTAAAGCA -> TTTTAAAGCAG
CTTTTCGGGGG -> TTTTCGGGGGT
GAAAAAGGGTG -> AAAAAGGGTGT
GAAAAGTATGG -> AAAAGTATGGA
GAAACGTGGAG -> AAACGTGGAGG
GAAACTCTTTT -> AAACTCTTTTC
GAAAGGGGAGG -> AAAGGGGAGGC
GAAATAGTGCC -> AAATAGTGCCT
GAAATCGAGAG -> AAATCGAGAGA
GAACAGATTCC -> AACAGATTCCA
GAACAGTCCTC -> AACAGTCCTCA
GAACCCCAACG -> AACCCCAACGT
GAACCCCAGGC -> AACCCCAGGCA
GAACCGTCGAA -> AACCGTCGAAA
GAACCGTTACT -> AACCGTTACTA
GAACGGGTACC -> AACGGGTACCA
GAACTACCGTA -> AACTACCGTAG
GAACTCTAAGA -> AACTCTAAGAA
GAACTGCGACC -> AACTGCGACCC
GAACTGTATCA -> AACTGTATCAG
GAACTTGAGGA -> AACTTGAGGAC
GAAGAACTACC -> AAGAACTACCG
GAAGAGTTGCC -> AAGAGTTGCCG
GAAGGATAGAG -> AAGGATAGAGT
GAAGGCTTGGT -> AAGGCTTGGTT
GAAGTACATGC -> AAGTACATGCA
GAAGTACCAGT -> AAGTACCAGTG
GAAGTCCTTTG -> AAGTCCTTTGC
GAAGTTAAGAA -> AAGTTAAGAAT
GAATACCAGGC -> AATACCAGGCG
GAATCAGTACA -> AATCAGTACAA
GAATCGAAAAG -> AATCGAAAAGT
GAATGCCCCAA -> AATGCCCCAAA
GAATGGCAACC -> AATGGCAACCG
GAATGTTATTC -> AATGTTATTCC
GAATTGCCCGT -> AATTGCCCGTG
GACAAACAATT -> ACAAACAATTA
GACAATCTTGC -> ACAATCTTGCA
GACACATGTAA -> ACACATGTAAT
GACACGACAAT -> ACACGACAATC
GACAGCGTCAC -> ACAGCGTCACA
GACATACACTC -> ACATACACTCA
GACCAATAGGC -> ACCAATAGGCC
GACCAGCGCGC -> ACCAGCGCGCA
GACCAGTACGT -> ACCAGTACGTT
GACCCCATGAG -> ACCCCATGAGC
GACCGAACAGT -> ACCGAACAGTC
GACCGCGACAT -> ACCGCGACATA
GACCTCGAACC -> ACCTCGAACCC
GACCTCGATTG -> ACCTCGATTGG
GACCTTTGAGA -> ACCTTTGAGAG
GACGAAAGGGG -> ACGAAAGGGGA
GACGAACTCTA -> ACGAACTCTAA
GACGAATGGCA -> ACGAATGGCAA
GACGACTTCGT -> ACGACTTCGTT
GACGAGGCGGT -> ACGAGGCGGTT
GACGAGTTACC -> ACGAGTTACCT
GACGATTGTGC -> ACGATTGTGCA
GACGCCATTTA -> ACGCCATTTAG
GACGCCGACCA -> ACGCCGACCAG
GACGCCGATGG -> ACGCCGATGGC
GACGCCTATAT -> ACGCCTATATG
GACGGACTGCG -> ACGGACTGCGA
GACGGATATTC -> ACGGATATTCA
GACGGCGAACC -> ACGGCGAACCG
GACGGGCATCA -> ACGGGCATCAT
GACGTAAGACG -> ACGTAAGACGA
GACGTACATTG -> ACGTACATTGG
GACTACCATTC -> ACTACCATTCT
GACTACGGTTC -> ACTACGGTTCA
GACTACTAGCC -> ACTACTAGCCG
GACTATATCAA -> ACTATATCAAT
GACTCATTGGG -> ACTCATTGGGT
GACTGCGACCG -> ACTGCGACCGC
GACTTAAATTC -> ACTTAAATTCA
GACTTCGTTGT -> ACTTCGTTGTT
GACTTTCACTC -> ACTTTCACTCG
GACTTTTAAAG -> ACTTTTAAAGC
GAGAGAGCATG -> AGAGAGCATGC
GAGAGAGCGCA -> AGAGAGCGCAT
GAGAGCAGACG -> AGAGCAGACGG
GAGAGCATGCA -> AGAGCATGCAG
GAGAGCGCATG -> AGAGCGCATGC
GAGAGTGGGAC -> AGAGTGGGACG
GAGATGAGATG -> AGATGAGATGT
GAGATGTGGCA -> AGATGTGGCAC
GAGATTATGTG -> AGATTATGTGC
GAGCAATCCGC -> AGCAATCCGCA
GAGCAGACGGA -> AGCAGACGGAT
GAGCATGCAGC -> AGCATGCAGCA
GAGCCAAGTGT -> AGCCAAGTGTT
GAGCCATTCTG -> AGCCATTCTGA
GAGCGACCTTT -> AGCGACCTTTG
GAGCGCATGCT -> AGCGCATGCTC
GAGGAAAAAGG -> AGGAAAAAGGG
GAGGACGATTG -> AGGACGATTGT
GAGGCAATGAC -> AGGCAATGACC
GAGGCGGAGAG -> AGGCGGAGAGT
GAGGCGGTTCA -> AGGCGGTTCAG
GAGGCGTCTGG -> AGGCGTCTGGA
GAGGCTTCAGC -> AGGCTTCAGCG
GAGGGACAGCG -> AGGGACAGCGT
GAGGGGTAGTT -> AGGGGTAGTTG
GAGGTGGTATT -> AGGTGGTATTA
GAGTGGGACGG -> AGTGGGACGGA
GAGTGGTTCGA -> AGTGGTTCGAC
GAGTTACCTTA -> AGTTACCTTAA
GAGTTGCCGCA -> AGTTGCCGCAC
GAGTTTTTTCA -> AGTTTTTTCAC
GATAAGTAATC -> ATAAGTAATCC
GATAAGTAGGA -> ATAAGTAGGAG
GATACATGTGC -> ATACATGTGCT
GATAGAGTGGT -> ATAGAGTGGTT
GATATCGCTCC -> ATATCGCTCCC
GATATCTTGCA -> ATATCTTGCAT
GATATTAGTCC -> ATATTAGTCCG
GATATTCATCA -> ATATTCATCAT
GATCAGAATAC -> ATCAGAATACC
GATCCAGACAA -> ATCCAGACAAA
GATGAGATGTG -> ATGAGATGTGG
GATGCAACTCC -> ATGCAACTCCC
GATGGCCGGCG -> ATGGCCGGCGT
GATGTCAGGGG -> ATGTCAGGGGG
GATGTGGCACA -> ATGTGGCACAT
GATGTTAGCGT -> ATGTTAGCGTT
GATGTTGAAGA -> ATGTTGAAGAG
GATTACTACCA -> ATTACTACCAA
GATTATCGCAC -> ATTATCGCACT
GATTATGTGCT -> ATTATGTGCTG
GATTCCATCGT -> ATTCCATCGTA
GATTCGAACTG -> ATTCGAACTGC
GATTGAGGCTT -> ATTGAGGCTTC
GATTGGCTGCT -> ATTGGCTGCTC
GATTGTGCACG -> ATTGTGCACGA
GATTTGACGAG -> ATTTGACGAGG
GCAACCGTCTG -> CAACCGTCTGT
GCAACTCCCGA -> CAACTCCCGAG
GCAAGCACCCA -> CAAGCACCCAT
GCAAGCTGTGG -> CAAGCTGTGGA
GCAAGGCCGCA -> CAAGGCCGCAA
GCAAGGCGACG -> CAAGGCGACGG
GCAAGTTGACT -> CAAGTTGACTA
GCAATAAAGTA -> CAATAAAGTAC
GCAATCCGCAC -> CAATCCGCACA
GCAATGACCAG -> CAATGACCAGT
GCACAGCTAAG -> CACAGCTAAGT
GCACATCCCAG -> CACATCCCAGT
GCACATTCTTG -> CACATTCTTGA
GCACCCATACA -> CACCCATACAT
GCACGACTCAT -> CACGACTCATT
GCACTCCCTAG -> CACTCCCTAGG
GCACTCTGCGA -> CACTCTGCGAA
GCAGAATTGCC -> CAGAATTGCCC
GCAGACGGATA -> CAGACGGATAT
GCAGCAGGTAG -> CAGCAGGTAGG
GCAGCGCGAGC -> CAGCGCGAGCA
GCAGCTCGAAC -> CAGCTCGAACC
GCAGGCGCCAG -> CAGGCGCCAGA
GCAGGCGGCTG -> CAGGCGGCTGG
GCAGGCGTAAC -> CAGGCGTAACT
GCAGGGCTTAC -> CAGGGCTTACT
GCAGGTAGGCT -> CAGGTAGGCTG
GCAGGTTCGCC -> CAGGTTCGCCA
GCAGTTTTGGA -> CAGTTTTGGAA
GCATAACCGGA -> CATAACCGGAC
GCATCATGGTT -> CATCATGGTTG
GCATGACTTTC -> CATGACTTTCA
GCATGATATCT -> CATGATATCTT
GCATGCAGCAG -> CATGCAGCAGG
GCATGCTCTGA -> CATGCTCTGAC
GCATGGTGCGG -> CATGGTGCGGC
GCATGTCTGCT -> CATGTCTGCTT
GCATTCCCGTT -> CATTCCCGTTA
GCATTGCTCAG -> CATTGCTCAGG
GCATTTGTCGC -> CATTTGTCGCC
GCCAAGTGTTG -> CCAAGTGTTGA
GCCAGAACTGT -> CCAGAACTGTA
GCCAGACGAAC -> CCAGACGAACT
GCCAGCCTCGG -> CCAGCCTCGGG
GCCAGGACCGA -> CCAGGACCGAA
GCCATGCGTTA -> CCATGCGTTAG
GCCATTCTGAC -> CCATTCTGACG
GCCATTGATAC -> CCATTGATACA
GCCATTTAGAT -> CCATTTAGATT
GCCCCAAAAGG -> CCCCAAAAGGT
GCCCCCCGATC -> CCCCCCGATCC
GCCCGTGGGTC -> CCCGTGGGTCA
GCCGAATGTTA -> CCGAATGTTAT
GCCGACCAGCG -> CCGACCAGCGC
GCCGATGGCCG -> CCGATGGCCGG
GCCGATTTGAC -> CCGATTTGACG
GCCGCAAGGCG -> CCGCAAGGCGA
GCCGCACAGCT -> CCGCACAGCTA
GCCGGAGTACG -> CCGGAGTACGT
GCCGGATATCG -> CCGGATATCGC
GCCGGCGTCAG -> CCGGCGTCAGT
GCCGTGGGAAC -> CCGTGGGAACC
GCCTAAGCCTC -> CCTAAGCCTCA
GCCTACAAAGT -> CCTACAAAGTC
GCCTATATGCC -> CCTATATGCCT
GCCTCACTTCG -> CCTCACTTCGA
GCCTCGGGTAA -> CCTCGGGTAAA
GCCTTCAAAAA -> CCTTCAAAAAT
GCGAACCGTCG -> CGAACCGTCGA
GCGAAGTACCA -> CGAAGTACCAG
GCGACATACAC -> CGACATACACT
GCGACCCCATG -> CGACCCCATGA
GCGACCGCGAC -> CGACCGCGACA
GCGACCTTTGA -> CGACCTTTGAG
GCGACGGCGAA -> CGACGGCGAAC
GCGACGGGCAT -> CGACGGGCATC
GCGAGCAATCC -> CGAGCAATCCG
GCGATAAGTAA -> CGATAAGTAAT
GCGCAAGTTGA -> CGCAAGTTGAC
GCGCAGAATTG -> CGCAGAATTGC
GCGCAGCGCGA -> CGCAGCGCGAG
GCGCAGGCGGC -> CGCAGGCGGCT
GCGCATGCTCT -> CGCATGCTCTG
GCGCCAGACGA -> CGCCAGACGAA
GCGCGAGCAAT -> CGCGAGCAATC
GCGCGCAAGTT -> CGCGCAAGTTG
GCGCGCAGCGC -> CGCGCAGCGCG
GCGCGGAGATT -> CGCGGAGATTA
GCGGAGAGTGG -> CGGAGAGTGGG
GCGGAGATTAT -> CGGAGATTATG
GCGGCAGGCGT -> CGGCAGGCGTA
GCGGCTGGTTA -> CGGCTGGTTAG
GCGGTAGACGA -> CGGTAGACGAA
GCGGTATGAGC -> CGGTATGAGCC
GCGGTTAAATT -> CGGTTAAATTG
GCGGTTCAGAT -> CGGTTCAGATC
GCGTAACTAAC -> CGTAACTAACT
GCGTACTCCGA -> CGTACTCCGAG
GCGTCACATCC -> CGTCACATCCG
GCGTCAGTTTC -> CGTCAGTTTCA
GCGTCTACAGG -> CGTCTACAGGA
GCGTCTGGAGG -> CGTCTGGAGGG
GCGTTAGCGGT -> CGTTAGCGGTT
GCGTTCTAGGC -> CGTTCTAGGCG
GCGTTTCCGTG -> CGTTTCCGTGA
GCTAAGTACGC -> CTAAGTACGCG
GCTACACTATT -> CTACACTATTG
GCTACGTCGTG -> CTACGTCGTGA
GCTACTGACGC -> CTACTGACGCC
GCTCAGGACTA -> CTCAGGACTAC
GCTCATAGTTG -> CTCATAGTTGG
GCTCCCCAATC -> CTCCCCAATCT
GCTCCGGCCAG -> CTCCGGCCAGC
GCTCCGTAGCG -> CTCCGTAGCGA
GCTCGAACCCC -> CTCGAACCCCA
GCTCTCGGTCG -> CTCTCGGTCGG
GCTCTGACGCC -> CTCTGACGCCG
GCTCTGCCATT -> CTCTGCCATTG
GCTGAAGAACT -> CTGAAGAACTA
GCTGCTCCGTA -> CTGCTCCGTAG
GCTGGTTAGAC -> CTGGTTAGACG
GCTGTATTGTT -> CTGTATTGTTG
GCTGTGCGTTC -> CTGTGCGTTCT
GCTGTGGATTG -> CTGTGGATTGA
GCTTACTCTTG -> CTTACTCTTGC
GCTTAGCATGA -> CTTAGCATGAT
GCTTATTTCCT -> CTTATTTCCTT
GCTTCAGCGGT -> CTTCAGCGGTA
GCTTGCATGTC -> CTTGCATGTCT
GCTTGGTTGGC -> CTTGGTTGGCC
GCTTTCTAAGG -> CTTTCTAAGGA
GGAAAAAGGGT -> GAAAAAGGGTG
GGAAACGTGGA -> GAAACGTGGAG
GGAACAGATTC -> GAACAGATTCC
GGAACCGTTAC -> GAACCGTTACT
GGAACGGGTAC -> GAACGGGTACC
GGAACTTGAGG -> GAACTTGAGGA
GGAAGGATAGA -> GAAGGATAGAG
GGAAGTTAAGA -> GAAGTTAAGAA
GGACACGACAA -> GACACGACAAT
GGACAGCGTCA -> GACAGCGTCAC
GGACCAATAGG -> GACCAATAGGC
GGACCGAACAG -> GACCGAACAGT
GGACGAAAGGG -> GACGAAAGGGG
GGACGATTGTG -> GACGATTGTGC
GGACGGACTGC -> GACGGACTGCG
GGACTACTAGC -> GACTACTAGCC
GGACTGCGACC -> GACTGCGACCG
GGAGAGAGCGC -> GAGAGAGCGCA
GGAGAGTGGGA -> GAGAGTGGGAC
GGAGATGAGAT -> GAGATGAGATG
GGAGATTATGT -> GAGATTATGTG
GGAGCGACCTT -> GAGCGACCTTT
GGAGGCAATGA -> GAGGCAATGAC
GGAGGCGGAGA -> GAGGCGGAGAG
GGAGGCGTCTG -> GAGGCGTCTGG
GGAGGGACAGC -> GAGGGACAGCG
GGAGGGGTAGT -> GAGGGGTAGTT
GGAGTTTTTTC -> GAGTTTTTTCA
GGATAGAGTGG -> GATAGAGTGGT
GGATATCGCTC -> GATATCGCTCC
GGATATTCATC -> GATATTCATCA
GGATGTTAGCG -> GATGTTAGCGT
GGATTGAGGCT -> GATTGAGGCTT
GGCAACCGTCT -> GCAACCGTCTG
GGCAAGCTGTG -> GCAAGCTGTGG
GGCAATGACCA -> GCAATGACCAG
GGCACATCCCA -> GCACATCCCAG
GGCAGGCGCCA -> GCAGGCGCCAG
GGCAGGCGTAA -> GCAGGCGTAAC
GGCAGGTTCGC -> GCAGGTTCGCC
GGCATCATGGT -> GCATCATGGTT
GGCATGACTTT -> GCATGACTTTC
GGCCAGCCTCG -> GCCAGCCTCGG
GGCCATGCGTT -> GCCATGCGTTA
GGCCCCCCGAT -> GCCCCCCGATC
GGCCGAATGTT -> GCCGAATGTTA
GGCCGATTTGA -> GCCGATTTGAC
GGCCGCAAGGC -> GCCGCAAGGCG
GGCCGGCGTCA -> GCCGGCGTCAG
GGCGAACCGTC -> GCGAACCGTCG
GGCGACGGCGA -> GCGACGGCGAA
GGCGCAGAATT -> GCGCAGAATTG
GGCGCCAGACG -> GCGCCAGACGA
GGCGCGGAGAT -> GCGCGGAGATT
GGCGGAGAGTG -> GCGGAGAGTGG
GGCGGCTGGTT -> GCGGCTGGTTA
GGCGGTTCAGA -> GCGGTTCAGAT
GGCGTAACTAA -> GCGTAACTAAC
GGCGTACTCCG -> GCGTACTCCGA
GGCGTCAGTTT -> GCGTCAGTTTC
GGCGTCTGGAG -> GCGTCTGGAGG
GGCTACGTCGT -> GCTACGTCGTG
GGCTCATAGTT -> GCTCATAGTTG
GGCTCCGGCCA -> GCTCCGGCCAG
GGCTCTGCCAT -> GCTCTGCCATT
GGCTGCTCCGT -> GCTGCTCCGTA
GGCTGGTTAGA -> GCTGGTTAGAC
GGCTGTATTGT -> GCTGTATTGTT
GGCTGTGCGTT -> GCTGTGCGTTC
GGCTTACTCTT -> GCTTACTCTTG
GGCTTCAGCGG -> GCTTCAGCGGT
GGCTTGGTTGG -> GCTTGGTTGGC
GGGAACCGTTA -> GGAACCGTTAC
GGGAACGGGTA -> GGAACGGGTAC
GGGAACTTGAG -> GGAACTTGAGG
GGGACAGCGTC -> GGACAGCGTCA
GGGACGGACTG -> GGACGGACTGC
GGGAGAGAGCG -> GGAGAGAGCGC
GGGAGGCGGAG -> GGAGGCGGAGA
GGGAGGGACAG -> GGAGGGACAGC
GGGATGTTAGC -> GGATGTTAGCG
GGGCATCATGG -> GGCATCATGGT
GGGCTCCGGCC -> GGCTCCGGCCA
GGGCTCTGCCA -> GGCTCTGCCAT
GGGCTTACTCT -> GGCTTACTCTT
GGGGAGGCGGA -> GGGAGGCGGAG
GGGGCTCCGGC -> GGGCTCCGGCC
GGGGGCTCCGG -> GGGGCTCCGGC
GGGGGGCTCCG -> GGGGGCTCCGG
GGGGGTTAGTG -> GGGGTTAGTGG
GGGGTAGTTGG -> GGGTAGTTGGG
GGGGTTAGTGG -> GGGTTAGTGGA
GGGTAAAAAAC -> GGTAAAAAACG
GGGTACCAGAC -> GGTACCAGACC
GGGTAGTTGGG -> GGTAGTTGGGT
GGGTCATACCG -> GGTCATACCGT
GGGTCGACTTA -> GGTCGACTTAA
GGGTCGGGAGA -> GGTCGGGAGAG
GGGTGTAGAAA -> GGTGTAGAAAT
GGGTGTATGTA -> GGTGTATGTAG
GGGTTAGTGGA -> GGTTAGTGGAG
GGGTTGTTGAT -> GGTTGTTGATA
GGTAAAAAACG -> GTAAAAAACGG
GGTAAGCTCTC -> GTAAGCTCTCG
GGTACCAGACC -> GTACCAGACCT
GGTACTACTTC -> GTACTACTTCC
GGTACTCCTCA -> GTACTCCTCAT
GGTAGACGAAT -> GTAGACGAATG
GGTAGGCTGTG -> GTAGGCTGTGC
GGTAGTTGGGT -> GTAGTTGGGTC
GGTATGAGCCA -> GTATGAGCCAT
GGTATTATCGT -> GTATTATCGTA
GGTCATACCGT -> GTCATACCGTT
GGTCGACTTAA -> GTCGACTTAAA
GGTCGGGAGAG -> GTCGGGAGAGA
GGTCGGTACTC -> GTCGGTACTCC
GGTGCGGCAGG -> GTGCGGCAGGC
GGTGGTATTAT -> GTGGTATTATC
GGTGTAGAAAT -> GTGTAGAAATA
GGTGTATGTAG -> GTGTATGTAGT
GGTGTGGCTCA -> GTGTGGCTCAT
GGTTAAATTGG -> GTTAAATTGGC
GGTTAGACGTA -> GTTAGACGTAC
GGTTAGTGGAG -> GTTAGTGGAGA
GGTTCAAAGAA -> GTTCAAAGAAG
GGTTCAGATCA -> GTTCAGATCAG
GGTTCGACGTA -> GTTCGACGTAA
GGTTCGCCAGG -> GTTCGCCAGGA
GGTTGCTTTCT -> GTTGCTTTCTA
GGTTGGCCATG -> GTTGGCCATGC
GGTTGTTGATA -> GTTGTTGATAA
GTAAAAAACGG -> TAAAAAACGGA
GTAACTAACTC -> TAACTAACTCC
GTAAGACGAGT -> TAAGACGAGTT
GTAAGCTCTCG -> TAAGCTCTCGG
GTAAGTTGTGC -> TAAGTTGTGCA
GTAATCCGGGA -> TAATCCGGGAT
GTAATGCCGTG -> TAATGCCGTGG
GTACAATAGCA -> TACAATAGCAA
GTACATGCAAT -> TACATGCAATA
GTACATTGGAC -> TACATTGGACC
GTACCAGACCT -> TACCAGACCTC
GTACCAGTGTA -> TACCAGTGTAC
GTACCCCACCT -> TACCCCACCTT
GTACCGTCGGG -> TACCGTCGGGA
GTACCTCTGAA -> TACCTCTGAAA
GTACGCGCAGG -> TACGCGCAGGC
GTACGTTGCTA -> TACGTTGCTAC
GTACTACTTCC -> TACTACTTCCG
GTACTCCGAGG -> TACTCCGAGGT
GTACTCCTCAT -> TACTCCTCATC
GTAGAAATAGT -> TAGAAATAGTG
GTAGAATCAGT -> TAGAATCAGTA
GTAGACGAATG -> TAGACGAATGG
GTAGCGACGGG -> TAGCGACGGGC
GTAGGAGCGAC -> TAGGAGCGACC
GTAGGCTGTGC -> TAGGCTGTGCG
GTAGTATATTA -> TAGTATATTAT
GTAGTCTGCAT -> TAGTCTGCATT
GTAGTGGAAGG -> TAGTGGAAGGA
GTAGTTGGGTC -> TAGTTGGGTCG
GTATATTATGA -> TATATTATGAT
GTATCAGTCGT -> TATCAGTCGTC
GTATCTAGACT -> TATCTAGACTA
GTATGAAGTCC -> TATGAAGTCCT
GTATGAGCCAT -> TATGAGCCATT
GTATGGAAACG -> TATGGAAACGT
GTATGTAGTGG -> TATGTAGTGGA
GTATTATCGTA -> TATTATCGTAT
GTATTCGTGAC -> TATTCGTGACT
GTATTGCAAGC -> TATTGCAAGCA
GTATTGTTGAC -> TATTGTTGACG
GTCACATCCGT -> TCACATCCGTC
GTCAGGGGGGC -> TCAGGGGGGCT
GTCAGTAGAAT -> TCAGTAGAATC
GTCAGTTTCAG -> TCAGTTTCAGT
GTCATACCGTT -> TCATACCGTTA
GTCATCCGTTC -> TCATCCGTTCG
GTCCGGGAGGG -> TCCGGGAGGGA
GTCCTCAAAGC -> TCCTCAAAGCC
GTCCTTTGCGC -> TCCTTTGCGCG
GTCGAAATCGA -> TCGAAATCGAG
GTCGAATGCCC -> TCGAATGCCCC
GTCGACTTAAA -> TCGACTTAAAT
GTCGCCAGAAC -> TCGCCAGAACT
GTCGGCTGTAT -> TCGGCTGTATT
GTCGGGAACTT -> TCGGGAACTTG
GTCGGGAGAGA -> TCGGGAGAGAG
GTCGGTACTCC -> TCGGTACTCCT
GTCGTAAGTTG -> TCGTAAGTTGT
GTCGTCAGTAG -> TCGTCAGTAGA
GTCGTGATTAT -> TCGTGATTATC
GTCTACAGGAG -> TCTACAGGAGT
GTCTCGGTACT -> TCTCGGTACTA
GTCTGCATTGC -> TCTGCATTGCT
GTCTGCTTATT -> TCTGCTTATTT
GTCTGGAGGGG -> TCTGGAGGGGT
GTCTGTGCGTC -> TCTGTGCGTCT
GTCTTACGTAT -> TCTTACGTATT
GTGACTATATC -> TGACTATATCA
GTGACTTTTAA -> TGACTTTTAAA
GTGATGTTGAA -> TGATGTTGAAG
GTGATTATCGC -> TGATTATCGCA
GTGCACGACTC -> TGCACGACTCA
GTGCACTCTGC -> TGCACTCTGCG
GTGCCTTCAAA -> TGCCTTCAAAA
GTGCGGCAGGC -> TGCGGCAGGCG
GTGCGTCTACA -> TGCGTCTACAG
GTGCGTTCTAG -> TGCGTTCTAGG
GTGCTACACTA -> TGCTACACTAT
GTGCTGAAGAA -> TGCTGAAGAAC
GTGCTTAGCAT -> TGCTTAGCATG
GTGGAAGGATA -> TGGAAGGATAG
GTGGAGATGAG -> TGGAGATGAGA
GTGGAGGCGTC -> TGGAGGCGTCT
GTGGATTGAGG -> TGGATTGAGGC
GTGGCACATCC -> TGGCACATCCC
GTGGCTCATAG -> TGGCTCATAGT
GTGGGAACCGT -> TGGGAACCGTT
GTGGGACGGAC -> TGGGACGGACT
GTGGGTCATAC -> TGGGTCATACC
GTGGTATTATC -> TGGTATTATCG
GTGGTTCGACG -> TGGTTCGACGT
GTGTACCCCAC -> TGTACCCCACC
GTGTAGAAATA -> TGTAGAAATAG
GTGTATGTAGT -> TGTATGTAGTG
GTGTGGCTCAT -> TGTGGCTCATA
GTGTGTTAATC -> TGTGTTAATCT
GTGTTAATCTG -> TGTTAATCTGT
GTGTTGATTAC -> TGTTGATTACT
GTTAAATTGGC -> TTAAATTGGCT
GTTAAGAATCG -> TTAAGAATCGA
GTTAATCTGTC -> TTAATCTGTCA
GTTACATGGAA -> TTACATGGAAG
GTTACCTTAAA -> TTACCTTAAAG
GTTACTATTGC -> TTACTATTGCC
GTTAGACGTAC -> TTAGACGTACA
GTTAGCGGTTA -> TTAGCGGTTAA
GTTAGCGTTTC -> TTAGCGTTTCC
GTTAGTGATGT -> TTAGTGATGTT
GTTAGTGGAGA -> TTAGTGGAGAT
GTTATGGGTCG -> TTATGGGTCGA
GTTATTCCACA -> TTATTCCACAT
GTTCAAAGAAG -> TTCAAAGAAGG
GTTCAGATCAG -> TTCAGATCAGA
GTTCGACGTAA -> TTCGACGTAAG
GTTCGCCAGGA -> TTCGCCAGGAC
GTTCGTACCTC -> TTCGTACCTCT
GTTCTAGGCGT -> TTCTAGGCGTA
GTTGAAGAGTT -> TTGAAGAGTTG
GTTGACGCCAT -> TTGACGCCATT
GTTGACTACGG -> TTGACTACGGT
GTTGATAAGTA -> TTGATAAGTAG
GTTGATTACTA -> TTGATTACTAC
GTTGCCGCACA -> TTGCCGCACAG
GTTGCTACTGA -> TTGCTACTGAC
GTTGCTTTCTA -> TTGCTTTCTAA
GTTGGCCATGC -> TTGGCCATGCG
GTTGGGTCGGG -> TTGGGTCGGGA
GTTGGGTGTAG -> TTGGGTGTAGA
GTTGTCGGCTG -> TTGTCGGCTGT
GTTGTGCACTC -> TTGTGCACTCT
GTTGTTAGTGA -> TTGTTAGTGAT
GTTGTTGATAA -> TTGTTGATAAG
GTTTCAGTGCT -> TTTCAGTGCTA
GTTTCCGTGAC -> TTTCCGTGACT
GTTTTGGAACA -> TTTTGGAACAG
GTTTTTTCACT -> TTTTTTCACTG
TAAAAAACGGA -> AAAAAACGGAG
TAAAAGTCTCG -> AAAAGTCTCGG
TAAAGCAGTTT -> AAAGCAGTTTT
TAAAGGCCCCC -> AAAGGCCCCCC
TAAAGTACCGT -> AAAGTACCGTC
TAAATTCATAA -> AAATTCATAAA
TAAATTGGCTA -> AAATTGGCTAC
TAACCGGACAC -> AACCGGACACG
TAACTAACTCC -> AACTAACTCCT
TAACTCCTACA -> AACTCCTACAG
TAAGAAGTACA -> AAGAAGTACAT
TAAGAATCGAA -> AAGAATCGAAA
TAAGACGAGTT -> AAGACGAGTTA
TAAGCCTCACT -> AAGCCTCACTT
TAAGCTCTCGG -> AAGCTCTCGGT
TAAGGACGAAA -> AAGGACGAAAG
TAAGTAATCCG -> AAGTAATCCGG
TAAGTACGCGC -> AAGTACGCGCA
TAAGTAGGAGC -> AAGTAGGAGCG
TAAGTTGTGCA -> AAGTTGTGCAC
TAATCCGGGAT -> AATCCGGGATG
TAATCTGTCAT -> AATCTGTCATC
TAATGCCGTGG -> AATGCCGTGGG
TACAAAGTCGT -> ACAAAGTCGTA
TACAATAGCAA -> ACAATAGCAAG
TACACTATTGA -> ACACTATTGAC
TACACTCATTT -> ACACTCATTTT
TACAGGAGTTT -> ACAGGAGTTTT
TACAGTGTGTT -> ACAGTGTGTTA
TACATGCAATA -> ACATGCAATAA
TACATGCTTGC -> ACATGCTTGCA
TACATGGAAGT -> ACATGGAAGTT
TACATGTGCTT -> ACATGTGCTTA
TACATTGGACC -> ACATTGGACCA
TACCAACCTGG -> ACCAACCTGGC
TACCAAGATAT -> ACCAAGATATT
TACCAGACCTC -> ACCAGACCTCG
TACCAGGCGCA -> ACCAGGCGCAG
TACCAGTGTAC -> ACCAGTGTACC
TACCATTCTCT -> ACCATTCTCTC
TACCCCACCTT -> ACCCCACCTTG
TACCGTAGTCT -> ACCGTAGTCTG
TACCGTCGGGA -> ACCGTCGGGAA
TACCGTTATGG -> ACCGTTATGGG
TACCTCTGAAA -> ACCTCTGAAAC
TACCTTAAAGG -> ACCTTAAAGGC
TACGCAGCTCG -> ACGCAGCTCGA
TACGCGCAGGC -> ACGCGCAGGCG
TACGGTTCAAA -> ACGGTTCAAAG
TACGTATTGCA -> ACGTATTGCAA
TACGTCGTGAT -> ACGTCGTGATT
TACGTTGCTAC -> ACGTTGCTACT
TACTACCAAGA -> ACTACCAAGAT
TACTACTTCCG -> ACTACTTCCGA
TACTAGCCGGA -> ACTAGCCGGAG
TACTATTGCCG -> ACTATTGCCGG
TACTCCGAGGT -> ACTCCGAGGTG
TACTCCTCATC -> ACTCCTCATCT
TACTCTTGCGG -> ACTCTTGCGGT
TACTGACGCCG -> ACTGACGCCGA
TACTTCCGACG -> ACTTCCGACGC
TAGAAATAGTG -> AGAAATAGTGC
TAGAATCAGTA -> AGAATCAGTAC
TAGACGAATGG -> AGACGAATGGC
TAGACGTACAT -> AGACGTACATT
TAGACTACCAT -> AGACTACCATT
TAGAGTGGTTC -> AGAGTGGTTCG
TAGATTCGAAC -> AGATTCGAACT
TAGCAAGGCCG -> AGCAAGGCCGC
TAGCATGATAT -> AGCATGATATC
TAGCCGGAGTA -> AGCCGGAGTAC
TAGCGACGGGC -> AGCGACGGGCA
TAGCGGTTAAA -> AGCGGTTAAAT
TAGCGTTTCCG -> AGCGTTTCCGT
TAGGAGCGACC -> AGGAGCGACCT
TAGGCAAGCTG -> AGGCAAGCTGT
TAGGCCGAATG -> AGGCCGAATGT
TAGGCGTACTC -> AGGCGTACTCC
TAGGCTGTGCG -> AGGCTGTGCGT
TAGGGCTCTGC -> AGGGCTCTGCC
TAGTATATTAT -> AGTATATTATG
TAGTCCGGGAG -> AGTCCGGGAGG
TAGTCTGCATT -> AGTCTGCATTG
TAGTGATGTTG -> AGTGATGTTGA
TAGTGCCTTCA -> AGTGCCTTCAA
TAGTGGAAGGA -> AGTGGAAGGAT
TAGTGGAGATG -> AGTGGAGATGA
TAGTTGGGTCG -> AGTTGGGTCGG
TAGTTGGGTGT -> AGTTGGGTGTA
TATATCAATAG -> ATATCAATAGG
TATATGCCTAC -> ATATGCCTACA
TATATTATGAT -> ATATTATGATG
TATCAATAGGG -> ATCAATAGGGC
TATCAGTCGTC -> ATCAGTCGTCA
TATCGCACTCC -> ATCGCACTCCC
TATCGCTCCCC -> ATCGCTCCCCA
TATCGGGAACG -> ATCGGGAACGG
TATCGTATGAA -> ATCGTATGAAG
TATCTAGACTA -> ATCTAGACTAC
TATCTTGCATT -> ATCTTGCATTT
TATGAAGTCCT -> ATGAAGTCCTT
TATGAGCCATT -> ATGAGCCATTC
TATGATGCAAC -> ATGATGCAACT
TATGCCTACAA -> ATGCCTACAAA
TATGGAAACGT -> ATGGAAACGTG
TATGGGTCGAC -> ATGGGTCGACT
TATGTAGTGGA -> ATGTAGTGGAA
TATGTGCTGAA -> ATGTGCTGAAG
TATTAGTCCGG -> ATTAGTCCGGG
TATTATCGTAT -> ATTATCGTATG
TATTATGATGC -> ATTATGATGCA
TATTCATCATA -> ATTCATCATAC
TATTCCACATC -> ATTCCACATCG
TATTCGTGACT -> ATTCGTGACTA
TATTGACCTCG -> ATTGACCTCGA
TATTGCAAGCA -> ATTGCAAGCAC
TATTGCCGGAT -> ATTGCCGGATA
TATTGTTGACG -> ATTGTTGACGC
TATTTCCTTCC -> ATTTCCTTCCC
TCAAAAATCAC -> CAAAAATCACC
TCAAAGAAGGC -> CAAAGAAGGCT
TCAAAGCCTAA -> CAAAGCCTAAG
TCAATAGGGCT -> CAATAGGGCTC
TCACATCCGTC -> CACATCCGTCG
TCACCGGTAAG -> CACCGGTAAGC
TCACTCGTTGT -> CACTCGTTGTC
TCACTGCATGG -> CACTGCATGGT
TCACTTCGACA -> CACTTCGACAC
TCAGAATACCA -> CAGAATACCAG
TCAGATCAGAA -> CAGATCAGAAT
TCAGCGGTAGA -> CAGCGGTAGAC
TCAGGACTACT -> CAGGACTACTA
TCAGGGGGGCT -> CAGGGGGGCTC
TCAGTACAATA -> CAGTACAATAG
TCAGTAGAATC -> CAGTAGAATCA
TCAGTCGTCAG -> CAGTCGTCAGT
TCAGTGCTACA -> CAGTGCTACAC
TCAGTTTCAGT -> CAGTTTCAGTG
TCATAAAAGTC -> CATAAAAGTCT
TCATACCAACC -> CATACCAACCT
TCATACCGTTA -> CATACCGTTAT
TCATAGTTGGG -> CATAGTTGGGT
TCATCATACCA -> CATCATACCAA
TCATCCGTTCG -> CATCCGTTCGT
TCATCTCGGCG -> CATCTCGGCGC
TCATGGTTGCT -> CATGGTTGCTT
TCATTGGGTTG -> CATTGGGTTGT
TCATTTTCCTA -> CATTTTCCTAT
TCCACATCGCA -> CCACATCGCAT
TCCAGACAAAC -> CCAGACAAACA
TCCATCGTATC -> CCATCGTATCT
TCCCAGTATTC -> CCCAGTATTCG
TCCCCAATCTT -> CCCCAATCTTC
TCCCGAGGAAA -> CCCGAGGAAAA
TCCCGCATAAC -> CCCGCATAACC
TCCCGTTACAT -> CCCGTTACATG
TCCCTAGGCAA -> CCCTAGGCAAG
TCCGACGCCTA -> CCGACGCCTAT
TCCGAGGTGGT -> CCGAGGTGGTA
TCCGCACATTC -> CCGCACATTCT
TCCGGCCAGCC -> CCGGCCAGCCT
TCCGGGAGGGA -> CCGGGAGGGAC
TCCGGGATGTT -> CCGGGATGTTA
TCCGTAGCGAC -> CCGTAGCGACG
TCCGTCGAATG -> CCGTCGAATGC
TCCGTGACTTT -> CCGTGACTTTT
TCCGTTCGTAC -> CCGTTCGTACC
TCCTACAGTGT -> CCTACAGTGTG
TCCTATCGGGA -> CCTATCGGGAA
TCCTCAAAGCC -> CCTCAAAGCCT
TCCTCATCTCG -> CCTCATCTCGG
TCCTTCCCGCA -> CCTTCCCGCAT
TCCTTTGCGCG -> CCTTTGCGCGC
TCGAAAAGTAT -> CGAAAAGTATG
TCGAAATCGAG -> CGAAATCGAGA
TCGAACCCCAA -> CGAACCCCAAC
TCGAACCCCAG -> CGAACCCCAGG
TCGAACTGCGA -> CGAACTGCGAC
TCGAATGCCCC -> CGAATGCCCCA
TCGACACATGT -> CGACACATGTA
TCGACGTAAGA -> CGACGTAAGAC
TCGACTTAAAT -> CGACTTAAATT
TCGAGAGAGCA -> CGAGAGAGCAT
TCGATTGGCTG -> CGATTGGCTGC
TCGCACTCCCT -> CGCACTCCCTA
TCGCATTCCCG -> CGCATTCCCGT
TCGCCAGAACT -> CGCCAGAACTG
TCGCCAGGACC -> CGCCAGGACCG
TCGCTCCCCAA -> CGCTCCCCAAT
TCGGCGCGGAG -> CGGCGCGGAGA
TCGGCTGTATT -> CGGCTGTATTG
TCGGGAACGGG -> CGGGAACGGGT
TCGGGAACTTG -> CGGGAACTTGA
TCGGGAGAGAG -> CGGGAGAGAGC
TCGGGGGTTAG -> CGGGGGTTAGT
TCGGGTAAAAA -> CGGGTAAAAAA
TCGGTACTACT -> CGGTACTACTT
TCGGTACTCCT -> CGGTACTCCTC
TCGGTCGGTAC -> CGGTCGGTACT
TCGTAAGTTGT -> CGTAAGTTGTG
TCGTACCTCTG -> CGTACCTCTGA
TCGTATCTAGA -> CGTATCTAGAC
TCGTATGAAGT -> CGTATGAAGTC
TCGTCAGTAGA -> CGTCAGTAGAA
TCGTGACTATA -> CGTGACTATAT
TCGTGATTATC -> CGTGATTATCG
TCGTTGTCGGC -> CGTTGTCGGCT
TCGTTGTTAGT -> CGTTGTTAGTG
TCTAAGAAGTA -> CTAAGAAGTAC
TCTAAGGACGA -> CTAAGGACGAA
TCTACAGGAGT -> CTACAGGAGTT
TCTAGACTACC -> CTAGACTACCA
TCTAGGCGTAC -> CTAGGCGTACT
TCTCGGCGCGG -> CTCGGCGCGGA
TCTCGGTACTA -> CTCGGTACTAC
TCTCGGTCGGT -> CTCGGTCGGTA
TCTCTCTGGCA -> CTCTCTGGCAG
TCTCTGCGATA -> CTCTGCGATAA
TCTCTGGCAGG -> CTCTGGCAGGC
TCTGAAACTCT -> CTGAAACTCTT
TCTGACGACTT -> CTGACGACTTC
TCTGACGCCGA -> CTGACGCCGAC
TCTGCATTGCT -> CTGCATTGCTC
TCTGCCATTGA -> CTGCCATTGAT
TCTGCGAAGTA -> CTGCGAAGTAC
TCTGCGATAAG -> CTGCGATAAGT
TCTGCTTATTT -> CTGCTTATTTC
TCTGGAGGGGT -> CTGGAGGGGTA
TCTGGCAGGCG -> CTGGCAGGCGC
TCTGTCATCCG -> CTGTCATCCGT
TCTGTGCGTCT -> CTGTGCGTCTA
TCTTACGTATT -> CTTACGTATTG
TCTTCTCTGCG -> CTTCTCTGCGA
TCTTGATGTCA -> CTTGATGTCAG
TCTTGCAGGGC -> CTTGCAGGGCT
TCTTGCATTTG -> CTTGCATTTGT
TCTTGCGGTAT -> CTTGCGGTATG
TCTTTTCGGGG -> CTTTTCGGGGG
TGAAACTCTTT -> GAAACTCTTTT
TGAAGAACTAC -> GAAGAACTACC
TGAAGAGTTGC -> GAAGAGTTGCC
TGAAGTCCTTT -> GAAGTCCTTTG
TGACCAGTACG -> GACCAGTACGT
TGACCTCGATT -> GACCTCGATTG
TGACGACTTCG -> GACGACTTCGT
TGACGAGGCGG -> GACGAGGCGGT
TGACGCCATTT -> GACGCCATTTA
TGACGCCGACC -> GACGCCGACCA
TGACGCCGATG -> GACGCCGATGG
TGACTACGGTT -> GACTACGGTTC
TGACTATATCA -> GACTATATCAA
TGACTTTCACT -> GACTTTCACTC
TGACTTTTAAA -> GACTTTTAAAG
TGAGAGCAGAC -> GAGAGCAGACG
TGAGATGTGGC -> GAGATGTGGCA
TGAGCCAAGTG -> GAGCCAAGTGT
TGAGCCATTCT -> GAGCCATTCTG
TGAGGACGATT -> GAGGACGATTG
TGAGGCTTCAG -> GAGGCTTCAGC
TGATAAGTAGG -> GATAAGTAGGA
TGATACATGTG -> GATACATGTGC
TGATATCTTGC -> GATATCTTGCA
TGATGCAACTC -> GATGCAACTCC
TGATGTCAGGG -> GATGTCAGGGG
TGATGTTGAAG -> GATGTTGAAGA
TGATTACTACC -> GATTACTACCA
TGATTATCGCA -> GATTATCGCAC
TGCAACTCCCG -> GCAACTCCCGA
TGCAAGCACCC -> GCAAGCACCCA
TGCAATAAAGT -> GCAATAAAGTA
TGCACGACTCA -> GCACGACTCAT
TGCACTCTGCG -> GCACTCTGCGA
TGCAGCAGGTA -> GCAGCAGGTAG
TGCAGGGCTTA -> GCAGGGCTTAC
TGCATGGTGCG -> GCATGGTGCGG
TGCATGTCTGC -> GCATGTCTGCT
TGCATTGCTCA -> GCATTGCTCAG
TGCATTTGTCG -> GCATTTGTCGC
TGCCATTGATA -> GCCATTGATAC
TGCCCCAAAAG -> GCCCCAAAAGG
TGCCCGTGGGT -> GCCCGTGGGTC
TGCCGCACAGC -> GCCGCACAGCT
TGCCGGATATC -> GCCGGATATCG
TGCCGTGGGAA -> GCCGTGGGAAC
TGCCTACAAAG -> GCCTACAAAGT
TGCCTTCAAAA -> GCCTTCAAAAA
TGCGAAGTACC -> GCGAAGTACCA
TGCGACCCCAT -> GCGACCCCATG
TGCGACCGCGA -> GCGACCGCGAC
TGCGATAAGTA -> GCGATAAGTAA
TGCGCGCAGCG -> GCGCGCAGCGC
TGCGGCAGGCG -> GCGGCAGGCGT
TGCGGTATGAG -> GCGGTATGAGC
TGCGTCTACAG -> GCGTCTACAGG
TGCGTTAGCGG -> GCGTTAGCGGT
TGCGTTCTAGG -> GCGTTCTAGGC
TGCTACACTAT -> GCTACACTATT
TGCTACTGACG -> GCTACTGACGC
TGCTCAGGACT -> GCTCAGGACTA
TGCTCCGTAGC -> GCTCCGTAGCG
TGCTCTGACGC -> GCTCTGACGCC
TGCTGAAGAAC -> GCTGAAGAACT
TGCTTAGCATG -> GCTTAGCATGA
TGCTTATTTCC -> GCTTATTTCCT
TGCTTGCATGT -> GCTTGCATGTC
TGCTTTCTAAG -> GCTTTCTAAGG
TGGAAACGTGG -> GGAAACGTGGA
TGGAACAGATT -> GGAACAGATTC
TGGAAGGATAG -> GGAAGGATAGA
TGGAAGTTAAG -> GGAAGTTAAGA
TGGACCAATAG -> GGACCAATAGG
TGGAGATGAGA -> GGAGATGAGAT
TGGAGGCGTCT -> GGAGGCGTCTG
TGGAGGGGTAG -> GGAGGGGTAGT
TGGATTGAGGC -> GGATTGAGGCT
TGGCAACCGTC -> GGCAACCGTCT
TGGCACATCCC -> GGCACATCCCA
TGGCAGGCGCC -> GGCAGGCGCCA
TGGCATGACTT -> GGCATGACTTT
TGGCCATGCGT -> GGCCATGCGTT
TGGCCGATTTG -> GGCCGATTTGA
TGGCCGGCGTC -> GGCCGGCGTCA
TGGCTACGTCG -> GGCTACGTCGT
TGGCTCATAGT -> GGCTCATAGTT
TGGCTGCTCCG -> GGCTGCTCCGT
TGGGAACCGTT -> GGGAACCGTTA
TGGGACGGACT -> GGGACGGACTG
TGGGTCATACC -> GGGTCATACCG
TGGGTCGACTT -> GGGTCGACTTA
TGGGTCGGGAG -> GGGTCGGGAGA
TGGGTGTAGAA -> GGGTGTAGAAA
TGGGTTGTTGA -> GGGTTGTTGAT
TGGTATTATCG -> GGTATTATCGT
TGGTGCGGCAG -> GGTGCGGCAGG
TGGTTAGACGT -> GGTTAGACGTA
TGGTTCGACGT -> GGTTCGACGTA
TGGTTGCTTTC -> GGTTGCTTTCT
TGGTTGGCCAT -> GGTTGGCCATG
TGTAATGCCGT -> GTAATGCCGTG
TGTACCCCACC -> GTACCCCACCT
TGTAGAAATAG -> GTAGAAATAGT
TGTAGTGGAAG -> GTAGTGGAAGG
TGTATCAGTCG -> GTATCAGTCGT
TGTATGTAGTG -> GTATGTAGTGG
TGTATTGTTGA -> GTATTGTTGAC
TGTCAGGGGGG -> GTCAGGGGGGC
TGTCATCCGTT -> GTCATCCGTTC
TGTCGCCAGAA -> GTCGCCAGAAC
TGTCGGCTGTA -> GTCGGCTGTAT
TGTCTGCTTAT -> GTCTGCTTATT
TGTCTTACGTA -> GTCTTACGTAT
TGTGCACGACT -> GTGCACGACTC
TGTGCACTCTG -> GTGCACTCTGC
TGTGCGTCTAC -> GTGCGTCTACA
TGTGCGTTCTA -> GTGCGTTCTAG
TGTGCTGAAGA -> GTGCTGAAGAA
TGTGCTTAGCA -> GTGCTTAGCAT
TGTGGATTGAG -> GTGGATTGAGG
TGTGGCACATC -> GTGGCACATCC
TGTGGCTCATA -> GTGGCTCATAG
TGTGTTAATCT -> GTGTTAATCTG
TGTTAATCTGT -> GTTAATCTGTC
TGTTAGCGTTT -> GTTAGCGTTTC
TGTTAGTGATG -> GTTAGTGATGT
TGTTATTCCAC -> GTTATTCCACA
TGTTGAAGAGT -> GTTGAAGAGTT
TGTTGACGCCA -> GTTGACGCCAT
TGTTGATAAGT -> GTTGATAAGTA
TGTTGATTACT -> GTTGATTACTA
TTAAAGCAGTT -> TAAAGCAGTTT
TTAAAGGCCCC -> TAAAGGCCCCC
TTAAATTCATA -> TAAATTCATAA
TTAAATTGGCT -> TAAATTGGCTA
TTAAGAATCGA -> TAAGAATCGAA
TTAATCTGTCA -> TAATCTGTCAT
TTACATGGAAG -> TACATGGAAGT
TTACCTTAAAG -> TACCTTAAAGG
TTACGCAGCTC -> TACGCAGCTCG
TTACGTATTGC -> TACGTATTGCA
TTACTACCAAG -> TACTACCAAGA
TTACTATTGCC -> TACTATTGCCG
TTACTCTTGCG -> TACTCTTGCGG
TTAGACGTACA -> TAGACGTACAT
TTAGATTCGAA -> TAGATTCGAAC
TTAGCATGATA -> TAGCATGATAT
TTAGCGGTTAA -> TAGCGGTTAAA
TTAGCGTTTCC -> TAGCGTTTCCG
TTAGTCCGGGA -> TAGTCCGGGAG
TTAGTGATGTT -> TAGTGATGTTG
TTAGTGGAGAT -> TAGTGGAGATG
TTATCGCACTC -> TATCGCACTCC
TTATCGTATGA -> TATCGTATGAA
TTATGATGCAA -> TATGATGCAAC
TTATGGGTCGA -> TATGGGTCGAC
TTATGTGCTGA -> TATGTGCTGAA
TTATTCCACAT -> TATTCCACATC
TTATTTCCTTC -> TATTTCCTTCC
TTCAAAAATCA -> TCAAAAATCAC
TTCAAAGAAGG -> TCAAAGAAGGC
TTCACTCGTTG -> TCACTCGTTGT
TTCACTGCATG -> TCACTGCATGG
TTCAGATCAGA -> TCAGATCAGAA
TTCAGCGGTAG -> TCAGCGGTAGA
TTCAGTGCTAC -> TCAGTGCTACA
TTCATAAAAGT -> TCATAAAAGTC
TTCATCATACC -> TCATCATACCA
TTCCACATCGC -> TCCACATCGCA
TTCCATCGTAT -> TCCATCGTATC
TTCCCGCATAA -> TCCCGCATAAC
TTCCCGTTACA -> TCCCGTTACAT
TTCCGACGCCT -> TCCGACGCCTA
TTCCGTGACTT -> TCCGTGACTTT
TTCCTATCGGG -> TCCTATCGGGA
TTCCTTCCCGC -> TCCTTCCCGCA
TTCGAACTGCG -> TCGAACTGCGA
TTCGACACATG -> TCGACACATGT
TTCGACGTAAG -> TCGACGTAAGA
TTCGCCAGGAC -> TCGCCAGGACC
TTCGGGGGTTA -> TCGGGGGTTAG
TTCGTACCTCT -> TCGTACCTCTG
TTCGTGACTAT -> TCGTGACTATA
TTCGTTGTTAG -> TCGTTGTTAGT
TTCTAAGGACG -> TCTAAGGACGA
TTCTAGGCGTA -> TCTAGGCGTAC
TTCTCTCTGGC -> TCTCTCTGGCA
TTCTCTGCGAT -> TCTCTGCGATA
TTCTGACGACT -> TCTGACGACTT
TTCTTGATGTC -> TCTTGATGTCA
TTGAAGAGTTG -> TGAAGAGTTGC
TTGACCTCGAT -> TGACCTCGATT
TTGACGAGGCG -> TGACGAGGCGG
TTGACGCCATT -> TGACGCCATTT
TTGACTACGGT -> TGACTACGGTT
TTGAGAGCAGA -> TGAGAGCAGAC
TTGAGGACGAT -> TGAGGACGATT
TTGAGGCTTCA -> TGAGGCTTCAG
TTGATAAGTAG -> TGATAAGTAGG
TTGATACATGT -> TGATACATGTG
TTGATGTCAGG -> TGATGTCAGGG
TTGATTACTAC -> TGATTACTACC
TTGCAAGCACC -> TGCAAGCACCC
TTGCAGGGCTT -> TGCAGGGCTTA
TTGCATGTCTG -> TGCATGTCTGC
TTGCATTTGTC -> TGCATTTGTCG
TTGCCCGTGGG -> TGCCCGTGGGT
TTGCCGCACAG -> TGCCGCACAGC
TTGCCGGATAT -> TGCCGGATATC
TTGCGCGCAGC -> TGCGCGCAGCG
TTGCGGTATGA -> TGCGGTATGAG
TTGCTACTGAC -> TGCTACTGACG
TTGCTCAGGAC -> TGCTCAGGACT
TTGCTTTCTAA -> TGCTTTCTAAG
TTGGAACAGAT -> TGGAACAGATT
TTGGACCAATA -> TGGACCAATAG
TTGGCCATGCG -> TGGCCATGCGT
TTGGCTACGTC -> TGGCTACGTCG
TTGGCTGCTCC -> TGGCTGCTCCG
TTGGGTCGGGA -> TGGGTCGGGAG
TTGGGTGTAGA -> TGGGTGTAGAA
TTGGGTTGTTG -> TGGGTTGTTGA
TTGGTTGGCCA -> TGGTTGGCCAT
TTGTCGCCAGA -> TGTCGCCAGAA
TTGTCGGCTGT -> TGTCGGCTGTA
TTGTCTTACGT -> TGTCTTACGTA
TTGTGCACGAC -> TGTGCACGACT
TTGTGCACTCT -> TGTGCACTCTG
TTGTTAGTGAT -> TGTTAGTGATG
TTGTTGACGCC -> TGTTGACGCCA
TTGTTGATAAG -> TGTTGATAAGT
TTTAAAGCAGT -> TTAAAGCAGTT
TTTAGATTCGA -> TTAGATTCGAA
TTTCACTCGTT -> TTCACTCGTTG
TTTCACTGCAT -> TTCACTGCATG
TTTCAGTGCTA -> TTCAGTGCTAC
TTTCCGTGACT -> TTCCGTGACTT
TTTCCTATCGG -> TTCCTATCGGG
TTTCCTTCCCG -> TTCCTTCCCGC
TTTCGGGGGTT -> TTCGGGGGTTA
TTTCTAAGGAC -> TTCTAAGGACG
TTTGACGAGGC -> TTGACGAGGCG
TTTGAGAGCAG -> TTGAGAGCAGA
TTTGCGCGCAG -> TTGCGCGCAGC
TTTGGAACAGA -> TTGGAACAGAT
TTTGTCGCCAG -> TTGTCGCCAGA
TTTTAAAGCAG -> TTTAAAGCAGT
TTTTCACTGCA -> TTTCACTGCAT
TTTTCCTATCG -> TTTCCTATCGG
TTTTCGGGGGT -> TTTCGGGGGTT
TTTTGGAACAG -> TTTGGAACAGA
TTTTTCACTGC -> TTTTCACTGCA
TTTTTTCACTG -> TTTTTCACTGC
